,GeoFIPS,GeoName,Earnings by place of work,Employee and self-employed contributions for government social insurance,Employer contributions for employee pension and insurance funds 8,Employer contributions for government social insurance,Equals: Net earnings by place of residence,Farm income 2,Farm proprietors' income,Less: Contributions for government social insurance 5,Nonfarm personal income 1,Nonfarm proprietors' income,Per capita personal income (dollars) 4,Personal income (thousands of dollars),Plus: Adjustment for residence 6,"Plus: Dividends, interest, and rent 7",Plus: Personal current transfer receipts,Population (persons) 3,Proprietors employment,Proprietors' income 9,Supplements to wages and salaries,Total employment,Wage and salary employment,Wages and salaries,year
0," ""51000""",Virginia,253297482,14929484,31270766,27361798,237770954,348305,92631,28610383,349080210,16738235,44087,349428515,13083855,66248218,45409343,7925937,893192,16830866,44951665,4758119,3864927,191514951,2009
1," ""51001""","Accomack, VA",654540,41267,94947,67440,593312,34427,26711,74987,1067953,40180,32991,1102380,13759,230153,278915,33415,3770,66891,128667,18095,14325,458982,2009
2," ""51007""","Amelia, VA",130820,9469,15965,13098,251619,9209,5547,16018,393043,15384,31940,402252,136817,60671,89962,12594,1695,20931,22514,4471,2776,87375,2009
3," ""51009""","Amherst, VA",463273,32673,67389,49304,579157,-2690,-3445,57325,965799,34546,29683,963109,173209,144903,239049,32447,2967,31101,92041,13030,10063,340131,2009
4," ""51011""","Appomattox, VA",153669,12387,21643,15912,272557,-3589,-4159,20343,461854,19716,30939,458265,139231,64060,121648,14812,1548,15557,29599,5066,3518,108513,2009
5," ""51013""","Arlington, VA",18223945,990495,2286667,2044692,11254789,0,0,2012841,15028023,796314,74162,15028023,-4956315,3019207,754027,202637,27541,796314,3309013,205930,178389,14118618,2009
6," ""51017""","Bath, VA",90911,6833,12632,11290,71519,-735,-1285,12478,171527,-524,36009,170792,-6914,60662,38611,4743,642,-1809,18277,2885,2243,74443,2009
7," ""51019""","Bedford, VA*",935559,69485,117451,97014,1693485,-5900,-7955,117992,2685458,118729,35932,2679558,875918,473216,512857,74573,9127,110774,165958,29344,20217,658827,2009
8," ""51021""","Bland, VA",109105,7560,19531,11312,103698,-1207,-1786,13216,190135,7853,27508,188928,7809,31568,53662,6868,767,6067,25187,2891,2124,77851,2009
9," ""51023""","Botetourt, VA",484827,34273,63424,51298,866910,-1746,-3167,59922,1294809,50796,39134,1293063,442005,211044,215109,33042,3985,47629,89073,13707,9722,348125,2009
10," ""51025""","Brunswick, VA",212482,14868,32132,22364,246570,8012,6287,26050,458425,8351,26643,466437,60138,67223,152644,17507,1272,14638,43314,6351,5079,154530,2009
11," ""51027""","Buchanan, VA",459231,33679,61102,49878,345109,-616,-664,58618,711256,24142,29324,710640,-55504,102017,263514,24234,1279,23478,86041,9682,8403,349712,2009
12," ""51029""","Buckingham, VA",168862,12324,24442,16472,231137,3107,2010,20560,393435,19736,23125,396542,82835,56951,108454,17148,1381,21746,32678,4889,3508,114438,2009
13," ""51033""","Caroline, VA",287854,20160,43279,30182,631723,-475,-2343,35251,949576,29115,33581,949101,379120,142166,175212,28263,2603,26772,58370,8349,5746,202712,2009
14," ""51036""","Charles City, VA",88291,6268,10562,8830,143690,3801,2683,10683,231398,10659,32594,235199,66082,39179,52330,7216,525,13342,14977,2134,1609,59972,2009
15," ""51037""","Charlotte, VA",130951,10543,20121,12764,169688,3969,2421,16925,331383,16079,26641,335352,55662,56822,108842,12588,1903,18500,26503,5013,3110,85948,2009
16," ""51041""","Chesterfield, VA",6947980,422715,857277,736750,9497426,884,211,791090,13208101,504390,42188,13208985,3340536,2141109,1570450,313096,35680,504601,1225652,158280,122600,5217727,2009
17," ""51043""","Clarke, VA",259589,17367,25613,24584,463642,2769,-1506,29659,705803,53898,50558,708572,233712,165496,79434,14015,2771,52392,37905,7145,4374,169292,2009
18," ""51045""","Craig, VA",33569,3130,5015,3190,85895,-694,-1099,4725,148622,6020,28892,147928,57051,24846,37187,5120,652,4921,6610,1382,730,22038,2009
19," ""51047""","Culpeper, VA",811120,52168,103118,84764,1124664,1179,-3499,94550,1669290,89002,36129,1670469,408094,293150,252655,46236,6127,85503,145500,21709,15582,580117,2009
20," ""51049""","Cumberland, VA",71200,5597,9475,6164,159128,7235,6204,8679,263963,10904,27085,271198,96607,39133,72937,10013,744,17108,12557,2212,1468,41535,2009
21," ""51051""","Dickenson, VA",207037,16818,29116,21736,200939,-1447,-1505,27686,430004,12746,26911,428557,21588,55929,171689,15925,839,11241,39984,5055,4216,155812,2009
22," ""51057""","Essex, VA",179204,12138,23751,18352,213215,4799,4000,21314,365861,16421,33381,370660,55325,71411,86034,11104,1329,20421,32927,5619,4290,125856,2009
23," ""51061""","Fauquier, VA",1322218,84518,141975,130942,2327745,-7666,-19922,149989,3509581,218115,53953,3501915,1155516,865215,308955,64907,10195,198193,207446,32479,22284,916579,2009
24," ""51063""","Floyd, VA",134768,10994,17433,12550,260645,3273,-1803,17269,438607,28399,29167,441880,143146,71813,109422,15150,2496,26596,23708,5637,3141,84464,2009
25," ""51065""","Fluvanna, VA",232800,17886,31507,21424,553398,-339,-963,28598,876335,42052,34251,875996,349196,177034,145564,25576,2989,41089,42219,7407,4418,149492,2009
26," ""51067""","Franklin, VA",643746,48700,77997,65120,993825,5893,1189,81260,1722444,101424,31012,1728337,431339,322859,411653,55732,6893,102613,110557,21042,14149,430576,2009
27," ""51071""","Giles, VA",266201,19187,40832,28334,298131,-1853,-2221,33354,523830,20444,30235,521977,65284,78491,145355,17264,1750,18223,54999,6991,5241,192979,2009
28," ""51073""","Gloucester, VA",437501,30947,58751,43714,968346,2952,2425,52804,1486242,49804,40491,1489194,583649,294148,226700,36778,3852,52229,80608,13976,10124,304664,2009
29," ""51075""","Goochland, VA",915628,55091,95422,93384,890473,-19,-2260,101783,1423008,36394,65867,1422989,76628,397107,135409,21604,3538,34134,142114,15186,11648,739380,2009
30," ""51077""","Grayson, VA",109741,11008,17094,11054,199930,-1078,-2916,16535,410599,17929,26091,409521,106724,69519,140072,15696,2133,15013,22621,4847,2714,72107,2009
31," ""51079""","Greene, VA",180413,13035,20877,17468,407326,892,169,21769,596483,30007,32756,597375,248682,94843,95206,18237,2078,30176,29611,5682,3604,120626,2009
32," ""51083""","Halifax, VA",580629,40420,87516,62680,545324,9951,6459,71760,1016043,34268,28270,1025994,36455,165288,315382,36293,3274,40727,118856,16357,13083,421046,2009
33," ""51085""","Hanover, VA",2443044,150665,282360,265950,3086678,6398,-740,283640,4352991,175596,43747,4359389,927274,750267,522444,99651,13070,174856,415335,61410,48340,1852853,2009
34," ""51087""","Henrico, VA",11429045,683992,1230753,1197072,9543327,2077,808,1282528,13672894,1023868,44871,13674971,-603190,2464954,1666690,304763,38002,1024676,1829289,219672,181670,8575080,2009
35," ""51091""","Highland, VA",24418,2080,3777,2238,28999,-376,-961,3199,74982,4864,31573,74606,7780,26546,19061,2363,711,3903,4896,1316,605,15619,2009
36," ""51093""","Isle of Wight, VA",632624,41147,77745,65574,1093696,8049,6015,73934,1561064,46467,44489,1569113,535006,247370,228047,35270,3538,52482,110532,15356,11818,469610,2009
37," ""51097""","King and Queen, VA",75845,5309,10061,7540,144129,2910,2170,9079,229230,10994,33678,232140,77363,38373,49638,6893,761,13164,13831,2015,1254,48850,2009
38," ""51099""","King George, VA",980099,53066,152116,109322,709498,-2834,-3297,107727,1016520,54178,43441,1013686,-162874,199246,104942,23335,2435,50881,206777,13186,10751,722441,2009
39," ""51101""","King William, VA",203219,13928,24295,20884,398242,3293,1455,24370,573383,19644,36573,576676,219393,86333,92101,15768,1684,21099,34737,5590,3906,147383,2009
40," ""51103""","Lancaster, VA",236441,17695,28208,22948,196278,-479,-797,29169,497432,36187,43581,496953,-10994,182728,117947,11403,1999,35390,39682,7176,5177,161369,2009
41," ""51105""","Lee, VA",259814,20971,42671,27698,325345,-3423,-4271,34820,652630,20371,25381,649207,100351,85711,238151,25578,2240,16100,56520,8151,5911,187194,2009
42," ""51107""","Loudoun, VA",10124694,589002,1068076,1053210,15326572,-2059,-12943,1115607,18773257,778109,61816,18771198,6317485,2630622,814004,303661,40583,765166,1594681,179822,139239,7764847,2009
43," ""51109""","Louisa, VA",530854,34762,78340,52968,741525,-1917,-3239,61246,1131587,55075,34399,1129670,271917,183218,204927,32840,3533,51836,104824,11830,8297,374194,2009
44," ""51111""","Lunenburg, VA",128024,9782,18743,13438,164464,2826,1351,16501,322941,9645,25279,325767,52941,61129,100174,12887,962,10996,25462,3912,2950,91566,2009
45," ""51113""","Madison, VA",144641,11035,19693,15568,252787,-1738,-4400,18819,431776,19118,32193,430038,126965,95701,81550,13358,2023,14718,27477,5427,3404,102446,2009
46," ""51115""","Mathews, VA",86624,7788,9307,7126,218734,36,-254,11351,409144,24834,45480,409180,143461,114379,76067,8997,1368,24580,12870,3131,1763,49174,2009
47," ""51117""","Mecklenburg, VA",532142,37386,78789,58556,467150,7901,3328,66664,920717,27229,28299,928618,1672,170711,290757,32815,2976,30557,108067,16285,13309,393518,2009
48," ""51119""","Middlesex, VA",165097,12517,22022,15024,198721,2479,1440,20029,413638,28259,38264,416117,53653,119370,98026,10875,1854,29699,29534,5483,3629,105864,2009
49," ""51125""","Nelson, VA",174846,13821,21074,15940,295388,2547,-406,21791,537485,37769,35787,540032,142333,119005,125639,15090,2710,37363,29044,6371,3661,108439,2009
50," ""51127""","New Kent, VA",199028,13997,24999,20360,727902,168,-86,24177,951555,27698,52707,951723,553051,123160,100661,18057,2480,27612,35179,6607,4127,136237,2009
51," ""51131""","Northampton, VA",282193,16075,30101,25338,244106,56424,43127,28744,397814,20158,36456,454238,-9343,92387,117745,12460,1711,63285,42770,7008,5297,176138,2009
52," ""51133""","Northumberland, VA",130462,11877,15867,12212,167452,2552,1775,17983,446941,24268,36311,449493,54973,163341,118700,12379,1641,26043,21973,4389,2748,82446,2009
53," ""51135""","Nottoway, VA",268871,18092,46562,31352,235081,2812,1035,33768,459530,10367,29089,462342,-22,82637,144624,15894,1471,11402,62238,7611,6140,195231,2009
54," ""51137""","Orange, VA",424600,30698,52181,41482,725634,16381,6752,51439,1213485,59194,36901,1229866,352473,261197,243035,33329,4244,65946,72922,13036,8792,285732,2009
55," ""51139""","Page, VA",273452,20030,36766,28266,412157,16506,14218,34163,693534,34569,29492,710040,172868,119020,178863,24076,2632,48787,50899,8791,6159,173766,2009
56," ""51141""","Patrick, VA",203090,16161,30719,21394,238429,2930,731,26858,474576,21381,25725,477506,62197,80877,158200,18562,2228,22112,41416,7576,5348,139562,2009
57," ""51145""","Powhatan, VA",349508,23563,45785,34380,772142,1504,798,40753,1088032,43790,38936,1089536,463387,180859,136535,27983,3281,44588,62975,10216,6935,241945,2009
58," ""51147""","Prince Edward, VA",393230,25567,56923,43378,296710,3624,2735,47256,545094,20945,23591,548718,-49264,96976,155032,23260,2218,23680,78612,11880,9662,290938,2009
59," ""51155""","Pulaski, VA",563699,39133,84077,65134,588590,416,-876,71700,1038591,43162,29696,1039007,96591,151462,298955,34988,2769,42286,116644,15217,12448,404769,2009
60," ""51157""","Rappahannock, VA",104110,7994,9925,8008,211268,-2806,-4324,11998,363052,33041,49127,360246,119156,101908,47070,7333,1600,28717,13929,3238,1638,61464,2009
61," ""51159""","Richmond, VA",144282,9529,21936,14846,134485,3839,2159,16952,243978,9653,26788,247817,7155,53153,60179,9251,968,11812,29359,4067,3099,103111,2009
62," ""51167""","Russell, VA",368251,28794,54589,41314,442248,-2490,-3878,49451,824944,31541,28349,822454,123448,108622,271584,29012,2624,27663,75246,10562,7938,265342,2009
63," ""51169""","Scott, VA",217687,19238,32292,23732,303069,-3234,-3960,31104,611506,15741,26205,608272,116486,92511,212692,23212,2709,11781,44158,8141,5432,161748,2009
64," ""51171""","Shenandoah, VA",629851,43919,82879,62668,806761,8300,5015,75253,1346269,75527,32450,1354569,252163,266008,281800,41743,5668,80542,114213,19863,14195,435096,2009
65," ""51173""","Smyth, VA",553534,39082,85714,61282,472116,-3516,-5253,69723,893694,41440,27574,890178,-11695,127913,290149,32283,3331,36187,116355,15703,12372,400992,2009
66," ""51179""","Stafford, VA",2484272,140198,343002,273282,4349591,-2438,-2843,276839,5829505,185471,46082,5827067,2142158,980069,497407,126449,11967,182628,479643,51150,39183,1822001,2009
67," ""51181""","Surry, VA",224355,12750,40197,22448,154351,3113,1915,23974,233114,5455,33569,236227,-46030,35298,46578,7037,614,7370,51421,2990,2376,165564,2009
68," ""51183""","Sussex, VA",181840,11881,27253,19228,177852,7632,5875,21495,308748,7054,25986,316380,17507,49344,89184,12175,847,12929,36867,4805,3958,132044,2009
69," ""51185""","Tazewell, VA",798000,56636,114914,84722,746884,-1729,-2530,98997,1409844,58178,31244,1408115,47881,240590,420641,45069,3694,55648,157275,22069,18375,585077,2009
70," ""51187""","Warren, VA",582812,38204,75588,62214,911880,-3139,-3896,69311,1369962,58180,36703,1366823,398379,241410,213533,37240,4400,54284,106695,16993,12593,421833,2009
71," ""51193""","Westmoreland, VA",160006,12858,21565,15906,295584,7693,2437,20811,570993,19968,33166,578686,156389,144287,138815,17448,2048,22405,29518,5983,3935,108083,2009
72," ""51197""","Wythe, VA",489674,34190,74346,53392,460535,-3225,-5726,60886,837613,33997,28559,834388,31747,133570,240283,29216,3232,28271,101042,15347,12115,360361,2009
73," ""51510""","Alexandria (Independent City), VA",9563410,529264,1102006,1041632,7306560,0,0,1050080,9873831,863047,71798,9873831,-1206770,2003604,563667,137523,19353,863047,1622822,126442,107089,7077541,2009
74," ""51550""","Chesapeake (Independent City), VA",5127688,308146,644954,563056,6424867,8239,2916,589674,9077804,299829,41267,9086043,1886853,1496266,1164910,220176,19963,302745,926482,121598,101635,3898461,2009
75," ""51650""","Hampton (Independent City), VA",4185455,227348,676915,499280,3035156,0,0,476988,4789312,112810,34747,4789312,-673311,833520,920636,137833,9275,112810,926555,77457,68182,3146090,2009
76," ""51700""","Newport News (Independent City), VA",6332981,346161,1008136,694308,3976151,0,0,693315,6127926,235117,33856,6127926,-1663515,1036936,1114839,181000,12975,235117,1355290,119637,106662,4742574,2009
77," ""51710""","Norfolk (Independent City), VA",13356276,653768,2195448,1622604,4930174,0,0,1465070,8124422,523928,33610,8124422,-6961032,1695557,1498691,241725,17956,523928,3006750,214998,197042,9825598,2009
78," ""51740""","Portsmouth (Independent City), VA",3211825,171828,571066,381846,1917801,0,0,362751,3186930,62730,33412,3186930,-931273,534292,734837,95384,6709,62730,761989,57088,50379,2387106,2009
79," ""51760""","Richmond (Independent City), VA",11304595,657116,1408225,1154444,4763468,0,0,1234338,8337222,753452,40933,8337222,-5306789,2032966,1540788,203678,18608,753452,1985447,178463,159855,8565696,2009
80," ""51770""","Roanoke (Independent City), VA",3836669,231950,488397,447924,1921050,0,0,455912,3318345,213237,34202,3318345,-1459707,573829,823466,97023,8504,213237,712359,80200,71696,2911073,2009
81," ""51800""","Suffolk (Independent City), VA",1478040,92673,194385,158438,2336043,16487,6099,171892,3446918,106190,41405,3463405,1029895,598377,528985,83648,8003,112289,273604,34826,26823,1092147,2009
82," ""51810""","Virginia Beach (Independent City), VA",10387858,590560,1453501,1191052,12584093,1901,246,1186086,18972355,512616,43619,18974256,3382321,4106652,2283511,435004,47138,512862,2049027,243151,196013,7825969,2009
83," ""51901""","Albemarle + Charlottesville, VA*",5701735,336287,735728,562344,4027554,-402,-9261,617459,6844641,656195,48498,6844239,-1056722,2093065,723620,141125,22159,646934,1016900,113544,91385,4037901,2009
84," ""51903""","Alleghany + Covington, VA*",430036,30258,57504,48532,368274,-1641,-1879,54524,693016,18690,31067,691375,-7238,111292,211809,22254,1428,16811,81770,10110,8682,331455,2009
85," ""51907""","Augusta, Staunton + Waynesboro, VA*",2592276,170405,322288,244398,2606758,12773,3683,292604,4144128,450301,35052,4156901,307086,713753,836390,118593,13229,453984,444487,62262,49033,1693805,2009
86," ""51911""","Campbell + Lynchburg, VA*",3665128,226917,462898,407824,2271715,-2272,-4341,430829,3984903,156510,30728,3982631,-962584,661497,1049419,129609,12130,152169,666810,85574,73444,2846149,2009
87," ""51913""","Carroll + Galax, VA*",524741,39148,74388,56914,518556,-275,-2161,67605,1032085,47128,27911,1031810,61420,156732,356522,36968,3260,44967,102845,16460,13200,376929,2009
88," ""51918""","Dinwiddie, Colonial Heights + Petersburg, VA*",1537169,99417,219855,169758,1434331,2867,1434,184296,2596699,63828,33508,2599566,81458,403118,762117,77581,7235,65262,304734,41346,34111,1167173,2009
89," ""51919""","Fairfax, Fairfax City + Falls Church, VA*",60179215,3492510,5787623,6361282,51571551,5971,4299,6673151,70340463,3269526,63989,70346434,-1934513,14593357,4181526,1099347,160628,3273825,8968264,822361,661733,47937126,2009
90," ""51921""","Frederick + Winchester, VA*",2719887,165710,332250,295834,2674054,-2266,-7326,313627,3895236,204500,37609,3892970,267794,648615,570301,103513,12517,197174,480167,63678,51161,2042546,2009
91," ""51923""","Greensville + Emporia, VA*",342126,21611,52625,38338,263342,4969,4114,40780,457276,5619,25486,462245,-38004,63901,135002,18137,1026,9733,71794,9686,8660,260599,2009
92," ""51929""","Henry + Martinsville, VA*",1096139,79828,157077,122666,971254,5043,4137,141161,1995782,68942,29246,2000825,16276,370045,659526,68414,5471,73079,218410,32328,26857,804650,2009
93," ""51931""","James City + Williamsburg, VA*",2149519,137092,261869,217708,2449633,610,148,245946,4053368,277326,50799,4053978,546060,1052649,551696,79805,10760,277474,370723,54694,43934,1501322,2009
94," ""51933""","Montgomery + Radford, VA*",2477383,145660,392863,266156,1899979,1091,-1962,278738,3104552,114706,28199,3105643,-298666,687473,518191,110133,10385,112744,525941,60903,50518,1838698,2009
95," ""51939""","Pittsylvania + Danville, VA*",1734711,121579,240672,191822,1586884,13443,6064,217490,2983174,90620,28037,2996617,69663,468467,941266,106882,8819,96684,336583,49491,40672,1301444,2009
96," ""51941""","Prince George + Hopewell, VA*",1843758,94005,338315,221834,1105093,-2842,-3141,204922,1819320,31541,31167,1816478,-533743,336620,374765,58283,3535,28400,449232,31462,27927,1366126,2009
97," ""51942""","Prince William, Manassas + Manassas Park, VA*",8811777,508418,1074318,961580,15755707,-2223,-5104,989208,20305319,721162,46218,20303096,7933138,2999001,1548388,439288,48178,716058,1555108,191657,143479,6540611,2009
98," ""51944""","Roanoke + Salem, VA*",3642983,225333,472453,382882,3187816,255,-350,416774,4826128,305382,41287,4826383,-38393,842333,796234,116899,13078,305032,663894,77616,64538,2674057,2009
99," ""51945""","Rockbridge, Buena Vista + Lexington, VA*",660058,45234,87095,73022,610944,-4100,-5996,81745,1127253,68210,31240,1123153,32631,253918,258291,35952,4628,62214,123606,19525,14897,474238,2009
100," ""51947""","Rockingham + Harrisonburg, VA*",3056943,182412,402030,316100,2351444,65622,49961,340462,3583365,229189,29393,3648987,-365037,664306,633237,124144,14975,279150,560080,77220,62245,2217713,2009
101," ""51949""","Southampton + Franklin, VA*",396308,26077,56881,39460,467851,19898,16357,45807,806660,26784,30505,826558,117350,148965,209742,27096,2387,43141,76611,11292,8905,276556,2009
102," ""51951""","Spotsylvania + Fredericksburg, VA*",2843868,173693,348149,311118,4139552,-2547,-4070,329252,5926272,175560,40906,5923725,1624936,1069075,715098,144813,14152,171490,503708,72883,58731,2168670,2009
103," ""51953""","Washington + Bristol, VA*",1694099,113848,220955,165194,1414232,-3913,-7026,196445,2518756,193280,34657,2514843,-83422,493895,606716,72564,8316,186254,303552,42116,33800,1204293,2009
104," ""51955""","Wise + Norton, VA*",984844,66112,136667,110024,682543,4,-97,121124,1294492,41325,28540,1294496,-181177,165790,446163,45357,2949,41228,191679,23244,20295,751937,2009
105," ""51958""","York + Poquoson, VA*",1302040,79701,182964,140970,2505149,2308,1610,150186,3639322,122677,47080,3641630,1353295,748857,387624,77350,6292,124287,253449,32589,26297,924304,2009
0," ""51000""",Virginia,263971808,15337139,31027480,28376402,249044710,333211,79353,29525340,364912269,22237956,45519,365245480,14598242,66616486,49584284,8024004,890637,22317309,45215681,4743189,3852552,196438818,2010
1," ""51001""","Accomack, VA",669368,42187,95329,69258,603275,30526,23563,76816,1092202,51167,33868,1122728,10723,222749,296704,33150,3731,74730,129958,18051,14320,464680,2010
2," ""51007""","Amelia, VA",143066,9696,15259,13136,267116,16485,12806,16264,409097,21461,33403,425582,140314,59809,98657,12741,1662,34267,21827,4364,2702,86972,2010
3," ""51009""","Amherst, VA",456055,32277,64045,48316,576212,-2933,-3697,56435,972617,41939,29939,969684,176592,140661,252811,32389,2921,38242,88203,12472,9551,329610,2010
4," ""51011""","Appomattox, VA",152044,12286,21081,15618,269588,-3758,-4446,20095,465821,22286,30618,462063,137639,61801,130674,15091,1570,17840,28890,5112,3542,105314,2010
5," ""51013""","Arlington, VA",20274242,1078354,2394589,2190244,12735445,0,0,2173476,16591315,1642270,79263,16591315,-5365321,2976104,879766,209319,27711,1642270,3489711,210386,182675,15142261,2010
6," ""51017""","Bath, VA",109581,7373,12767,11646,90080,-1125,-1660,13196,183263,18057,38580,182138,-6305,51023,41035,4721,637,16397,18590,2883,2246,74594,2010
7," ""51019""","Bedford, VA*",979217,71420,114659,102578,1714860,-4939,-6935,122709,2728569,140463,36300,2723630,858352,460526,548244,75032,9069,133528,165948,29699,20630,679741,2010
8," ""51021""","Bland, VA",113139,7761,19769,11748,106383,-1261,-1769,13635,189440,8778,27669,188179,6879,26657,55139,6801,774,7009,25643,2878,2104,80487,2010
9," ""51023""","Botetourt, VA",489107,34288,58027,51030,871217,-2247,-3636,59803,1314278,66325,39525,1312031,441913,208735,232079,33195,3979,62689,83542,13228,9249,342876,2010
10," ""51025""","Brunswick, VA",192092,14004,27653,20708,235187,6458,4678,24358,454326,10148,26492,460784,67453,63879,161718,17393,1222,14826,38007,5891,4669,139259,2010
11," ""51027""","Buchanan, VA",497943,35741,62248,54468,365755,-505,-552,62975,722400,29568,29965,721895,-69213,88941,267199,24091,1217,29016,89482,9762,8545,379445,2010
12," ""51029""","Buckingham, VA",177577,12514,24752,16886,232741,6358,5241,20957,401999,23278,23892,408357,76121,59210,116406,17092,1403,28519,33195,4846,3443,115863,2010
13," ""51033""","Caroline, VA",291482,20393,43459,30528,637040,-1805,-3690,35657,969101,32185,33785,967296,381215,138509,191747,28631,2536,28495,58723,8221,5685,204264,2010
14," ""51036""","Charles City, VA",89416,6472,10471,9304,144874,553,-608,11124,239920,12417,33146,240473,66582,39923,55676,7255,530,11809,15123,2152,1622,62484,2010
15," ""51037""","Charlotte, VA",130733,10525,19181,12674,169873,3059,1415,16862,336843,19148,27045,339902,56002,54986,115043,12568,1912,20563,25518,4869,2957,84652,2010
16," ""51041""","Chesterfield, VA",7067502,426101,843021,766002,9624324,497,-270,809102,13506060,515820,42579,13506557,3365924,2149378,1732855,317210,35341,515550,1226022,156635,121294,5325930,2010
17," ""51043""","Clarke, VA",260226,16755,23949,23666,478626,3972,-188,28588,718498,65809,51539,722470,246988,158699,85145,14018,2847,65621,35782,7039,4192,158823,2010
18," ""51045""","Craig, VA",35510,3185,5077,3342,90303,-1042,-1492,4856,155136,7685,29645,154094,59649,25039,38752,5198,640,6193,6748,1386,746,22569,2010
19," ""51047""","Culpeper, VA",836656,52925,101184,86670,1161076,986,-4013,96260,1729264,113519,36944,1730250,420680,285876,283298,46834,6276,109506,144519,21797,15521,582631,2010
20," ""51049""","Cumberland, VA",73748,5626,9175,6128,165565,9289,8237,8690,269297,12176,27781,278586,100507,38209,74812,10028,748,20413,12239,2194,1446,41096,2010
21," ""51051""","Dickenson, VA",218615,17512,29710,22610,219709,-1624,-1683,28817,454106,17111,28555,452482,29911,54678,178095,15846,858,15428,41015,5149,4291,162172,2010
22," ""51057""","Essex, VA",174973,12325,22329,18704,207135,-2521,-3336,21677,372772,19042,33221,370251,53839,68111,95005,11145,1300,15706,31681,5409,4109,127586,2010
23," ""51061""","Fauquier, VA",1435352,88658,138412,134144,2496865,-9243,-21326,155730,3702190,317612,56439,3692947,1217243,853838,342244,65433,10154,296286,205484,32311,22157,933582,2010
24," ""51063""","Floyd, VA",142692,11336,17510,12858,268512,2242,-2252,17765,456768,35362,29870,459010,143585,72355,118143,15367,2432,33110,23939,5627,3195,85643,2010
25," ""51065""","Fluvanna, VA",245105,18287,32246,22576,566160,-303,-902,29575,899479,48000,34863,899176,350630,175970,157046,25792,2915,47098,43534,7423,4508,154473,2010
26," ""51067""","Franklin, VA",665529,49272,74596,65634,1021107,10615,5914,82089,1753262,124700,31400,1763877,437667,306564,436206,56174,6748,130614,107413,20746,13998,427502,2010
27," ""51071""","Giles, VA",272833,19527,39235,29142,308913,-1910,-2326,34098,546747,25303,31463,544837,70178,80489,155435,17317,1794,22977,53806,7011,5217,196050,2010
28," ""51073""","Gloucester, VA",449109,31355,57835,43972,968229,1753,1180,53341,1491468,64441,40421,1493221,572461,281918,243074,36942,3861,65621,79821,13841,9980,303667,2010
29," ""51075""","Goochland, VA",980626,58697,94807,98852,936372,-734,-2745,108123,1502531,60310,68556,1501797,63869,413316,152109,21906,3505,57565,144233,15371,11866,778828,2010
30," ""51077""","Grayson, VA",111572,10989,16137,11166,201605,316,-1450,16572,415746,20540,26843,416062,106605,63935,150522,15500,2029,19090,21720,4723,2694,70762,2010
31," ""51079""","Greene, VA",185731,13130,20473,17916,424976,1106,313,22088,631122,34254,34211,632228,261333,101928,105324,18480,1971,34567,29431,5620,3649,121733,2010
32," ""51083""","Halifax, VA",599085,41528,87843,64618,555753,7554,4090,73837,1041813,45615,28985,1049367,30505,160003,333611,36204,3231,49705,120152,16446,13215,429228,2010
33," ""51085""","Hanover, VA",2465267,150901,270681,268864,3170288,4132,-2939,285333,4479851,227025,44891,4483983,990354,745175,568520,99886,12769,224086,405113,60644,47875,1836068,2010
34," ""51087""","Henrico, VA",12031437,706796,1182721,1226192,10125463,1413,218,1319892,14378448,1515888,46809,14379861,-586082,2444048,1810350,307201,38127,1516106,1795817,218651,180524,8719514,2010
35," ""51091""","Highland, VA",26775,2083,3621,2240,30485,1717,1110,3203,72926,5314,32496,74643,6913,23501,20657,2297,702,6424,4741,1306,604,15610,2010
36," ""51093""","Isle of Wight, VA",603309,39850,69350,59870,1114101,3254,1365,69785,1600461,59161,45407,1603715,580577,238669,250945,35319,3517,60526,99285,14202,10685,443498,2010
37," ""51097""","King and Queen, VA",73620,5363,9662,7330,142796,80,-742,9028,233730,13716,33516,233810,78204,36384,54630,6976,703,12974,13327,1903,1200,47319,2010
38," ""51099""","King George, VA",1056447,56502,160870,119280,749698,-2252,-2703,116142,1075857,67715,45306,1073605,-190607,208756,115151,23697,2310,65012,220510,13347,11037,770925,2010
39," ""51101""","King William, VA",201582,13842,23397,21064,398588,927,-474,24374,580994,22649,36372,581921,221380,82695,100638,15999,1626,22175,33929,5401,3775,145478,2010
40," ""51103""","Lancaster, VA",239059,17480,27686,23520,197257,-536,-873,29240,499160,37901,43885,498624,-12562,179535,121832,11362,2024,37028,39446,7121,5097,162585,2010
41," ""51105""","Lee, VA",265914,21006,42177,28078,336029,-3729,-4594,35045,668345,25891,25955,664616,105160,83624,244963,25606,2245,21297,56216,8075,5830,188401,2010
42," ""51107""","Loudoun, VA",10841061,619613,1059225,1123376,16473525,-6534,-17729,1181301,20152009,1012297,63855,20145475,6813765,2735585,936365,315486,41295,994568,1620913,183855,142560,8225580,2010
43," ""51109""","Louisa, VA",587511,37823,81866,58736,757350,-2615,-3968,67191,1167918,62160,35132,1165303,237030,187573,220380,33169,3485,58192,111234,12229,8744,418085,2010
44," ""51111""","Lunenburg, VA",125844,9856,18147,13720,163101,-751,-2374,16716,331262,11816,25603,330511,53973,60887,106523,12909,964,9442,25007,3837,2873,91395,2010
45," ""51113""","Madison, VA",157724,11587,18092,15818,272699,-649,-3338,19496,450155,32156,33800,449506,134471,92189,84618,13299,2015,28818,26001,5292,3277,102905,2010
46," ""51115""","Mathews, VA",88513,7708,8804,6810,207544,200,-3,11113,403925,29780,45033,404125,130144,116639,79942,8974,1335,29777,12209,3004,1669,46527,2010
47," ""51117""","Mecklenburg, VA",543515,38440,77010,61202,474703,3628,-1040,69041,939732,34773,28835,943360,229,165418,303239,32716,2985,33733,107611,16121,13136,402171,2010
48," ""51119""","Middlesex, VA",178177,13155,21910,15378,208026,1227,179,20844,424045,40339,38728,425272,50693,113462,103784,10981,1814,40518,29599,5362,3548,108060,2010
49," ""51125""","Nelson, VA",183622,14068,20807,16400,300615,1833,-1029,22268,548123,45790,36718,549956,139261,116655,132686,14978,2653,44761,29007,6326,3673,109854,2010
50," ""51127""","New Kent, VA",200972,14081,23898,19808,783691,-847,-1085,23985,1016326,36894,54763,1015479,606704,122212,109576,18543,2565,35809,33802,6523,3958,131361,2010
51," ""51131""","Northampton, VA",259217,15263,28963,25302,226852,42877,30383,27914,393751,24554,35184,436628,-4451,87696,122080,12410,1725,54937,41614,6988,5263,162666,2010
52," ""51133""","Northumberland, VA",129957,12013,15941,12912,172155,-660,-1448,18469,454992,22842,36770,454332,60667,158752,123425,12356,1627,21394,22397,4407,2780,86166,2010
53," ""51135""","Nottoway, VA",277502,18468,47642,32826,228124,4056,2180,34881,454428,10762,28932,458484,-14497,77115,153245,15847,1495,12942,64055,7631,6136,200505,2010
54," ""51137""","Orange, VA",448105,31993,51872,44018,760883,11415,1783,54002,1258563,70633,37835,1269978,366780,253132,255963,33566,4223,72416,73881,13050,8827,301808,2010
55," ""51139""","Page, VA",296527,20745,37160,29604,431725,24603,22201,35547,715258,43212,30748,739861,170745,118933,189203,24062,2630,65413,51962,8781,6151,179152,2010
56," ""51141""","Patrick, VA",211156,16651,29866,22474,245801,2225,217,27888,488943,26787,26587,491168,62533,78745,166622,18474,2225,27004,41103,7690,5465,143049,2010
57," ""51145""","Powhatan, VA",358853,23832,46189,34780,794855,523,-182,41222,1120062,53738,39832,1120585,477224,177453,148277,28133,3284,53556,63579,10054,6770,241718,2010
58," ""51147""","Prince Edward, VA",408399,26279,57168,45626,303178,3581,2681,49092,561390,26124,24181,564971,-56129,96038,165755,23364,2191,28805,79981,11734,9543,299613,2010
59," ""51155""","Pulaski, VA",563807,39299,76201,62700,596318,1106,-207,70649,1067927,53589,30693,1069033,103160,158060,314655,34830,2691,53382,107551,14654,11963,402874,2010
60," ""51157""","Rappahannock, VA",110865,8015,9637,8084,219659,-2751,-4334,12057,368508,39392,48755,365757,120851,94876,51222,7502,1620,35058,13679,3249,1629,62128,2010
61," ""51159""","Richmond, VA",144600,9550,22008,14948,135188,2627,792,17024,245293,10717,26727,247920,7612,49174,63558,9276,911,11509,29482,3993,3082,103609,2010
62," ""51167""","Russell, VA",377244,29392,51608,42056,457358,-2246,-3768,50420,841459,39374,29066,839213,130534,101116,280739,28873,2576,35606,72636,10285,7709,269002,2010
63," ""51169""","Scott, VA",223833,20079,31519,24638,312280,-4717,-5404,32398,625772,21230,26854,621055,120845,85446,223329,23127,2671,15826,43838,8028,5357,164169,2010
64," ""51171""","Shenandoah, VA",654709,44567,81149,65492,837409,13688,10343,77313,1396346,91151,33534,1410034,260013,268540,304085,42048,5645,101494,113895,19765,14120,439320,2010
65," ""51173""","Smyth, VA",562100,39398,82954,62338,487000,-1398,-3117,70567,911424,48624,28263,910026,-4533,120777,302249,32198,3270,45507,114123,15541,12271,402470,2010
66," ""51179""","Stafford, VA",2609110,145467,353741,285536,4542440,-2942,-3353,288235,6132424,231715,47202,6129482,2221565,1018048,568994,129857,11659,228362,496509,51543,39884,1884239,2010
67," ""51181""","Surry, VA",233426,13407,40595,23806,146916,650,-389,25310,232667,6149,33118,233317,-61200,33384,53017,7045,620,5760,52498,3041,2421,175168,2010
68," ""51183""","Sussex, VA",179112,11778,27047,19198,178102,4302,2706,21377,312428,9177,26366,316730,20367,45192,93436,12013,806,11883,36646,4658,3852,130583,2010
69," ""51185""","Tazewell, VA",799434,56568,109218,85610,761533,-679,-1545,99373,1412414,67724,31290,1411735,61472,210566,439636,45118,3619,66179,152023,21522,17903,581232,2010
70," ""51187""","Warren, VA",599368,38764,73879,63878,946945,-2978,-3729,70703,1434356,71774,38150,1431378,418280,255112,229321,37520,4244,68045,105818,16578,12334,425505,2010
71," ""51193""","Westmoreland, VA",161104,13075,21252,16098,301796,4984,-98,21124,586628,23246,33820,591612,161816,143748,146068,17493,2005,23148,29301,5902,3897,108655,2010
72," ""51197""","Wythe, VA",508117,35021,73679,55314,462018,-992,-3509,62678,838417,46098,28628,837425,16579,122466,252941,29252,3188,42589,101336,15230,12042,364192,2010
73," ""51510""","Alexandria (Independent City), VA",10033478,549450,1045199,1056772,8022104,0,0,1077836,10670343,1340703,75818,10670343,-933538,2015709,632530,140737,19658,1340703,1573585,123544,103886,7119190,2010
74," ""51550""","Chesapeake (Independent City), VA",5278047,314475,626508,581080,6612926,7047,2044,605015,9405681,400790,42110,9412728,1939894,1498536,1301266,223525,20055,402834,917048,121599,101544,3958165,2010
75," ""51650""","Hampton (Independent City), VA",4218730,229078,677540,509174,3025065,0,0,483665,4895276,150186,35623,4895276,-710000,863539,1006672,137418,9371,150186,932127,76859,67488,3136417,2010
76," ""51700""","Newport News (Independent City), VA",6471769,352095,1002773,722196,4027407,0,0,713193,6261985,299554,34615,6261985,-1731169,1016715,1217863,180905,13145,299554,1363871,119543,106398,4808344,2010
77," ""51710""","Norfolk (Independent City), VA",13400189,648567,2251879,1658104,4892106,0,0,1477619,8260186,528339,33990,8260186,-7030464,1710964,1657116,243019,18096,528339,3080931,210781,192685,9790919,2010
78," ""51740""","Portsmouth (Independent City), VA",3354655,178576,601175,401362,1943423,0,0,379257,3298129,89665,34551,3298129,-1031975,544975,809731,95457,6700,89665,801856,57359,50659,2463134,2010
79," ""51760""","Richmond (Independent City), VA",11523164,653448,1391777,1171514,5010151,0,0,1239205,8615326,970669,42155,8615326,-5273808,1947396,1657779,204375,19211,970669,1977534,177780,158569,8574961,2010
80," ""51770""","Roanoke (Independent City), VA",3861531,231867,467322,452510,1947219,0,0,458122,3431805,270601,35481,3431805,-1456190,603840,880746,96722,8416,270601,693577,79022,70606,2897353,2010
81," ""51800""","Suffolk (Independent City), VA",1536035,95390,191715,162448,2410385,10411,263,176614,3578560,160530,42293,3588971,1050964,598669,579917,84859,8207,160793,272939,34728,26521,1102303,2010
82," ""51810""","Virginia Beach (Independent City), VA",10653650,597166,1447682,1223654,12864513,-107,-1718,1208993,19605681,715138,44673,19605574,3419856,4159945,2581116,438864,46407,713420,2059509,240301,193894,7880721,2010
83," ""51901""","Albemarle + Charlottesville, VA*",5972951,341821,735779,581248,4301638,-1140,-10408,632445,7269881,854558,50950,7268741,-1038868,2180543,786560,142663,22196,844150,1026403,112944,90748,4102398,2010
84," ""51903""","Alleghany + Covington, VA*",451606,31611,57444,51702,381859,-2042,-2322,57462,705647,19217,31774,703605,-12285,102743,219003,22144,1352,16895,83295,9903,8551,351416,2010
85," ""51907""","Augusta, Staunton + Waynesboro, VA*",2645300,168149,311520,249184,2661947,25922,17366,292741,4214321,491765,35837,4240243,309388,687639,890657,118320,12993,509131,436112,61243,48250,1700057,2010
86," ""51911""","Campbell + Lynchburg, VA*",3741501,231095,438196,418562,2352101,-1582,-3650,440376,4174623,216541,31986,4173041,-949024,661918,1159022,130463,12131,212891,647477,84221,72090,2881133,2010
87," ""51913""","Carroll + Galax, VA*",542785,40044,72274,58726,528765,503,-1473,69407,1045447,59019,28223,1045950,55387,141879,375306,37060,3324,57546,101637,16507,13183,383602,2010
88," ""51918""","Dinwiddie, Colonial Heights + Petersburg, VA*",1536263,99757,214173,172952,1433823,-834,-2167,186233,2653132,71386,34047,2652298,83793,401571,816904,77902,7023,69219,300649,40567,33544,1166395,2010
89," ""51919""","Fairfax, Fairfax City + Falls Church, VA*",63086221,3615818,5624116,6630788,54739464,5080,3283,6931212,74393381,4272169,66356,74398461,-1415545,14981389,4677608,1121203,160270,4275452,8939510,825687,665417,49871259,2010
90," ""51921""","Frederick + Winchester, VA*",2835377,170188,337379,310148,2783215,-1373,-6090,325262,4066412,240798,38827,4065039,273100,664475,617349,104695,12328,234708,492453,63784,51456,2108216,2010
91," ""51923""","Greensville + Emporia, VA*",341882,21955,53412,39646,250481,-1081,-1963,41778,456491,6921,25087,455410,-49623,62060,142869,18153,1049,4958,73235,9700,8651,263689,2010
92," ""51929""","Henry + Martinsville, VA*",1147695,82995,150434,130086,1021546,6895,6056,148038,2061005,94748,30460,2067900,21889,357100,689254,67888,5378,100804,215477,31700,26322,831414,2010
93," ""51931""","James City + Williamsburg, VA*",2202378,137276,260639,224470,2570187,538,28,249511,4225552,314646,51926,4226090,617320,1052988,602915,81387,10585,314674,372874,54242,43657,1514830,2010
94," ""51933""","Montgomery + Radford, VA*",2485330,144575,393282,270208,1893779,1340,-1664,279679,3080957,114273,27770,3082297,-311872,622919,565599,110992,10195,112609,528386,59620,49425,1844335,2010
95," ""51939""","Pittsylvania + Danville, VA*",1755419,122658,232083,199642,1613427,19049,11608,222479,3037908,100883,28700,3056957,80487,456552,986978,106516,8866,112491,331904,48651,39785,1311024,2010
96," ""51941""","Prince George + Hopewell, VA*",2061943,102788,385820,254028,1126787,-4426,-4762,229802,1880578,45216,32190,1876152,-705354,346436,402929,58283,3318,40454,512834,33083,29765,1508655,2010
97," ""51942""","Prince William, Manassas + Manassas Park, VA*",9406817,532989,1109127,1018060,16640490,-1467,-4229,1042019,21619488,991213,47114,21618021,8275692,3171084,1806447,458846,48365,986984,1618157,194469,146104,6801676,2010
98," ""51944""","Roanoke + Salem, VA*",3636193,223291,445014,380032,3187853,55,-602,413307,4908468,375945,41841,4908523,-35033,857974,862696,117313,12907,375343,635030,76166,63259,2625820,2010
99," ""51945""","Rockbridge, Buena Vista + Lexington, VA*",660296,44831,83256,73702,611927,-4616,-6539,81682,1141453,81835,31574,1136837,33313,249892,275018,36006,4537,75296,120107,18915,14378,464893,2010
100," ""51947""","Rockingham + Harrisonburg, VA*",3190852,184707,398518,324182,2490235,113905,97240,346798,3725301,299453,30613,3839206,-353819,665920,683051,125412,15069,396693,560609,77309,62240,2233550,2010
101," ""51949""","Southampton + Franklin, VA*",368975,25669,56306,39264,446150,-1888,-5576,45301,813672,28223,29822,811784,122476,134589,231045,27221,2404,22647,75938,11031,8627,270390,2010
102," ""51951""","Spotsylvania + Fredericksburg, VA*",2918452,176265,348717,321702,4311356,-1551,-3027,337116,6165076,201664,41833,6163525,1730020,1059355,792814,147337,13795,198637,509568,73195,59400,2210247,2010
103," ""51953""","Washington + Bristol, VA*",1736182,113797,212118,172690,1423545,-1566,-4702,200142,2496834,257489,34306,2495268,-112495,428945,642778,72735,8232,252787,298463,41679,33447,1184932,2010
104," ""51955""","Wise + Norton, VA*",1113086,73469,142784,125470,755124,1034,930,136204,1385696,50591,30419,1386730,-221758,161784,469822,45587,2968,51521,205519,23933,20965,856046,2010
105," ""51958""","York + Poquoson, VA*",1296236,79002,175479,140030,2594342,1514,782,149017,3773807,136562,48794,3775321,1447123,755248,425731,77372,6503,137344,245494,32059,25556,913398,2010
0," ""51000""",Virginia,272116862,12328968,30466061,29588324,261869982,606655,388840,27123130,385377798,24374362,47638,385984453,16876250,72698608,51415863,8102437,921009,24763202,45260223,4802678,3881669,202093437,2011
1," ""51001""","Accomack, VA",647359,33489,86457,66730,597117,35831,30404,66854,1093129,56764,33977,1128960,16612,225985,305858,33227,3843,87168,119822,17567,13724,440369,2011
2," ""51007""","Amelia, VA",145591,8186,14157,12752,268860,20378,17176,14562,413927,24755,34071,434305,137831,61969,103476,12747,1713,41931,20533,4323,2610,83127,2011
3," ""51009""","Amherst, VA",448764,26322,60793,48132,584024,-1790,-2453,50388,992016,39023,30791,990226,185648,144577,261625,32160,2916,36570,84859,12514,9598,327335,2011
4," ""51011""","Appomattox, VA",149727,10290,19904,15736,278183,-2004,-2670,18158,478660,19958,31558,476656,146614,65856,132617,15104,1709,17288,27772,5201,3492,104667,2011
5," ""51013""","Arlington, VA",21024532,853232,2425999,2289728,13664715,0,0,1998096,17775526,1758438,82264,17775526,-5361721,3276096,834715,216078,28092,1758438,3570863,215762,187670,15695231,2011
6," ""51017""","Bath, VA",117222,6331,12782,12356,99629,-469,-915,12509,205431,20488,44031,204962,-5084,63118,42215,4655,659,19573,18960,2994,2335,78689,2011
7," ""51019""","Bedford, VA*",991258,60410,106962,104002,1782465,-3182,-4838,112411,2831957,156843,37440,2828775,903618,475873,570437,75555,9455,152005,158963,29546,20091,680290,2011
8," ""51021""","Bland, VA",113793,6432,18616,12080,112492,-474,-843,12472,200889,8505,29577,200415,11171,30274,57649,6776,814,7662,24656,2867,2053,81475,2011
9," ""51023""","Botetourt, VA",505964,29126,56065,53496,904858,-259,-1436,55874,1368916,71116,41473,1368657,454768,224858,238941,33001,4115,69680,82813,13454,9339,353471,2011
10," ""51025""","Brunswick, VA",185538,11508,26366,20356,231794,5522,3937,21686,459071,10528,27139,464593,67942,67288,165511,17119,1255,14465,36544,5802,4547,134529,2011
11," ""51027""","Buchanan, VA",533574,31325,59977,59342,392558,-313,-358,60996,760808,32149,31907,760495,-80020,94304,273633,23835,1246,31791,89648,10061,8815,412135,2011
12," ""51029""","Buckingham, VA",180016,10525,24209,17282,241553,6909,5935,19166,415690,22814,24545,422599,80703,62350,118696,17217,1345,28749,32850,4763,3418,118417,2011
13," ""51033""","Caroline, VA",302218,17173,43440,32044,656162,3576,1932,33195,992135,32213,34728,995711,387139,144701,194848,28672,2562,34145,59462,8372,5810,208611,2011
14," ""51036""","Charles City, VA",96846,5576,10325,9672,154190,4965,3925,10412,248313,13642,35178,253278,67756,42289,56799,7200,538,17567,15161,2196,1658,64118,2011
15," ""51037""","Charlotte, VA",131214,8972,18134,12466,170713,4328,2839,15205,344037,21060,27876,348365,54704,58586,119066,12497,1924,23899,24367,4845,2921,82948,2011
16," ""51041""","Chesterfield, VA",7186141,341305,809199,794722,9953773,1169,439,738666,14122768,542421,44090,14123937,3506298,2345907,1824257,320344,36693,542860,1206560,158757,122064,5436721,2011
17," ""51043""","Clarke, VA",265518,13712,23035,24664,498013,7929,4409,26044,751053,62043,53461,758982,258539,175338,85631,14197,2755,66452,35367,6902,4147,163699,2011
18," ""51045""","Craig, VA",36355,2923,4824,3396,91634,-669,-1091,4621,159731,8240,30766,159062,59900,26618,40810,5170,608,7149,6522,1338,730,22684,2011
19," ""51047""","Culpeper, VA",882575,44461,98226,88786,1247606,4660,66,88854,1838669,145964,38932,1843329,453885,303679,292044,47347,6373,146030,142619,21888,15515,593926,2011
20," ""51049""","Cumberland, VA",73266,4973,8765,6124,167604,9423,8505,8035,277511,12241,28731,286934,102373,40625,78705,9987,765,20746,11827,2191,1426,40693,2011
21," ""51051""","Dickenson, VA",222703,14958,27152,23074,224001,-1656,-1711,26495,453888,18489,28662,452232,27793,50475,177756,15778,784,16778,38689,4960,4176,167236,2011
22," ""51057""","Essex, VA",179830,10120,20686,18588,216072,4757,4033,19414,379487,21147,34406,384244,55656,70025,98147,11168,1286,25180,29980,5332,4046,124670,2011
23," ""51061""","Fauquier, VA",1501670,73562,140913,144620,2602793,-4345,-14701,145872,3918363,313415,59275,3914018,1246995,955067,356158,66032,10419,298714,213223,33041,22622,989733,2011
24," ""51063""","Floyd, VA",146776,9958,16534,13286,281220,3736,309,16601,474031,36031,31016,477767,151045,77934,118613,15404,2500,36340,23177,5673,3173,87259,2011
25," ""51065""","Fluvanna, VA",252357,15811,31775,24140,587642,-481,-983,27881,939645,47685,36179,939164,363166,190683,160839,25959,2856,46702,43845,7499,4643,161810,2011
26," ""51067""","Franklin, VA",681378,42181,72615,67582,1080009,18717,14664,75972,1849281,128300,33156,1867998,474603,336672,451317,56339,6985,142964,106406,21093,14108,432008,2011
27," ""51071""","Giles, VA",282378,16526,37350,30604,321702,-930,-1324,31828,559417,27930,32561,558487,71152,81091,155694,17152,1795,26606,52652,7128,5333,203120,2011
28," ""51073""","Gloucester, VA",452478,26158,54949,44718,982175,2823,2311,48517,1548875,66421,42055,1551698,578214,311052,258471,36897,3720,68732,77308,13740,10020,306438,2011
29," ""51075""","Goochland, VA",1093080,50538,95667,109668,1022711,1021,-533,105372,1645435,65002,76448,1646456,35003,452458,171287,21537,3505,64469,150501,15760,12255,878110,2011
30," ""51077""","Grayson, VA",113363,9921,15199,11012,205555,1752,286,15427,419478,20776,27410,421230,107619,62924,152751,15368,2020,21062,20705,4645,2625,71596,2011
31," ""51079""","Greene, VA",205998,11902,20423,19970,443095,1351,610,21887,662049,40849,35487,663400,258984,109794,110511,18694,1959,41459,30408,5812,3853,134131,2011
32," ""51083""","Halifax, VA",585278,33921,81247,63724,547287,7974,5013,65783,1041797,45890,29163,1049771,27792,166241,336243,35997,3428,50903,113109,16340,12912,421266,2011
33," ""51085""","Hanover, VA",2523717,121871,258468,279326,3311534,10528,4461,261534,4706028,247558,47213,4716556,1049351,816972,588050,99899,13159,252019,398131,61402,48243,1873567,2011
34," ""51087""","Henrico, VA",13022458,595448,1153647,1330582,10929359,1923,942,1260739,15469902,1888960,49845,15471825,-832360,2687114,1855352,310401,40134,1889902,1818938,223999,183865,9313618,2011
35," ""51091""","Highland, VA",29374,1821,3376,2248,32400,5068,4526,2945,76695,5066,36178,81763,5971,27933,21430,2260,677,9592,4500,1266,589,15282,2011
36," ""51093""","Isle of Wight, VA",571039,30861,58554,54638,1147764,12495,10974,58180,1646119,65233,46985,1658614,634905,249776,261074,35301,3578,76207,85873,13753,10175,408959,2011
37," ""51097""","King and Queen, VA",76681,4609,8818,7152,150389,4797,4021,8185,237807,15352,34727,242604,81893,36523,55692,6986,737,19373,12394,1897,1160,44914,2011
38," ""51099""","King George, VA",1089031,44567,171586,125684,774783,-2185,-2573,107409,1113454,69119,45775,1111269,-206839,215432,121054,24277,2309,66546,234428,13646,11337,788057,2011
39," ""51101""","King William, VA",203828,11311,22243,21100,408777,4166,3319,21861,592566,23157,37265,596732,226810,85673,102282,16013,1731,26476,32793,5361,3630,144559,2011
40," ""51103""","Lancaster, VA",238815,14608,25589,24126,199633,1487,1181,26671,511660,36599,45508,513147,-12511,186008,127506,11276,2002,37780,37652,7029,5027,163383,2011
41," ""51105""","Lee, VA",275134,18568,40887,29024,347628,-1608,-2351,33080,686210,28771,26799,684602,105574,82411,254563,25546,2240,26420,55399,8028,5788,193315,2011
42," ""51107""","Loudoun, VA",11263164,492742,1055773,1197048,17862928,-6147,-16076,1091266,21832892,1033533,66880,21826745,7691030,2978581,985236,326357,43157,1017457,1654297,190953,147796,8591410,2011
43," ""51109""","Louisa, VA",592210,30705,79446,58906,758318,41,-1150,60158,1181176,63986,35445,1181217,226266,193020,229879,33325,3702,62836,108899,12543,8841,420475,2011
44," ""51111""","Lunenburg, VA",124840,8146,16686,13268,168443,4688,3156,14780,340021,11913,26707,344709,58383,67619,108647,12907,969,15069,23320,3772,2803,86451,2011
45," ""51113""","Madison, VA",163249,9885,17043,15392,293813,1389,-954,17581,485684,39753,37062,487073,148145,104809,88451,13142,2051,38799,24739,5279,3228,99711,2011
46," ""51115""","Mathews, VA",88199,6754,8215,6862,210402,389,284,10185,423503,29989,47394,423892,132388,130713,82777,8944,1355,30273,11646,2969,1614,46280,2011
47," ""51117""","Mecklenburg, VA",542562,31800,71933,61314,481719,4145,35,62457,963989,38973,29727,968134,1614,178047,308368,32567,3073,39008,102590,16065,12992,400964,2011
48," ""51119""","Middlesex, VA",181090,11242,20590,15700,212637,2187,1266,19092,436114,42261,40378,438301,50639,117563,108101,10855,1755,43527,28440,5265,3510,109123,2011
49," ""51125""","Nelson, VA",191235,12270,20418,17080,320957,2446,44,20810,581298,49379,38867,583744,150532,126887,135900,15019,2676,49423,28958,6374,3698,112854,2011
50," ""51127""","New Kent, VA",204536,11774,23108,20308,839161,1407,1220,21928,1083898,37216,57843,1085305,656553,132651,113493,18763,2607,38436,33262,6592,3985,132838,2011
51," ""51131""","Northampton, VA",257552,12722,26580,24698,229582,42118,31886,25071,415626,25828,36897,457744,-2899,99938,128224,12406,1706,57714,38929,6686,4980,160909,2011
52," ""51133""","Northumberland, VA",137725,10713,14992,13380,187813,3800,3103,17403,484417,23134,39208,488217,67491,168255,132149,12452,1684,26237,21682,4406,2722,89806,2011
53," ""51135""","Nottoway, VA",282357,15203,46818,33832,224882,4809,3121,32119,461739,10534,29359,466548,-25356,84559,157107,15891,1506,13655,63734,7621,6115,204968,2011
54," ""51137""","Orange, VA",447923,26695,51025,43858,799457,9705,1355,48624,1325854,76947,39302,1335559,400158,275546,260556,33982,4265,78302,72954,13100,8835,296667,2011
55," ""51139""","Page, VA",295645,17689,34545,30394,434872,23125,20963,32886,742041,45248,31940,765166,172113,132875,197419,23956,2676,66211,49742,8867,6191,179692,2011
56," ""51141""","Patrick, VA",214899,14434,28137,22618,251731,2613,1027,25743,501452,31370,27486,504065,62575,81830,170504,18339,2269,32397,39446,7601,5332,143056,2011
57," ""51145""","Powhatan, VA",368278,19972,45193,36208,814984,923,311,38076,1163510,55703,41383,1164433,484782,192898,156551,28138,3321,56014,63297,10212,6891,248967,2011
58," ""51147""","Prince Edward, VA",406852,21022,54765,45396,306897,2991,2208,43720,571824,30927,25744,574815,-56235,99935,167983,22328,2205,33135,77463,11803,9598,296254,2011
59," ""51155""","Pulaski, VA",638299,35562,79236,73176,638598,3115,1971,72150,1118109,57248,32274,1121224,72449,167973,314653,34741,2641,59219,115824,15581,12940,463256,2011
60," ""51157""","Rappahannock, VA",119937,7161,9417,8502,220010,-1519,-2943,11412,390247,44299,51983,388728,111485,115925,52793,7478,1667,41356,13668,3287,1620,64913,2011
61," ""51159""","Richmond, VA",146202,7791,21125,15132,138654,4337,2620,15357,252772,10530,27934,257109,7809,50721,67734,9204,915,13150,28691,3979,3064,104361,2011
62," ""51167""","Russell, VA",379025,24950,47377,42746,468176,-1180,-2595,46323,857904,41490,29871,856724,135474,100790,287758,28681,2539,38895,68750,10122,7583,271380,2011
63," ""51169""","Scott, VA",227226,17342,29899,25020,336856,-3607,-4168,29852,664302,24160,28660,660695,139482,96502,227337,23053,2782,19992,42409,8082,5300,164825,2011
64," ""51171""","Shenandoah, VA",674038,37413,77813,68026,877241,19729,16826,71426,1462751,95144,35075,1482480,274629,293074,312165,42266,5779,111970,111826,19994,14215,450242,2011
65," ""51173""","Smyth, VA",577014,32981,78619,63818,514296,4058,2589,64890,947668,54293,29691,951726,2172,131797,305633,32054,3319,56882,110528,15631,12312,409604,2011
66," ""51179""","Stafford, VA",2847109,123203,381445,317458,4746637,-2869,-3228,281932,6432827,241485,48619,6429958,2181460,1074467,608854,132251,12211,238257,540174,54515,42304,2068678,2011
67," ""51181""","Surry, VA",243835,10697,41471,25088,149598,5184,4421,23241,233201,5364,34434,238385,-70996,35316,53471,6923,544,9785,54015,3047,2503,180035,2011
68," ""51183""","Sussex, VA",188183,9635,26566,19534,182658,11154,9904,19402,310801,7995,26634,321955,13877,44704,94593,12088,842,17899,36333,4709,3867,133951,2011
69," ""51185""","Tazewell, VA",814565,47097,102781,88368,799985,802,10,91281,1466417,72104,32799,1467219,76701,218541,448693,44733,3820,72114,146965,21520,17700,595486,2011
70," ""51187""","Warren, VA",609945,31877,70147,65310,1002942,-1978,-2621,64532,1527094,79432,40503,1525116,457529,284037,238137,37654,4303,76811,102802,16709,12406,430332,2011
71," ""51193""","Westmoreland, VA",170549,11549,20397,16700,320056,9632,5372,19899,611489,25099,35213,621121,169406,150503,150562,17639,2046,30471,28747,5982,3936,111331,2011
72," ""51197""","Wythe, VA",521939,29269,70964,57736,472099,3012,822,58137,849333,45995,29186,852345,8297,124023,256223,29204,3382,46817,99832,15596,12214,375290,2011
73," ""51510""","Alexandria (Independent City), VA",9734373,412601,968463,1032978,8404833,0,0,929090,11272972,1327448,78139,11272972,-400450,2211781,656358,144269,20323,1327448,1484952,120806,100483,6921973,2011
74," ""51550""","Chesapeake (Independent City), VA",5328484,249261,596790,596850,6801187,7766,3671,547686,9774458,409945,43407,9782224,2020389,1623524,1357513,225360,20778,413616,895215,122009,101231,4019653,2011
75," ""51650""","Hampton (Independent City), VA",4203178,178264,670845,515450,3056879,0,0,435989,5004658,154635,36623,5004658,-710310,899616,1048163,136652,9710,154635,928570,76136,66426,3119973,2011
76," ""51700""","Newport News (Independent City), VA",6729514,284697,963168,760158,4206635,0,0,664776,6567503,398988,36458,6567503,-1858103,1093520,1267348,180139,13840,398988,1343247,119929,106089,4987279,2011
77," ""51710""","Norfolk (Independent City), VA",13211127,490282,2204381,1696576,4846825,0,0,1338570,8428774,355861,34587,8428774,-7025732,1860557,1721392,243701,19712,355861,3052669,210323,190611,9802597,2011
78," ""51740""","Portsmouth (Independent City), VA",3504498,144396,631821,425890,2002124,0,0,357341,3420267,109047,35714,3420267,-1145033,577345,840798,95767,6971,109047,844766,58015,51044,2550685,2011
79," ""51760""","Richmond (Independent City), VA",11662573,509990,1322167,1204684,5411232,0,0,1112332,9303034,1126620,45054,9303034,-5139009,2192227,1699575,206487,21430,1126620,1924509,181036,159606,8611444,2011
80," ""51770""","Roanoke (Independent City), VA",3969888,186646,448760,472350,2027730,0,0,422821,3555924,312037,36738,3555924,-1519337,631963,896231,96791,8969,312037,684935,79751,70782,2972916,2011
81," ""51800""","Suffolk (Independent City), VA",1565506,77432,184426,167948,2467011,15401,6748,161406,3691253,166656,43706,3706654,1062911,629248,610395,84808,8510,173404,268400,35183,26673,1123702,2011
82," ""51810""","Virginia Beach (Independent City), VA",11143035,487976,1460255,1288116,13387358,4022,2676,1132034,20514218,851578,46353,20518240,3376357,4439951,2690931,442654,48029,854254,2104313,241829,193800,8184468,2011
83," ""51901""","Albemarle + Charlottesville, VA*",6031959,268098,724048,605106,4405347,706,-7579,570651,7648179,770186,53113,7648885,-1055961,2435184,808354,144011,22618,762607,1026601,114353,91735,4242751,2011
84," ""51903""","Alleghany + Covington, VA*",455355,26042,55598,53004,387800,-2005,-2275,52544,723924,19466,32697,721919,-15011,110956,223163,22079,1352,17191,82100,9816,8464,356064,2011
85," ""51907""","Augusta, Staunton + Waynesboro, VA*",2593517,137987,296578,256990,2664051,42642,35707,266482,4287429,394185,36455,4330071,337016,743697,922323,118778,13116,429892,425073,61537,48421,1738552,2011
86," ""51911""","Campbell + Lynchburg, VA*",3790577,184741,416189,431416,2397175,1311,-469,400449,4336203,234234,33007,4337514,-992953,701983,1238356,131413,12054,233765,631897,84317,72263,2924915,2011
87," ""51913""","Carroll + Galax, VA*",542550,33242,67215,59216,542200,4448,2668,62850,1065247,62629,28960,1069695,62500,144507,382988,36937,3352,65297,96823,16312,12960,380430,2011
88," ""51918""","Dinwiddie, Colonial Heights + Petersburg, VA*",1563767,80665,203750,176636,1490060,7529,6465,168983,2762523,81600,35745,2770052,95276,432946,847046,77495,7270,88065,292068,40780,33510,1183634,2011
89," ""51919""","Fairfax, Fairfax City + Falls Church, VA*",66170787,2894463,5612252,6968558,58373508,3522,1878,6378742,80061140,5284726,70311,80064662,-1418537,16750601,4940553,1138729,164309,5286604,9096531,838615,674306,51787652,2011
90," ""51921""","Frederick + Winchester, VA*",2977775,140113,332165,328590,2963385,1825,-1966,304408,4317430,290474,40678,4319255,290018,728709,627161,106182,12957,288508,496460,65812,52855,2192807,2011
91," ""51923""","Greensville + Emporia, VA*",357427,17849,50867,40912,259220,9555,8769,38305,461912,8450,26425,471467,-59902,63119,149128,17842,1059,17219,71323,9772,8713,268885,2011
92," ""51929""","Henry + Martinsville, VA*",1117840,67735,140519,128066,1027253,7101,6424,131768,2093725,91896,31285,2100826,41181,366548,707025,67152,5939,98320,204552,31797,25858,814968,2011
93," ""51931""","James City + Williamsburg, VA*",2159849,108542,243010,225234,2695456,-12,-488,221159,4493822,296861,54514,4493810,756766,1162626,635728,82434,10740,296373,355627,53506,42766,1507849,2011
94," ""51933""","Montgomery + Radford, VA*",2499064,114000,377298,275018,1948941,4044,1492,251509,3208500,106784,28792,3212544,-298614,685115,578488,111578,10480,108276,514807,60038,49558,1875981,2011
95," ""51939""","Pittsylvania + Danville, VA*",1789949,102341,224717,206386,1662849,20326,13873,205534,3128730,106928,29729,3149056,78434,477419,1008788,105926,9569,120801,327910,50292,40723,1341238,2011
96," ""51941""","Prince George + Hopewell, VA*",2221648,84314,417687,279728,1157667,1034,717,224178,1946018,48975,32871,1947052,-839803,369602,419783,59234,3423,49692,557551,33901,30478,1614405,2011
97," ""51942""","Prince William, Manassas + Manassas Park, VA*",9886478,434594,1128219,1082030,17691964,-30,-2305,975609,23015506,1129268,48625,23015476,8781095,3398109,1925403,473323,51094,1126963,1669234,201788,150694,7090281,2011
98," ""51944""","Roanoke + Salem, VA*",3713873,180643,427946,402884,3281835,223,-382,382085,5043841,382397,42793,5044064,-49953,897022,865207,117871,13174,382015,629388,76410,63236,2702470,2011
99," ""51945""","Rockbridge, Buena Vista + Lexington, VA*",664022,36752,78745,74894,624721,-542,-2224,74199,1184100,83721,32748,1183558,34898,276584,282253,36141,4621,81497,116192,18803,14182,466333,2011
100," ""51947""","Rockingham + Harrisonburg, VA*",3270959,148991,379402,337166,2585398,131382,116220,317574,3908437,310656,31855,4039819,-367987,737025,717396,126818,15628,426876,547985,78824,63196,2296098,2011
101," ""51949""","Southampton + Franklin, VA*",393927,21164,52785,39444,477567,24301,20997,40886,843686,30888,32046,867987,124526,153147,237273,27086,2529,51885,72507,10962,8433,269535,2011
102," ""51951""","Spotsylvania + Fredericksburg, VA*",2972236,141913,324835,330386,4527283,387,-845,307106,6519609,228939,43375,6519996,1862153,1152784,839929,150316,14433,228094,490028,73457,59024,2254114,2011
103," ""51953""","Washington + Bristol, VA*",1791779,94677,200466,178952,1521216,2432,-276,184153,2687909,293791,37075,2690341,-86410,516921,652204,72565,8473,293515,289942,42037,33564,1208322,2011
104," ""51955""","Wise + Norton, VA*",1109799,58647,135829,128758,768909,1035,949,123026,1419634,49148,31191,1420669,-217864,165695,486065,45548,2944,50097,200208,24192,21248,859494,2011
105," ""51958""","York + Poquoson, VA*",1304530,64124,166428,146342,2623489,833,179,137295,3904856,133058,50177,3905689,1456254,831929,450271,77839,6632,133237,239599,32731,26099,931694,2011
0," ""51000""",Virginia,283275330,12672802,31077087,30649784,272126011,638401,325155,27997694,403541342,28366026,49366,404179743,16848375,80147376,51906356,8187456,930360,28691181,46401979,4856886,3926526,208182170,2012
1," ""51001""","Accomack, VA",686271,34773,89012,71102,619517,33910,26841,70324,1155672,68692,35749,1189582,3570,261375,308690,33276,3808,95533,124563,17588,13780,466175,2012
2," ""51007""","Amelia, VA",163259,8637,14592,13444,288481,22276,17603,15359,434426,35975,35845,456702,140581,65995,102226,12741,1642,53578,21314,4255,2613,88367,2012
3," ""51009""","Amherst, VA",466205,26648,62966,49788,594634,-812,-1783,51542,1021395,42913,31268,1020583,179971,165632,260317,32640,2850,41130,87860,12588,9738,337215,2012
4," ""51011""","Appomattox, VA",145833,9916,19185,14856,281679,83,-1000,17344,484514,20456,31798,484597,153190,74054,128864,15240,1688,19456,26613,5079,3391,99764,2012
5," ""51013""","Arlington, VA",20468349,830188,2259658,2224418,14231522,0,0,1942397,18580002,1948098,83839,18580002,-4294430,3563474,785006,221614,28965,1948098,3371867,212248,183283,15148384,2012
6," ""51017""","Bath, VA",120612,6317,12631,11940,104143,41,-589,12287,230329,20845,49627,230370,-4182,81789,44438,4642,628,20256,18601,3012,2384,81755,2012
7," ""51019""","Bedford, VA*",1033559,61273,109436,107844,1853787,-2085,-4380,115195,2978842,174373,39295,2976757,935423,543111,579859,75755,9466,169993,163358,29755,20289,700208,2012
8," ""51021""","Bland, VA",114941,6373,18443,12132,114733,-47,-500,12439,203608,10384,30414,203561,12231,31530,57298,6693,800,9884,24509,2874,2074,80548,2012
9," ""51023""","Botetourt, VA",552442,30492,61127,59188,925547,525,-1152,60086,1419429,79902,42872,1419954,433191,249702,244705,33121,3984,78750,90721,13837,9853,382971,2012
10," ""51025""","Brunswick, VA",197539,11811,27375,21478,239258,7837,5466,22550,463176,13137,27669,471013,64269,72336,159419,17023,1231,18603,38114,5768,4537,140822,2012
11," ""51027""","Buchanan, VA",544748,31165,64893,60684,398844,-99,-167,61507,766494,33909,32154,766395,-84397,96531,271020,23835,1242,33742,95235,10191,8949,415771,2012
12," ""51029""","Buckingham, VA",191638,10899,25361,18670,246671,7110,5674,20234,424552,24626,25286,431662,75267,65106,119885,17071,1344,30300,34696,4886,3542,126642,2012
13," ""51033""","Caroline, VA",305835,17303,42935,32212,674912,2426,23,33409,1045007,37376,36181,1047433,402486,172854,199667,28950,2658,37399,59041,8528,5870,209395,2012
14," ""51036""","Charles City, VA",100342,5620,10768,10550,158982,5803,4254,10895,259750,12010,37281,265553,69535,50624,55947,7123,520,16264,16043,2260,1740,68035,2012
15," ""51037""","Charlotte, VA",139376,9081,18888,13296,177734,4523,2260,15729,351113,23594,28680,355636,54087,61775,116127,12400,1901,25854,25536,4900,2999,87986,2012
16," ""51041""","Chesterfield, VA",7650014,358589,834263,841862,10411153,1500,340,779520,14913476,656699,46042,14914976,3540659,2624635,1879188,323942,36786,657039,1255194,163408,126622,5737781,2012
17," ""51043""","Clarke, VA",276303,13570,23671,25790,499676,12824,7829,26465,748897,61491,53435,761721,249838,174358,87687,14255,2691,69320,36566,6797,4106,170417,2012
18," ""51045""","Craig, VA",37705,2939,4658,3410,97988,-599,-1251,4644,169667,9684,32899,169068,64927,29173,41907,5139,639,8433,6363,1357,718,22909,2012
19," ""51047""","Culpeper, VA",946261,46007,101981,94072,1299315,7195,173,93043,1929944,169812,40484,1937139,446097,338980,298844,47850,6454,169985,149017,22484,16030,627259,2012
20," ""51049""","Cumberland, VA",74649,4976,8827,6290,175247,8778,7431,8121,291937,13825,30545,300715,108719,44164,81304,9845,764,21256,11972,2166,1402,41421,2012
21," ""51051""","Dickenson, VA",220684,14576,28113,23042,214696,-1884,-1961,26097,444110,19712,28153,442226,20109,52792,174738,15708,810,17751,39634,4889,4079,163299,2012
22," ""51057""","Essex, VA",184458,10183,21280,19320,219073,3983,2914,19843,392824,22580,35642,396807,54458,76402,101332,11133,1259,25494,30940,5419,4160,128024,2012
23," ""51061""","Fauquier, VA",1563210,73857,147281,150618,2702560,-406,-15277,149166,4118301,326816,61861,4117895,1288516,1051827,363508,66567,10384,311539,222590,33708,23324,1029081,2012
24," ""51063""","Floyd, VA",153668,10004,17105,13922,293459,3526,-828,16965,495421,39477,32319,498947,156756,85242,120246,15438,2523,38649,24066,5732,3209,90953,2012
25," ""51065""","Fluvanna, VA",258410,15785,31086,24042,604795,283,-417,27806,960940,53378,37129,961223,374191,191902,164526,25889,2877,52961,43107,7406,4529,162342,2012
26," ""51067""","Franklin, VA",719991,43174,75833,73034,1092275,18268,12386,79691,1934137,130002,34683,1952405,451975,401303,458827,56293,6961,142388,112350,21482,14521,465253,2012
27," ""51071""","Giles, VA",289825,16670,37261,31146,334144,-725,-1350,32243,573761,32125,33660,573036,76562,84635,154257,17024,1706,30775,52834,7005,5299,206216,2012
28," ""51073""","Gloucester, VA",464691,26376,55488,45354,1002252,2270,1480,49053,1574786,76040,42798,1577056,586614,307498,267306,36849,3761,77520,78165,13870,10109,309006,2012
29," ""51075""","Goochland, VA",1197766,54797,99230,124158,1039414,2011,1,116876,1758981,66819,82143,1760992,-41476,556129,165449,21438,3457,66820,161309,16318,12861,969637,2012
30," ""51077""","Grayson, VA",114520,9754,15408,11140,209074,1631,-418,15324,419690,22261,27817,421321,109878,65628,146619,15146,1979,21843,20978,4563,2584,71699,2012
31," ""51079""","Greene, VA",216760,12183,20615,21012,462292,1086,-70,22689,691381,47594,36773,692467,268221,115535,114640,18831,1938,47524,31121,5760,3822,138115,2012
32," ""51083""","Halifax, VA",595828,34053,80967,66092,555503,8477,4210,67099,1072445,47662,30244,1080922,26774,189355,336064,35740,3332,51872,114013,16241,12909,429943,2012
33," ""51085""","Hanover, VA",2651843,125416,263340,291338,3438457,14045,5301,271085,4891504,299629,48889,4905549,1057699,870234,596858,100340,13222,304930,409009,62307,49085,1937904,2012
34," ""51087""","Henrico, VA",13911021,619299,1177718,1393542,11716757,2030,679,1316070,16635182,2357234,52720,16637212,-878194,3027518,1892937,315575,40172,2357913,1874489,230116,189944,9678619,2012
35," ""51091""","Highland, VA",31691,1809,3638,2396,33764,6457,5649,3007,76774,4739,37256,83231,5080,28590,20877,2234,698,10388,4836,1308,610,16467,2012
36," ""51093""","Isle of Wight, VA",602845,31774,63502,60826,1178772,9880,7832,62187,1702474,69782,48437,1712354,638114,268192,265390,35352,3534,77614,93915,14150,10616,431316,2012
37," ""51097""","King and Queen, VA",72095,4488,7679,6518,148746,3917,2701,7747,239311,15333,34707,243228,84398,38706,55776,7008,730,18034,10938,1873,1143,43123,2012
38," ""51099""","King George, VA",1107813,44942,178061,127164,795509,494,-58,108524,1153076,81356,46865,1153570,-203780,233295,124766,24615,2359,81298,241643,13562,11203,784872,2012
39," ""51101""","King William, VA",211991,11580,22542,21834,426198,2510,1749,22497,632244,29452,39729,634754,236704,102056,106500,15977,1729,31201,33459,5403,3674,147331,2012
40," ""51103""","Lancaster, VA",243699,14634,25901,24858,202978,12,-459,27063,537004,36605,48271,537016,-13658,203506,130532,11125,1958,36146,38330,7002,5044,169223,2012
41," ""51105""","Lee, VA",263929,17875,39748,27840,334099,-2459,-3553,31795,674349,31083,26418,671890,101965,89398,248393,25433,2366,27530,53668,7908,5542,182731,2012
42," ""51107""","Loudoun, VA",11783364,509942,1092733,1252710,18880461,-326,-15088,1136297,23428626,1052735,69335,23428300,8233394,3528008,1019831,337902,44494,1037647,1719088,195925,151431,9026629,2012
43," ""51109""","Louisa, VA",592528,30646,72297,60538,761253,324,-1433,60915,1213566,73305,36391,1213890,229640,217338,235299,33357,3705,71872,102566,12568,8863,418090,2012
44," ""51111""","Lunenburg, VA",128184,8285,17187,13906,170431,1973,-412,15238,343414,13010,27327,345387,57485,68999,105957,12639,991,12598,24140,3772,2781,91446,2012
45," ""51113""","Madison, VA",201722,11032,17696,15878,340271,2487,-944,18971,543428,73265,41562,545915,157520,114164,91480,13135,2050,72321,25635,5307,3257,103766,2012
46," ""51115""","Mathews, VA",89328,6572,8265,6738,215768,320,265,9941,425275,32193,47761,425595,136381,125257,84570,8911,1339,32458,11634,2953,1614,45236,2012
47," ""51117""","Mecklenburg, VA",543727,31412,70361,61374,491094,8508,2430,62099,986969,43135,31405,995477,9466,190855,313528,31698,2973,45565,101048,15725,12752,397114,2012
48," ""51119""","Middlesex, VA",183792,11004,20720,15578,216118,2332,980,18793,457776,47534,42402,460108,51119,132418,111572,10851,1795,48514,28509,5279,3484,106769,2012
49," ""51125""","Nelson, VA",208367,12557,21628,17544,338133,4748,1362,21329,617365,57300,42029,622113,151095,148439,135541,14802,2709,58662,30400,6539,3830,119305,2012
50," ""51127""","New Kent, VA",224070,12487,23920,21778,890540,1363,1105,23376,1166244,45896,60978,1167607,689846,158575,118492,19148,2724,47001,34809,6748,4024,142260,2012
51," ""51131""","Northampton, VA",259852,12475,26783,24318,242241,43459,29433,24634,440618,31722,39649,484077,7023,111531,130305,12209,1721,61155,38942,6522,4801,159755,2012
52," ""51133""","Northumberland, VA",141467,10753,15718,13750,197666,2431,1405,17628,518635,27653,41950,521066,73827,186444,136956,12421,1682,29058,22593,4399,2717,89816,2012
53," ""51135""","Nottoway, VA",284448,15202,47872,34258,217380,3755,1204,32331,456914,10965,29234,460669,-34737,87604,155685,15758,1479,12169,65001,7540,6061,207278,2012
54," ""51137""","Orange, VA",485768,27735,54661,47104,851691,9140,-3006,51287,1437327,89064,42217,1446467,417210,319623,275153,34263,4320,86058,78213,13455,9135,321497,2012
55," ""51139""","Page, VA",290296,17336,32792,30102,431223,20274,17019,32387,741313,47761,31944,761587,173314,134063,196301,23841,2654,64780,47843,8659,6005,177673,2012
56," ""51141""","Patrick, VA",226867,14674,29082,23660,264002,3421,1324,26504,512155,36306,28114,515576,63639,80142,171432,18339,2254,37630,40912,7660,5406,148325,2012
57," ""51145""","Powhatan, VA",404257,21167,48535,39662,854737,1067,172,40998,1241248,65340,44076,1242315,491478,223681,163897,28186,3286,65512,68366,10599,7313,270379,2012
58," ""51147""","Prince Edward, VA",428807,21644,57030,46870,322332,3918,2776,45079,596548,38496,25897,600466,-61396,107950,170184,23187,2191,41272,80465,11789,9598,307070,2012
59," ""51155""","Pulaski, VA",670264,36234,84557,78618,670759,3623,1944,75543,1164017,59972,33617,1167640,76038,176096,320785,34734,2693,61916,123866,16290,13597,484482,2012
60," ""51157""","Rappahannock, VA",131534,7275,10443,8972,229454,327,-1809,11761,405990,46736,54804,406317,109681,123764,53099,7414,1680,44927,14929,3380,1700,71678,2012
61," ""51159""","Richmond, VA",149007,7738,21105,15240,142594,4896,2230,15358,265342,12083,29775,270238,8945,57420,70224,9076,925,14313,28725,3917,2992,105969,2012
62," ""51167""","Russell, VA",397302,25321,49054,44526,462138,-1852,-4050,47584,853632,46574,29962,851780,112420,109987,279655,28429,2512,42524,71317,10213,7701,283461,2012
63," ""51169""","Scott, VA",228103,17072,29625,25170,338303,-3508,-4284,29657,660467,27652,28618,656959,139857,94140,224516,22956,2730,23368,42210,7960,5230,162525,2012
64," ""51171""","Shenandoah, VA",710410,38180,78585,70542,926344,22249,17978,73451,1518647,115816,36229,1540896,289385,292996,321556,42532,5710,133794,113856,19804,14094,462760,2012
65," ""51173""","Smyth, VA",589807,33154,80407,65692,532947,2336,226,66000,975835,60938,30653,978171,9140,141777,303447,31911,3214,61164,113253,15495,12281,415390,2012
66," ""51179""","Stafford, VA",2991538,127949,404128,333718,4847358,-3295,-3824,294808,6624168,270734,49614,6620873,2150628,1144119,629396,133449,12220,266910,570987,55593,43373,2153641,2012
67," ""51181""","Surry, VA",233593,10433,35157,23882,151336,6527,5583,22374,234832,6076,35266,241359,-59883,36519,53504,6844,553,11659,47098,2937,2384,174836,2012
68," ""51183""","Sussex, VA",195798,9824,26815,20482,183274,11800,10156,20065,311247,8751,27085,323047,7541,45837,93936,11927,778,18907,37056,4627,3849,139835,2012
69," ""51185""","Tazewell, VA",813170,46053,103632,87598,807156,1274,53,89852,1492570,79500,33739,1493844,83838,246378,440310,44276,3756,79553,147431,21227,17471,586186,2012
70," ""51187""","Warren, VA",658948,33455,72760,70744,1041722,-1020,-1952,68827,1519970,93640,40080,1518950,451601,233137,244091,37898,4255,91688,108132,16879,12624,459128,2012
71," ""51193""","Westmoreland, VA",173156,11453,20349,16850,322526,10522,4513,19878,630759,27688,36613,641281,169248,162369,156386,17515,2035,32201,28774,5836,3801,112181,2012
72," ""51197""","Wythe, VA",537564,29553,72280,60188,473410,1954,-1249,59647,876466,49941,29949,878420,-4507,140552,264458,29331,3425,48692,102374,15646,12221,386498,2012
73," ""51510""","Alexandria (Independent City), VA",10183159,426710,1010887,1072508,8803589,0,0,962964,11951904,1511310,81096,11951904,-416606,2498919,649396,147379,21222,1511310,1547141,122492,101270,7124708,2012
74," ""51550""","Chesapeake (Independent City), VA",5472022,253173,605181,624282,6989519,7582,1955,565314,10059301,414931,44127,10066883,2082811,1693668,1383696,228134,20633,416886,917322,122642,102009,4137814,2012
75," ""51650""","Hampton (Independent City), VA",4176014,177867,654348,513412,3087448,0,0,434573,5066199,171370,36920,5066199,-653993,897842,1080909,137222,9832,171370,911054,76460,66628,3093590,2012
76," ""51700""","Newport News (Independent City), VA",7111851,295111,1031341,819202,4302405,0,0,704712,6718946,432695,37297,6718946,-2104734,1127669,1288872,180148,14051,432695,1440942,119956,105905,5238214,2012
77," ""51710""","Norfolk (Independent City), VA",13325695,496707,2184906,1715038,5015645,0,0,1354226,8722547,437992,35422,8722547,-6955824,2021468,1685434,246247,19554,437992,3042425,207067,187513,9845278,2012
78," ""51740""","Portsmouth (Independent City), VA",3602306,147396,657345,443904,2005218,0,0,369348,3394242,103927,35168,3394242,-1227740,548345,840679,96516,7087,103927,879297,58573,51486,2619082,2012
79," ""51760""","Richmond (Independent City), VA",11899012,509724,1336437,1225186,5783693,0,0,1122317,10236240,1289606,48531,10236240,-4993002,2764828,1687719,210922,21712,1289606,1949030,180453,158741,8660376,2012
80," ""51770""","Roanoke (Independent City), VA",4117480,190440,457186,494300,2103427,0,0,437590,3786396,326453,38623,3786396,-1576463,769742,913227,98034,9039,326453,704336,80666,71627,3086691,2012
81," ""51800""","Suffolk (Independent City), VA",1795570,86067,194834,194186,2543032,19875,7542,183160,3884419,190336,45761,3904294,930622,737918,623344,85320,8432,197878,291927,37098,28666,1305765,2012
82," ""51810""","Virginia Beach (Independent City), VA",11621397,505528,1492137,1340640,13955085,2169,262,1175848,21508200,934154,48317,21510369,3509536,4837877,2717407,445189,48532,934416,2162457,244114,195582,8524524,2012
83," ""51901""","Albemarle + Charlottesville, VA*",6425249,278159,745766,630378,4767788,7558,-4799,593348,8406308,933085,57584,8413866,-1064113,2821041,825037,146114,23325,928286,1060955,116265,92940,4436008,2012
84," ""51903""","Alleghany + Covington, VA*",496216,27769,56890,52794,424957,-2172,-2607,54166,766235,23056,34919,764063,-17093,119784,219322,21881,1463,20449,83287,9957,8494,392480,2012
85," ""51907""","Augusta, Staunton + Waynesboro, VA*",2589996,133874,303911,269600,2674449,33708,24351,268674,4371303,319415,37182,4405011,353127,813023,917539,118472,13232,343766,438711,61959,48727,1807519,2012
86," ""51911""","Campbell + Lynchburg, VA*",3906492,187373,425190,441784,2487109,2468,-86,408265,4488340,275199,33978,4490808,-1011118,790883,1212816,132169,12061,275113,646082,84807,72746,2985297,2012
87," ""51913""","Carroll + Galax, VA*",551590,33056,68002,60240,556384,3924,1274,63176,1082507,69642,29547,1086431,67970,155931,374116,36770,3463,70916,98122,16369,12906,382552,2012
88," ""51918""","Dinwiddie, Colonial Heights + Petersburg, VA*",1609811,81850,204541,180888,1531570,10923,9521,172294,2781639,97906,35983,2792562,94053,432468,828524,77607,7188,107427,294985,40585,33397,1207399,2012
89," ""51919""","Fairfax, Fairfax City + Falls Church, VA*",70057433,3046240,5851180,7291444,60490068,3271,774,6691962,83945004,6591018,72577,83948275,-2875403,18464677,4993530,1156684,167852,6591792,9496902,858111,690259,53968739,2012
90," ""51921""","Frederick + Winchester, VA*",3118424,143854,340810,341060,3103270,11124,6072,314384,4544216,339001,42470,4555340,299230,808934,643136,107259,13014,345073,511340,66467,53453,2262011,2012
91," ""51923""","Greensville + Emporia, VA*",348315,17426,49629,40400,249169,8055,6898,37626,459357,10318,26615,467412,-61520,63986,154257,17562,1095,17216,69829,9464,8369,261270,2012
92," ""51929""","Henry + Martinsville, VA*",1157979,68527,142599,133318,1072992,6014,5111,135186,2143584,104444,32268,2149598,50199,368364,708242,66616,5767,109555,209258,31880,26113,839166,2012
93," ""51931""","James City + Williamsburg, VA*",2264353,111153,251238,235032,2791609,-46,-771,228669,4735988,313328,56394,4735942,755925,1291448,652885,83979,10895,312557,368754,54533,43638,1583042,2012
94," ""51933""","Montgomery + Radford, VA*",2639259,118483,393740,290530,2054349,4995,1383,263748,3349944,121248,29843,3354939,-321162,724118,576472,112418,10474,122631,539005,60766,50292,1977623,2012
95," ""51939""","Pittsylvania + Danville, VA*",1843721,103334,226542,211868,1721579,24039,14732,209268,3200858,129561,30532,3224897,87126,490804,1012514,105625,9223,144293,332476,50050,40827,1366952,2012
96," ""51941""","Prince George + Hopewell, VA*",2414898,90097,454788,310964,1194355,939,444,245579,2000510,66179,33660,2001449,-974964,382128,424966,59461,3459,66623,610270,34979,31520,1738005,2012
97," ""51942""","Prince William, Manassas + Manassas Park, VA*",10539797,455627,1170108,1143644,18167973,2810,-293,1027449,23720437,1358281,48873,23723247,8655625,3573602,1981672,485404,52760,1357988,1741930,208607,155847,7439879,2012
98," ""51944""","Roanoke + Salem, VA*",3838475,183021,432436,411388,3478106,910,-15,388715,5374027,456171,45565,5374937,28346,1002493,894338,117961,13012,456156,638130,76290,63278,2744189,2012
99," ""51945""","Rockbridge, Buena Vista + Lexington, VA*",685227,36870,81932,75906,646313,-223,-2658,74823,1228543,95405,33967,1228320,35909,294996,287011,36162,4682,92747,119885,18981,14299,472595,2012
100," ""51947""","Rockingham + Harrisonburg, VA*",3405798,153005,395822,352312,2703794,110490,87614,329161,4118789,354911,32917,4229279,-372843,793967,731518,128485,15568,442525,571978,79301,63733,2391295,2012
101," ""51949""","Southampton + Franklin, VA*",426953,22204,56172,44098,523425,24678,19767,44253,915559,32742,34831,940237,140725,177245,239567,26994,2499,52509,78221,11290,8791,296223,2012
102," ""51951""","Spotsylvania + Fredericksburg, VA*",3179602,149271,332487,343348,4678271,2555,838,320945,6795798,329423,44417,6798353,1819614,1256150,863932,153057,14797,330261,504161,74568,59771,2345180,2012
103," ""51953""","Washington + Bristol, VA*",1936897,98429,207117,187846,1609791,-1031,-4926,192352,2894002,382140,39730,2892971,-134754,626521,656659,72816,8361,377214,301040,42303,33942,1258643,2012
104," ""51955""","Wise + Norton, VA*",978545,52418,127838,111594,716661,2005,1896,108215,1370132,50971,30456,1372137,-153669,179871,475605,45053,2881,52867,183635,22342,19461,742043,2012
105," ""51958""","York + Poquoson, VA*",1306137,63616,165104,146478,2679666,159,-814,136855,4007580,140547,51390,4007739,1510384,869543,458530,77987,6526,139733,238343,32245,25719,928061,2012
0," ""51000""",Virginia,285869187,16801339,33313310,31169978,270094615,772951,456370,32386328,400911320,26066811,48654,401684271,16611756,77717740,53871916,8255861,950936,26523181,48898299,4898765,3947829,210447707,2013
1," ""51001""","Accomack, VA",707994,44437,97646,71912,630542,45312,38226,80393,1145692,64174,36111,1191004,2941,244894,315568,32982,3867,102400,133602,17687,13820,471992,2013
2," ""51007""","Amelia, VA",174758,11080,15729,13230,314842,27069,22385,17695,459027,37601,38411,486096,157779,65257,105997,12655,1720,59986,22344,4298,2578,92428,2013
3," ""51009""","Amherst, VA",471255,33608,69100,49788,591358,-1538,-2513,58502,1016888,41429,31405,1015350,178605,159749,264243,32331,2846,38916,93994,12533,9687,338345,2013
4," ""51011""","Appomattox, VA",149269,12345,21346,14838,289294,-1150,-2232,19764,499754,21492,32557,498604,159789,74704,134606,15315,1727,19260,28765,5125,3398,101244,2013
5," ""51013""","Arlington, VA",19730438,1084206,2311502,2227652,13448872,0,0,2198032,17865923,1202620,79362,17865923,-4083534,3604181,812870,225120,30191,1202620,3425328,212978,182787,15102490,2013
6," ""51017""","Bath, VA",118918,8066,14463,12898,100770,462,-170,14515,214320,8940,46783,214782,-3633,69624,44388,4591,657,8770,20912,3079,2422,89236,2013
7," ""51019""","Bedford, VA*",1035483,76749,119688,109094,1861277,-3505,-5900,131296,3018126,157525,39568,3014621,957090,552606,600738,76189,9537,151625,174235,29648,20111,709623,2013
8," ""51021""","Bland, VA",117357,8033,20425,12304,113955,135,-319,14185,203241,9913,30473,203376,10783,31029,58392,6674,843,9594,26577,2877,2034,81186,2013
9," ""51023""","Botetourt, VA",562198,39268,67559,60674,937823,-418,-2095,69605,1434093,70181,43451,1433675,445230,241354,254498,32995,4072,68086,97896,14407,10335,396216,2013
10," ""51025""","Brunswick, VA",209901,15409,29920,22234,239065,6832,4456,26526,464683,14998,27775,471515,55690,69063,163387,16976,1281,19454,41037,5926,4645,149410,2013
11," ""51027""","Buchanan, VA",503632,36630,65597,55616,370109,-185,-257,64438,740973,31576,31339,740788,-69085,92250,278429,23638,1202,31319,93405,9433,8231,378908,2013
12," ""51029""","Buckingham, VA",191471,13617,28298,18498,243531,6245,4809,22866,428224,22798,25328,434469,74926,64786,126152,17154,1324,27607,37547,4849,3525,126317,2013
13," ""51033""","Caroline, VA",324351,22612,48282,34096,692087,3282,873,39660,1074855,37596,36856,1078137,407396,182287,203763,29253,2632,38469,65330,8792,6160,220552,2013
14," ""51036""","Charles City, VA",106694,7123,11943,10296,168044,9496,7941,12271,265186,14230,38863,274682,73621,49673,56965,7068,531,22171,17091,2294,1763,67432,2013
15," ""51037""","Charlotte, VA",149393,11476,21547,13774,185294,4581,2315,18363,359012,25316,29606,363593,54264,59982,118317,12281,1925,27631,28434,5004,3079,93328,2013
16," ""51041""","Chesterfield, VA",7966160,485918,927957,881318,10577950,1395,234,926577,15124472,648725,46155,15125867,3538367,2558173,1989744,327721,37645,648959,1368616,168986,131341,5948585,2013
17," ""51043""","Clarke, VA",278610,17533,26166,27002,495984,11050,6048,31034,752445,53422,53526,763495,248408,176878,90633,14264,2939,59470,39667,7079,4140,179473,2013
18," ""51045""","Craig, VA",40113,3649,5297,3760,98529,-677,-1333,5529,172233,9015,33390,171556,63945,29112,43915,5138,657,7682,7177,1397,740,25254,2013
19," ""51047""","Culpeper, VA",969286,60191,116455,98488,1290504,7274,235,109435,1928746,150128,39828,1936020,430653,332174,313342,48609,6644,150363,165699,23155,16511,653224,2013
20," ""51049""","Cumberland, VA",79225,6148,9777,6326,180560,9824,8472,9311,297765,15722,31221,307589,110646,43427,83602,9852,817,24194,12940,2254,1437,42091,2013
21," ""51051""","Dickenson, VA",225046,18053,31040,23356,208541,-1321,-1400,29731,441240,18235,28333,439919,13226,53210,178168,15527,790,16835,42718,4958,4168,165493,2013
22," ""51057""","Essex, VA",192269,13320,24059,20180,220974,1919,849,23410,398960,22872,35927,400879,52115,75073,104832,11158,1334,23721,34149,5472,4138,134399,2013
23," ""51061""","Fauquier, VA",1500801,92054,158728,150260,2664171,3162,-11741,167184,4003948,261316,59674,4007110,1330554,963095,379844,67150,10777,249575,233858,33981,23204,1017368,2013
24," ""51063""","Floyd, VA",153168,12236,18595,14174,291008,3139,-1228,19323,494366,35383,32112,497505,157163,81679,124818,15493,2526,34155,25682,5745,3219,93331,2013
25," ""51065""","Fluvanna, VA",266038,20029,34341,25106,610922,-448,-1147,32582,979490,51612,37899,979042,377466,195910,172210,25833,2910,50465,46894,7491,4581,168679,2013
26," ""51067""","Franklin, VA",740306,54644,87726,75546,1085336,15308,9410,92417,1924055,119905,34464,1939363,437447,378698,475329,56272,6884,129315,125499,22244,15360,485492,2013
27," ""51071""","Giles, VA",282695,20395,39754,29872,335442,-738,-1366,35331,578377,28990,33995,577639,88078,83866,158331,16992,1719,27624,54690,6883,5164,200381,2013
28," ""51073""","Gloucester, VA",469230,33207,62945,46612,983311,3435,2643,56513,1550970,63658,42262,1554405,570594,289799,281295,36780,3775,66301,86251,13915,10140,316678,2013
29," ""51075""","Goochland, VA",1343668,81263,117367,139696,1018161,2457,437,151111,1710095,58287,78803,1712552,-174396,510104,184287,21732,3550,58724,187215,17429,13879,1097729,2013
30," ""51077""","Grayson, VA",115587,11680,18246,11482,206914,-1128,-3183,17421,418189,20408,27563,417061,108748,60831,149316,15131,2007,17225,23987,4628,2621,74375,2013
31," ""51079""","Greene, VA",202994,14548,22018,18782,462170,766,-399,23939,699210,46146,37087,699976,283115,119474,118332,18874,2043,45747,31409,5733,3690,125838,2013
32," ""51083""","Halifax, VA",620975,43767,89777,68760,559395,6066,1791,78147,1066292,46858,30302,1072358,16567,168120,344843,35389,3311,48649,124157,16253,12942,448169,2013
33," ""51085""","Hanover, VA",2765209,169122,293367,304812,3499812,16093,7329,321528,4968507,305071,49316,4984600,1056131,860151,624637,101075,13491,312400,445773,64292,50801,2007036,2013
34," ""51087""","Henrico, VA",14694999,853392,1298061,1447366,12176961,2538,1184,1577075,17021628,2761573,53427,17024166,-940963,2871678,1975527,318646,40717,2762757,2021744,231935,191218,9910498,2013
35," ""51091""","Highland, VA",30755,2121,3966,2438,31780,6492,5683,3340,75665,3179,37259,82157,4365,29139,21238,2205,710,8862,5185,1323,613,16708,2013
36," ""51093""","Isle of Wight, VA",691691,45786,75421,66166,1185295,9383,7328,78869,1720810,65045,48680,1730193,572473,267602,277296,35542,3564,72373,108504,14778,11214,510814,2013
37," ""51097""","King and Queen, VA",72549,5540,8270,6586,152754,4193,2974,8833,245999,13977,35594,250192,89038,39185,58253,7029,741,16951,11563,1874,1133,44035,2013
38," ""51099""","King George, VA",1168678,63050,189901,132754,817555,-109,-659,129427,1188231,101356,47699,1188122,-221696,237667,132900,24909,2368,100697,256278,13956,11588,811703,2013
39," ""51101""","King William, VA",223194,15261,24937,22772,434094,1922,1163,26647,643063,32810,40071,644985,237547,99961,110930,16096,1729,33973,36323,5447,3718,152898,2013
40," ""51103""","Lancaster, VA",240780,17997,27979,25116,197768,1023,550,30555,526463,28731,48128,527486,-12457,197059,132659,10960,2021,29281,40537,6988,4967,170962,2013
41," ""51105""","Lee, VA",254381,21129,41572,26836,313125,-117,-1214,34547,657178,26362,26184,657061,93291,86853,257083,25094,2379,25148,54990,7587,5208,174243,2013
42," ""51107""","Loudoun, VA",12512992,723419,1217662,1330476,19215955,4306,-10482,1388657,23732779,1105946,67820,23737085,8091620,3440843,1080287,350001,46683,1095464,1882900,203895,157212,9534628,2013
43," ""51109""","Louisa, VA",606325,39931,80561,61760,753406,167,-1597,70811,1228783,69630,36306,1228950,217892,225315,250229,33850,3748,68033,111441,12790,9042,426851,2013
44," ""51111""","Lunenburg, VA",129405,10165,18980,13974,168960,1710,-683,17152,341466,12582,27380,343176,56707,63639,110577,12534,1032,11899,25967,3809,2777,91539,2013
45," ""51113""","Madison, VA",215261,14487,19844,16688,348426,2500,-941,22831,558326,79906,42834,560826,155996,110948,101452,13093,2055,78965,28188,5398,3343,108108,2013
46," ""51115""","Mathews, VA",86503,7655,9200,6616,213553,614,560,10963,415896,28561,46804,416510,138013,114187,88770,8899,1378,29121,12508,2951,1573,44874,2013
47," ""51117""","Mecklenburg, VA",528469,38571,72015,59390,478955,6850,759,68266,980603,41616,31600,987453,18752,180652,327846,31249,3123,42375,101710,15201,12078,384384,2013
48," ""51119""","Middlesex, VA",183338,13505,23764,16322,208189,3248,1894,21666,443063,37137,41398,446311,46517,123481,114641,10781,1821,39031,31925,5311,3490,112382,2013
49," ""51125""","Nelson, VA",211640,15710,24932,18350,340580,2866,-527,24885,634399,54051,43061,637265,153825,156587,140098,14799,2693,53524,34107,6716,4023,124009,2013
50," ""51127""","New Kent, VA",223984,15702,27210,22156,941254,1521,1264,26780,1229160,41416,63060,1230681,744050,165301,124126,19516,2761,42680,38288,6882,4121,143016,2013
51," ""51131""","Northampton, VA",258589,15350,28881,24316,241292,44154,30096,27508,431120,27687,39511,475274,10211,102385,131597,12029,1806,57783,41039,6618,4812,159767,2013
52," ""51133""","Northumberland, VA",146557,12979,16951,13808,205839,6273,5246,19883,509416,26963,41933,515689,79165,169448,140402,12298,1697,32209,23855,4321,2624,90493,2013
53," ""51135""","Nottoway, VA",294926,19359,53385,33986,212282,7288,4731,36352,444300,11310,28870,451588,-46292,82003,157303,15642,1448,16041,70378,7558,6110,208507,2013
54," ""51137""","Orange, VA",517877,36188,63596,50974,878703,12231,58,61675,1453922,80005,42366,1466153,422501,304160,283290,34607,4395,80063,89083,14153,9758,348731,2013
55," ""51139""","Page, VA",293094,20981,35662,29434,427871,29185,25922,35698,730858,41394,32037,760043,170475,131728,200444,23724,2712,67316,50379,8644,5932,175399,2013
56," ""51141""","Patrick, VA",226073,17950,31004,23284,261295,1490,-612,29592,510238,36394,28031,511728,64814,76371,174062,18256,2231,35782,42646,7446,5215,147645,2013
57," ""51145""","Powhatan, VA",414959,27403,54848,40956,873735,1361,469,47881,1258700,63749,44502,1260061,506657,213313,173013,28315,3357,64218,75326,10835,7478,275415,2013
58," ""51147""","Prince Edward, VA",435727,27938,63130,47222,316514,3495,2351,51549,593658,36320,26268,597153,-67664,104312,176327,22733,2171,38671,86741,11535,9364,310315,2013
59," ""51155""","Pulaski, VA",689123,46792,92259,79656,664654,4476,2792,86620,1157137,53235,33620,1161613,62151,172935,324024,34551,2685,56027,132087,16305,13620,501009,2013
60," ""51157""","Rappahannock, VA",130485,9097,11202,8988,225577,-853,-2995,13591,407200,45556,54668,406347,108683,125215,55555,7433,1729,42561,15696,3423,1694,72228,2013
61," ""51159""","Richmond, VA",152674,9908,23882,15620,145952,3767,1094,17718,267456,11720,30311,271223,10996,57696,67575,8948,959,12814,31692,3978,3019,108168,2013
62," ""51167""","Russell, VA",392236,30789,53052,44034,430891,2155,-48,52806,817882,34247,28939,820037,91461,106902,282244,28337,2630,34199,75069,10203,7573,282968,2013
63," ""51169""","Scott, VA",222527,20178,31785,24128,327767,-3143,-3918,32242,651596,25108,28480,648453,137482,92388,228298,22769,2780,21190,43849,7858,5078,157488,2013
64," ""51171""","Shenandoah, VA",725306,48448,86789,71868,943004,26852,22574,84382,1528978,108428,36596,1555830,302080,282507,330319,42514,5804,131002,122723,20089,14285,471581,2013
65," ""51173""","Smyth, VA",623331,42721,88845,67118,555288,9033,6916,76280,984248,65121,31246,993281,8237,127917,310076,31789,3212,72037,122404,15526,12314,428890,2013
66," ""51179""","Stafford, VA",3017401,171403,422306,338520,4850346,-2808,-3335,340663,6667360,240025,48992,6664552,2173608,1139814,674392,136034,12697,236690,591566,56846,44149,2189145,2013
67," ""51181""","Surry, VA",218726,12560,38819,22138,150800,6067,5122,23629,235459,6681,35560,241526,-44297,34897,55829,6792,574,11803,49888,2847,2273,157035,2013
68," ""51183""","Sussex, VA",205404,12746,30338,21206,183872,13261,11610,23349,310617,10389,27529,323878,1817,44729,95277,11765,814,21999,40941,4721,3907,142464,2013
69," ""51185""","Tazewell, VA",812276,57433,111649,86952,781141,4811,3588,100909,1451798,76093,33081,1456609,69774,224996,450472,44031,3758,79681,155125,20836,17078,577470,2013
70," ""51187""","Warren, VA",730779,47074,84856,78846,1034765,-1596,-2527,86497,1519439,84397,39410,1517843,390483,229266,253812,38514,4240,81870,124279,17188,12948,524630,2013
71," ""51193""","Westmoreland, VA",168735,13572,22336,16998,314766,13484,7457,22071,626508,18284,36461,639992,168102,165454,159772,17553,2069,25741,30835,5822,3753,112159,2013
72," ""51197""","Wythe, VA",542026,37185,78533,60172,458017,5149,1937,67271,849275,43473,29176,854424,-16738,126219,270188,29285,3418,45410,108619,15533,12115,387997,2013
73," ""51510""","Alexandria (Independent City), VA",9823818,548705,1059882,1086108,8391356,0,0,1091759,11516425,1053891,76896,11516425,-340703,2459903,665166,149767,21792,1053891,1602936,122829,101037,7166991,2013
74," ""51550""","Chesapeake (Independent City), VA",5516147,333560,663068,635100,6946380,9468,3831,651110,10113904,349684,43935,10123372,2081343,1724975,1452017,230415,21243,353515,980618,123596,102353,4182014,2013
75," ""51650""","Hampton (Independent City), VA",4152020,232097,673421,510542,3058958,0,0,487368,5093399,147691,37068,5093399,-605694,908574,1125867,137406,10323,147691,928692,76166,65843,3075637,2013
76," ""51700""","Newport News (Independent City), VA",7391404,405800,1096144,849750,4313984,0,0,830675,6753508,435098,37232,6753508,-2246745,1110345,1329179,181388,14181,435098,1521019,122239,108058,5435287,2013
77," ""51710""","Norfolk (Independent City), VA",13146346,660182,2188761,1673610,4892491,0,0,1496987,8627186,330646,35127,8627186,-6756868,1993851,1740844,245598,20012,330646,3025566,206771,186759,9790134,2013
78," ""51740""","Portsmouth (Independent City), VA",3661853,196606,685371,453784,1955723,0,0,423498,3381948,82723,35184,3381948,-1282632,555697,870528,96123,7152,82723,912263,59595,52443,2666867,2013
79," ""51760""","Richmond (Independent City), VA",11992122,675796,1481523,1249434,5801780,0,0,1300513,9776386,1165025,45680,9776386,-4889829,2240925,1733681,214020,22643,1165025,2106240,180763,158120,8720857,2013
80," ""51770""","Roanoke (Independent City), VA",4229568,255343,507910,508302,2084567,0,0,509494,3692069,284487,37337,3692069,-1635507,665228,942274,98884,8903,284487,762061,81124,72221,3183020,2013
81," ""51800""","Suffolk (Independent City), VA",1838163,113417,220568,201910,2513606,19343,6982,214372,3836384,152801,44922,3855727,889815,698142,643979,85832,8456,159783,321523,37384,28928,1356857,2013
82," ""51810""","Virginia Beach (Independent City), VA",11749618,669260,1538032,1322862,13883889,4303,2390,1330691,21440977,1153055,47877,21445280,3464962,4716480,2844911,447922,49752,1155445,2199463,247262,197510,8394710,2013
83," ""51901""","Albemarle + Charlottesville, VA*",6476387,366903,841531,655168,4715302,734,-11880,694487,8316889,739477,56436,8317623,-1066598,2740868,861453,147381,24004,727597,1169115,117647,93643,4579675,2013
84," ""51903""","Alleghany + Covington, VA*",456430,32600,60714,52834,376669,-1976,-2417,59017,717666,27121,32893,715690,-20744,113249,225772,21758,1452,24704,87131,9880,8428,344595,2013
85," ""51907""","Augusta, Staunton + Waynesboro, VA*",2666746,173096,338483,278004,2709531,49845,40146,312098,4419426,291267,37517,4469271,354883,811047,948693,119126,13316,331413,477485,62619,49303,1857848,2013
86," ""51911""","Campbell + Lynchburg, VA*",3982085,247794,464820,455414,2469855,2673,47,475501,4434259,232455,33333,4436932,-1036729,708368,1258709,133108,12318,232502,692527,85483,73165,3057056,2013
87," ""51913""","Carroll + Galax, VA*",551808,40886,74974,59594,549097,3954,1220,70683,1076022,63293,29314,1079976,67972,150538,380341,36842,3427,64513,104771,16244,12817,382524,2013
88," ""51918""","Dinwiddie, Colonial Heights + Petersburg, VA*",1624281,105335,224322,182872,1517906,6937,5474,196771,2793404,94668,35953,2800341,90396,432045,850390,77890,7374,100142,315758,40780,33406,1208381,2013
89," ""51919""","Fairfax, Fairfax City + Falls Church, VA*",69860442,4073500,6228976,7426694,59162782,7243,4692,7786847,82189871,5996114,70324,82197114,-2910813,17832077,5202255,1168830,170743,6000806,9942323,857784,687041,53917313,2013
90," ""51921""","Frederick + Winchester, VA*",3220002,194213,378577,355730,3091643,-96,-5355,372078,4568821,314592,41983,4568725,243719,802174,674908,108822,13174,309237,556442,68031,54857,2354323,2013
91," ""51923""","Greensville + Emporia, VA*",352029,22383,55001,40204,244385,6847,5655,42485,463607,9256,27058,470454,-65159,63699,162370,17387,1187,14911,75103,9313,8126,262015,2013
92," ""51929""","Henry + Martinsville, VA*",1166786,85529,156066,132868,1070436,6896,5973,151963,2125977,95166,32228,2132873,55613,344580,717857,66181,5733,101139,222500,32263,26530,843147,2013
93," ""51931""","James City + Williamsburg, VA*",2275804,144056,274237,238988,2810724,-650,-1415,263550,4809064,266853,56378,4808414,798470,1309876,687814,85289,11240,265438,393731,54717,43477,1616635,2013
94," ""51933""","Montgomery + Radford, VA*",2754706,159133,448108,296010,2121530,5317,1612,307138,3415452,140565,30064,3420769,-326038,705336,593903,113782,10654,142177,596113,61876,51222,2016416,2013
95," ""51939""","Pittsylvania + Danville, VA*",1878405,131555,247026,212464,1741504,23837,14208,237787,3247474,140481,31092,3271311,100886,479659,1050148,105214,9419,154689,353258,50250,40831,1370458,2013
96," ""51941""","Prince George + Hopewell, VA*",2433377,120964,461366,310140,1198784,1436,928,276034,2017401,69247,33909,2018837,-958559,377113,442940,59537,3504,70175,616436,35647,32143,1746766,2013
97," ""51942""","Prince William, Manassas + Manassas Park, VA*",10832480,614482,1286867,1175678,18031547,1811,-1457,1202321,23851672,1316788,48200,23853483,8401388,3727434,2094502,494882,54514,1315331,1874706,213801,159287,7642443,2013
98," ""51944""","Roanoke + Salem, VA*",3778714,233990,459310,402616,3437112,91,-857,435298,5256440,410581,44290,5256531,93696,906415,913004,118684,13008,409724,660618,74982,61974,2708372,2013
99," ""51945""","Rockbridge, Buena Vista + Lexington, VA*",691073,46761,89377,76110,642552,581,-1937,84816,1231369,89072,34076,1231950,36295,297928,291470,36153,4710,87135,127432,18900,14190,476506,2013
100," ""51947""","Rockingham + Harrisonburg, VA*",3549793,202166,434233,357574,2810785,188094,164698,380953,4142983,341777,33572,4331077,-358055,781907,738385,129009,15833,506475,613020,79920,64087,2430298,2013
101," ""51949""","Southampton + Franklin, VA*",418083,27747,61936,42236,525481,16426,11394,48865,924440,33673,35009,940866,156263,169160,246225,26875,2499,45067,83054,11128,8629,289962,2013
102," ""51951""","Spotsylvania + Fredericksburg, VA*",3272348,199416,370971,351770,4694666,2613,841,375301,6833141,335471,44021,6835754,1797619,1229396,911692,155284,15490,336312,546856,75497,60007,2389180,2013
103," ""51953""","Washington + Bristol, VA*",1860766,120207,219986,181690,1540567,5864,1845,211052,2729004,348677,37873,2734868,-109147,532564,661737,72211,8395,350522,310831,41141,32746,1199413,2013
104," ""51955""","Wise + Norton, VA*",881853,60911,132344,98600,654362,1064,941,110211,1305962,45557,29183,1307026,-117280,172653,480011,44788,2889,46498,181644,21014,18125,653711,2013
105," ""51958""","York + Poquoson, VA*",1325463,83055,174362,146892,2695133,863,-143,156501,4058756,142960,51954,4059619,1526171,889569,474917,78139,6713,142817,247808,32168,25455,934838,2013
0," ""51000""",Virginia,293734833,17291151,34325940,31679344,279115524,673870,329780,33130823,418655729,27341131,50428,419329599,18511514,83664869,56549206,8315430,980916,27670911,50165612,4953354,3972438,215898310,2014
1," ""51001""","Accomack, VA",721844,45980,104395,74114,639478,31914,24210,83037,1196347,65931,37229,1228261,671,260195,328588,32992,3920,90141,141452,17737,13817,490251,2014
2," ""51007""","Amelia, VA",180052,11739,16748,13562,321486,24081,19003,18520,475710,42013,39313,499791,159954,68595,109710,12713,1709,61016,23529,4323,2614,95507,2014
3," ""51009""","Amherst, VA",476682,34197,70694,50370,609162,-1151,-2212,59382,1055704,39993,32777,1054553,191862,167023,278368,32174,2857,37781,95879,12477,9620,343022,2014
4," ""51011""","Appomattox, VA",152555,12690,21762,14684,302735,-1147,-2349,20032,519831,23684,33806,518684,170212,76646,139303,15343,1675,21335,29104,5085,3410,102116,2014
5," ""51013""","Arlington, VA",20043970,1105171,2333630,2249988,14076009,0,0,2230165,18839913,1176522,83262,18839913,-3737796,3907195,856709,226274,31419,1176522,3458624,213861,182442,15408824,2014
6," ""51017""","Bath, VA",126162,8336,15603,13062,106377,932,241,14867,223770,10539,49537,224702,-4918,73783,44542,4536,657,10780,22134,3168,2511,93248,2014
7," ""51019""","Bedford, VA*",1088224,80776,125754,112386,1918317,-4201,-6809,136969,3139322,166880,40687,3135121,967062,580549,636255,77054,9520,160071,181947,29963,20443,746206,2014
8," ""51021""","Bland, VA",120557,8215,20886,12656,112312,1234,729,14543,202503,8933,30935,203737,6298,32134,59291,6586,801,9662,27214,2878,2077,83681,2014
9," ""51023""","Botetourt, VA",581612,40979,71206,62452,958847,-905,-2722,72205,1490286,66596,45015,1489381,449440,259282,271252,33086,4135,63874,102432,14632,10497,415306,2014
10," ""51025""","Brunswick, VA",206635,15417,30441,22238,239034,4725,2155,26536,474939,13300,28526,479664,58935,70671,169959,16815,1335,15455,41560,5833,4498,149620,2014
11," ""51027""","Buchanan, VA",490209,36059,64486,53272,358489,-253,-330,62695,737348,30470,31817,737095,-69025,97494,281112,23167,1224,30140,91122,9095,7871,368947,2014
12," ""51029""","Buckingham, VA",194277,14046,29393,19216,247791,5159,3592,23654,440885,20663,26337,446044,77168,66351,131902,16936,1359,24255,39001,4904,3545,131021,2014
13," ""51033""","Caroline, VA",323850,23184,49921,34514,712136,-2503,-5118,40441,1125188,36243,37741,1122685,428727,193746,216803,29747,2596,31125,67178,8702,6106,225547,2014
14," ""51036""","Charles City, VA",106483,7522,12722,10556,164409,4188,2494,12800,277262,14876,40351,281450,70726,56000,61041,6975,584,17370,18000,2439,1855,71113,2014
15," ""51037""","Charlotte, VA",153547,11840,22649,14406,189192,3154,684,19043,363366,25667,30099,366520,54688,61956,115372,12177,1880,26351,29852,5026,3146,97344,2014
16," ""51041""","Chesterfield, VA",8200769,501718,958396,896070,10831357,176,-1092,949753,15687132,681225,47219,15687308,3580341,2721641,2134310,332221,38599,680133,1406431,172283,133684,6114205,2014
17," ""51043""","Clarke, VA",273296,17579,27626,26916,494770,7040,1609,31037,778457,50869,54819,785497,252511,193912,96815,14329,2981,52478,41084,7233,4252,179734,2014
18," ""51045""","Craig, VA",41346,3803,5618,3900,99792,-811,-1522,5753,175410,8766,33726,174599,64199,30566,44241,5177,666,7244,7568,1414,748,26534,2014
19," ""51047""","Culpeper, VA",978577,61510,119423,99308,1319718,2401,-5238,111164,1998395,150890,40631,2000796,452305,357046,324032,49243,6807,145652,169077,23267,16460,663848,2014
20," ""51049""","Cumberland, VA",82321,6359,10342,6534,187412,11028,9560,9626,311912,15161,32809,322940,114717,46243,89285,9843,855,24721,13609,2312,1457,43991,2014
21," ""51051""","Dickenson, VA",218988,17833,30857,22696,202110,-1412,-1498,29181,442950,16613,28774,441538,12303,55973,183455,15345,791,15115,42205,4928,4137,161668,2014
22," ""51057""","Essex, VA",187198,13552,24445,20592,219597,-5365,-6525,23848,411939,21775,36741,406574,56247,80437,106540,11066,1357,15250,34741,5551,4194,137207,2014
23," ""51061""","Fauquier, VA",1560689,96308,166078,153426,2704206,138,-16030,173021,4123471,276313,60521,4123609,1316538,1004351,415052,68135,11017,260283,242791,34279,23262,1057615,2014
24," ""51063""","Floyd, VA",156775,12796,19724,14614,297566,459,-4283,20103,517692,36141,33347,518151,160894,89987,130598,15538,2520,31858,27031,5815,3295,97886,2014
25," ""51065""","Fluvanna, VA",270424,20709,36872,26364,612858,-1909,-2669,33891,1013275,43117,38929,1011366,376325,212477,186031,25980,3031,40448,50054,7794,4763,179922,2014
26," ""51067""","Franklin, VA",781373,57277,94688,79532,1112554,18791,12377,97043,2001339,117998,35904,2020130,428224,408805,498771,56265,6969,130375,134454,22897,15928,516544,2014
27," ""51071""","Giles, VA",286331,20640,40930,30390,346600,-353,-1039,35835,598935,27092,35518,598582,96104,89411,162571,16853,1716,26053,56125,6781,5065,204153,2014
28," ""51073""","Gloucester, VA",470383,33923,64590,47210,992831,1281,404,57528,1601707,59091,43280,1602988,579976,303616,306541,37038,3750,59495,88195,13846,10096,322693,2014
29," ""51075""","Goochland, VA",1502153,90405,129626,156076,1074952,-542,-2735,168443,1819576,67830,82608,1819034,-258758,556722,187360,22020,3573,65095,207664,18555,14982,1229394,2014
30," ""51077""","Grayson, VA",127769,12355,21340,12648,216939,-982,-3216,18679,438734,20200,27488,437752,107849,67454,153359,15925,1971,16984,27664,4757,2786,83121,2014
31," ""51079""","Greene, VA",210137,15091,22852,18932,481738,1151,-113,24557,731673,49820,38306,732824,296158,120676,130410,19131,2068,49707,32318,5758,3690,128112,2014
32," ""51083""","Halifax, VA",629462,44545,91937,69342,568335,2179,-2474,79216,1105561,48289,31465,1107740,18089,173486,365919,35205,3429,45815,126608,16337,12908,457039,2014
33," ""51085""","Hanover, VA",2982365,182187,311992,319952,3721801,7300,-2214,342163,5320138,371127,52363,5327438,1081599,930963,674674,101740,13721,368913,471968,65976,52255,2141484,2014
34," ""51087""","Henrico, VA",15577599,904366,1337491,1468404,13021775,1415,-53,1638568,18277745,3256050,56792,18279160,-917256,3138572,2118813,321863,42306,3255997,2071693,234757,192451,10249909,2014
35," ""51091""","Highland, VA",32459,2162,4284,2516,33709,7740,6857,3420,80915,2660,39613,88655,4670,32448,22498,2238,716,9517,5542,1349,633,17400,2014
36," ""51093""","Isle of Wight, VA",646753,43462,78133,66798,1186021,3391,1157,76861,1748615,61230,48820,1752006,616129,274747,291238,35887,3708,62387,111532,15198,11490,472834,2014
37," ""51097""","King and Queen, VA",68518,5607,8578,6516,154097,720,-601,8865,255968,13223,36235,256688,94444,40915,61676,7084,773,12622,11836,1892,1119,44060,2014
38," ""51099""","King George, VA",1220238,66385,197845,139174,842748,-1771,-2371,135972,1232378,99548,48671,1230607,-241518,245667,142192,25284,2412,97177,267432,14191,11779,855629,2014
39," ""51101""","King William, VA",232119,16096,26677,24120,406155,-823,-1657,28156,631374,31038,39036,630551,202192,107492,116904,16153,1781,29381,38737,5578,3797,164001,2014
40," ""51103""","Lancaster, VA",241087,18263,28149,25062,198968,-210,-724,30794,539544,28071,49649,539334,-11325,212104,128262,10863,2077,27347,40680,7013,4936,173060,2014
41," ""51105""","Lee, VA",237343,20365,40802,24812,299658,6,-1200,32771,651936,23349,26347,651942,95086,91439,260845,24744,2438,22149,53208,7377,4939,161986,2014
42," ""51107""","Loudoun, VA",13064389,755859,1277196,1364368,20078799,-3815,-19891,1438043,25036907,1241514,69089,25033092,8452453,3760963,1193330,362330,49627,1221623,1959380,209683,160056,9883386,2014
43," ""51109""","Louisa, VA",625812,41683,84981,64844,778929,-717,-2638,74105,1294422,58955,37858,1293705,227222,246515,268261,34173,3857,56317,117403,13298,9441,452092,2014
44," ""51111""","Lunenburg, VA",131367,10344,20055,14106,173994,1401,-1186,17397,356584,11333,28685,357985,60024,66516,117475,12480,1088,10147,27108,3962,2874,94112,2014
45," ""51113""","Madison, VA",243084,16082,21114,17508,377754,1284,-2461,24836,598337,102818,46004,599621,159506,119572,102295,13034,2098,100357,29868,5497,3399,112859,2014
46," ""51115""","Mathews, VA",88274,7967,9668,6932,216090,242,178,11433,433475,27365,49213,433717,139249,124257,93370,8813,1402,27543,13134,2991,1589,47597,2014
47," ""51117""","Mecklenburg, VA",533384,39258,73999,59634,475938,5229,-1383,69075,999718,38278,32296,1004947,11629,193214,335795,31117,3157,36895,103816,15401,12244,392673,2014
48," ""51119""","Middlesex, VA",183953,13770,24146,16630,210496,1462,-5,22085,451438,35809,42514,452900,48628,127839,114565,10653,1848,35804,32461,5279,3431,115688,2014
49," ""51125""","Nelson, VA",222195,16601,27806,19526,329938,1872,-1817,26364,646799,53281,43632,648671,134107,170166,148567,14867,2671,51464,37569,6862,4191,133162,2014
50," ""51127""","New Kent, VA",238430,16937,28852,22826,991160,-438,-716,28350,1309871,47656,65403,1309433,781080,180409,137864,20021,2953,46940,40265,7108,4155,151225,2014
51," ""51131""","Northampton, VA",252422,15808,30656,25510,234005,30735,15507,28563,450958,26979,40028,481693,10146,112009,135679,12034,1821,42486,43411,6869,5048,166525,2014
52," ""51133""","Northumberland, VA",144074,13286,17980,14374,203890,1588,473,20473,543987,23762,44515,545575,80289,189296,152389,12256,1782,24235,25167,4390,2608,94672,2014
53," ""51135""","Nottoway, VA",302537,19729,55406,34774,220694,8127,5341,37116,461852,10756,30292,469979,-44727,85101,164184,15515,1452,16097,72793,7596,6144,213647,2014
54," ""51137""","Orange, VA",523456,36982,64998,52010,901015,10482,-2730,62987,1507084,78656,43468,1517566,440546,328200,288351,34912,4425,75926,91003,14364,9939,356527,2014
55," ""51139""","Page, VA",304774,21630,37504,30126,444715,34153,30600,36693,761702,38965,33458,795855,176634,140603,210537,23787,2704,69565,52567,8717,6013,182642,2014
56," ""51141""","Patrick, VA",232321,18372,32886,23908,269003,2054,-230,30326,530496,34488,29285,532550,67008,80339,183208,18185,2184,34258,44840,7475,5291,153223,2014
57," ""51145""","Powhatan, VA",438589,29215,58535,43204,911257,716,-258,50817,1331613,65918,46742,1332329,523485,238504,182568,28504,3378,65660,80137,11077,7699,292792,2014
58," ""51147""","Prince Edward, VA",441230,28278,64500,47286,323475,4041,2797,51921,615118,37971,26927,619159,-65834,109264,186420,22994,2244,40768,88143,11505,9261,312319,2014
59," ""51155""","Pulaski, VA",743908,49915,99746,86406,687234,5215,3379,93118,1199306,51117,35073,1204521,36444,183131,334156,34343,2678,54496,142949,16774,14096,546463,2014
60," ""51157""","Rappahannock, VA",132501,9460,11874,9304,218262,-2129,-4456,14112,411737,43961,55775,409608,99873,131762,59584,7344,1816,39505,16526,3537,1721,76470,2014
61," ""51159""","Richmond, VA",154230,10107,25164,15956,149189,1419,-1480,18085,280252,12078,31720,281671,13044,60396,72086,8880,965,10598,33142,4027,3062,110490,2014
62," ""51167""","Russell, VA",392131,30891,52615,43834,426453,4277,1875,52808,824597,31275,29516,828874,87130,112044,290377,28082,2559,33150,74532,10006,7447,284449,2014
63," ""51169""","Scott, VA",230831,20659,33312,25416,326395,-2232,-3083,33367,665226,23115,29439,662994,128931,97961,238638,22521,2668,20032,46020,7816,5148,164779,2014
64," ""51171""","Shenandoah, VA",758167,50661,93249,74378,992241,26210,21525,87850,1631719,110195,38794,1657929,321924,318079,347609,42737,5787,131720,130438,20667,14880,496009,2014
65," ""51173""","Smyth, VA",657992,44588,94304,69882,578733,12519,10219,79529,1024724,63484,32831,1037243,270,139772,318738,31593,3189,73703,129245,15796,12607,455044,2014
66," ""51179""","Stafford, VA",3042608,176072,421670,333452,4923922,-3422,-3996,342798,6878417,234837,49483,6874995,2224112,1206475,744598,138937,13309,230841,588396,57736,44427,2223371,2014
67," ""51181""","Surry, VA",234841,13632,42177,24326,157586,1896,865,25795,250441,6786,37201,252337,-51460,35288,59463,6783,591,7651,54340,2989,2398,172850,2014
68," ""51183""","Sussex, VA",207408,13231,31744,22248,177101,6929,5129,24355,312427,9956,27240,319356,-5952,45004,97251,11724,869,15085,42868,4909,4040,149455,2014
69," ""51185""","Tazewell, VA",800728,56903,111303,85528,761890,6749,5411,99667,1455032,71766,33682,1461781,60829,233257,466634,43399,3793,77177,154067,20555,16762,569484,2014
70," ""51187""","Warren, VA",740216,47857,88166,80554,1047608,-2054,-3069,88134,1564437,81260,38917,1562383,395526,248108,266667,40147,4165,78191,128443,17465,13300,533582,2014
71," ""51193""","Westmoreland, VA",168031,13858,23152,17160,320199,10898,4351,22438,650660,18663,37933,661558,174606,172628,168731,17440,2074,23014,31732,5852,3778,113285,2014
72," ""51197""","Wythe, VA",563365,38175,82050,61154,482941,10931,7435,68752,889685,43895,30992,900616,-11672,136063,281612,29060,3483,51330,112627,15637,12154,399408,2014
73," ""51510""","Alexandria (Independent City), VA",10052670,560641,1101254,1110892,8749913,0,0,1116087,12085870,1015235,79752,12085870,-186670,2635845,700112,151544,22887,1015235,1656700,123962,101075,7380735,2014
74," ""51550""","Chesapeake (Independent City), VA",5594707,338951,683532,639338,7153748,4500,-1605,658620,10540978,330131,45167,10545478,2217661,1844303,1547427,233477,21762,328526,1003201,124495,102733,4262980,2014
75," ""51650""","Hampton (Independent City), VA",4261092,238436,690632,516724,3138642,0,0,496798,5236703,141706,38008,5236703,-625652,938024,1160037,137778,10617,141706,948994,75378,64761,3170392,2014
76," ""51700""","Newport News (Independent City), VA",7592055,418206,1124542,867438,4348125,0,0,851925,6848167,351265,37698,6848167,-2392005,1140156,1359886,181661,14640,351265,1558261,123428,108788,5682529,2014
77," ""51710""","Norfolk (Independent City), VA",13704839,691083,2281403,1737318,5084881,0,0,1559742,8915068,330962,36129,8915068,-7060216,2049024,1781163,246756,20465,330962,3150062,207913,187448,10223815,2014
78," ""51740""","Portsmouth (Independent City), VA",3788225,203500,708075,468060,2001213,0,0,437530,3440929,79932,35886,3440929,-1349482,585750,853966,95886,7306,79932,942105,59922,52616,2766188,2014
79," ""51760""","Richmond (Independent City), VA",12377238,700406,1522041,1275894,6112797,0,0,1338353,10328668,1190081,47545,10328668,-4926088,2478922,1736949,217238,24261,1190081,2159988,183795,159534,9027169,2014
80," ""51770""","Roanoke (Independent City), VA",4278711,259410,511509,510866,2113028,0,0,514843,3807746,257883,38278,3807746,-1650840,727411,967307,99475,9449,257883,766942,81715,72266,3253886,2014
81," ""51800""","Suffolk (Independent City), VA",1902422,117816,233140,209466,2601116,13175,-198,222549,3981957,147613,45934,3995132,921243,714860,679156,86976,8722,147415,337873,37995,29273,1417134,2014
82," ""51810""","Virginia Beach (Independent City), VA",12203470,697080,1571897,1349064,14539612,-2542,-4632,1371612,22531497,1313131,50160,22528955,3707754,4976989,3012354,449139,51408,1308499,2246429,250531,199123,8648542,2014
83," ""51901""","Albemarle + Charlottesville, VA*",6780785,385447,883127,685758,4975377,-4514,-18255,728326,8871049,755942,59358,8866535,-1077082,2989173,901985,149373,24677,737687,1226006,120623,95946,4817092,2014
84," ""51903""","Alleghany + Covington, VA*",458083,32700,61325,51830,381626,-1812,-2296,58615,735145,28739,34282,733333,-17842,118327,233380,21391,1487,26443,87240,9789,8302,344400,2014
85," ""51907""","Augusta, Staunton + Waynesboro, VA*",2787892,181445,350755,282936,2813123,61743,51194,322913,4608976,325773,39086,4670719,348144,858628,998968,119498,13567,376967,492223,63206,49639,1918702,2014
86," ""51911""","Campbell + Lynchburg, VA*",4097442,255045,483725,465264,2540905,3185,317,487677,4635635,209728,34740,4638820,-1068860,813281,1284634,133528,12783,210045,716357,86706,73923,3171040,2014
87," ""51913""","Carroll + Galax, VA*",570359,41965,78166,60924,579208,5714,2751,72427,1133203,62949,31107,1138917,81276,161688,398021,36613,3425,65700,108628,16298,12873,396031,2014
88," ""51918""","Dinwiddie, Colonial Heights + Petersburg, VA*",1651119,107677,225580,184654,1526523,2331,741,200004,2791907,91310,35925,2794238,75408,436140,831575,77780,7644,92051,317907,41098,33454,1241161,2014
89," ""51919""","Fairfax, Fairfax City + Falls Church, VA*",70876369,4125780,6331171,7431282,61034324,6697,3917,7841421,86168008,6616000,73429,86174705,-2000624,19635478,5504903,1173577,176894,6619917,10046812,860180,683286,54209640,2014
90," ""51921""","Frederick + Winchester, VA*",3389104,203462,411879,366060,3196807,-2397,-8105,386492,4771851,339395,43306,4769454,194195,849545,723102,110133,13483,331290,594909,70528,57045,2462905,2014
91," ""51923""","Greensville + Emporia, VA*",364838,23289,57591,41892,253985,3772,2481,44235,473026,7521,27763,476798,-66618,63306,159507,17174,1262,10002,78537,9376,8114,276299,2014
92," ""51929""","Henry + Martinsville, VA*",1192030,87220,158947,132306,1100471,7653,6656,153373,2196207,99471,33607,2203860,61814,363370,740019,65578,5646,106127,225100,31883,26237,860803,2014
93," ""51931""","James City + Williamsburg, VA*",2332462,148723,283573,241830,2873382,-2746,-3577,269638,5018626,273776,57833,5015880,810558,1408824,733674,86731,11463,270199,404488,55080,43617,1657775,2014
94," ""51933""","Montgomery + Radford, VA*",2870473,165311,466199,305658,2223909,6383,2351,318140,3625207,163317,31693,3631590,-328424,781716,625965,114588,10912,165668,619028,62398,51486,2085777,2014
95," ""51939""","Pittsylvania + Danville, VA*",1918648,134058,255444,215240,1784588,27624,17175,241678,3363216,131784,32392,3390840,107618,504667,1101585,104681,9688,148959,363064,50760,41072,1406625,2014
96," ""51941""","Prince George + Hopewell, VA*",2444107,123678,462652,312892,1205197,-1699,-2257,280124,2060704,50351,34558,2059005,-958786,380612,473196,59582,3580,48094,619098,35895,32315,1776915,2014
97," ""51942""","Prince William, Manassas + Manassas Park, VA*",11330617,642445,1363621,1216764,18562217,-1875,-5425,1250827,24765920,1386851,49423,24764045,8482427,3947548,2254280,501067,58010,1381426,1972003,221245,163235,7977188,2014
98," ""51944""","Roanoke + Salem, VA*",3837732,238590,469362,405040,3497514,-491,-1529,441110,5445741,391953,45809,5445250,100892,986324,961412,118869,12907,390424,671882,75230,62323,2775426,2014
99," ""51945""","Rockbridge, Buena Vista + Lexington, VA*",727523,48773,95204,79036,674342,3714,975,88291,1295114,91882,35940,1298828,35110,317508,306978,36139,4674,92857,134722,18847,14173,499944,2014
100," ""51947""","Rockingham + Harrisonburg, VA*",3695064,207966,452455,364540,2958576,234669,209234,390236,4338683,356480,35049,4573352,-346252,823842,790934,130486,16155,565714,634725,80908,64753,2494625,2014
101," ""51949""","Southampton + Franklin, VA*",399686,27786,62493,41374,520839,1145,-4311,48473,944957,36055,35537,946102,169626,175913,249350,26623,2537,31744,83180,11088,8551,284762,2014
102," ""51951""","Spotsylvania + Fredericksburg, VA*",3360568,205617,381062,355618,4797066,1441,-490,383426,7084896,362621,45091,7086337,1819924,1300835,988436,157157,16201,362131,558871,76703,60502,2439566,2014
103," ""51953""","Washington + Bristol, VA*",1666215,112428,219382,177416,1372605,15072,10690,201136,2641384,156264,36970,2656456,-92474,592083,691768,71855,8471,166954,308090,40631,32160,1191171,2014
104," ""51955""","Wise + Norton, VA*",850901,59458,129345,94726,636709,934,798,106821,1315499,41520,29882,1316433,-107371,185564,494160,44055,2863,42318,176708,20223,17360,631875,2014
105," ""51958""","York + Poquoson, VA*",1397008,87502,184464,154700,2788209,307,-784,164852,4225026,146822,53749,4225333,1556053,927708,509416,78612,6730,146038,261814,32424,25694,989156,2014
0," ""51000""",Virginia,306244872,18112689,36017008,33091254,290546779,505545,226205,34658316,437767212,27833826,52379,438272757,18960223,88219366,59506612,8367303,1011334,28060031,52562635,5060290,4048956,225622206,2015
1," ""51001""","Accomack, VA",751303,48015,106385,77234,663844,33464,27204,86632,1235993,66350,38550,1269457,-827,268930,336683,32930,3955,93554,145002,18019,14064,512747,2015
2," ""51007""","Amelia, VA",187371,12267,17768,14206,340728,24010,19874,19370,506566,45296,41503,530576,172727,71725,118123,12784,1714,65170,24871,4387,2673,97330,2015
3," ""51009""","Amherst, VA",483704,34771,72416,51496,619489,-837,-1700,60519,1080143,38438,33882,1079306,196304,171583,288234,31855,2783,36738,98164,12305,9522,348802,2015
4," ""51011""","Appomattox, VA",159818,13253,22778,15184,315760,-1588,-2541,20845,548902,25597,35345,547314,176787,83131,148423,15485,1720,23056,30370,5146,3426,106392,2015
5," ""51013""","Arlington, VA",21306347,1182815,2434167,2406150,14620599,0,0,2385890,19646826,1219198,85836,19646826,-4299858,4107334,918893,228887,32956,1219198,3637242,221671,188715,16449907,2015
6," ""51017""","Bath, VA",129809,8571,16076,13484,111025,995,439,15313,238266,10715,53610,239261,-3471,80807,47429,4463,643,11154,22818,3128,2485,95837,2015
7," ""51019""","Bedford, VA*",1140615,84777,131981,117360,1976817,-5052,-7147,143457,3294548,178608,42361,3289496,979659,636718,675961,77653,9837,171461,190661,30512,20675,778493,2015
8," ""51021""","Bland, VA",128939,8724,22238,13234,118579,454,58,15341,211559,12856,32438,212013,4981,33180,60254,6536,800,12914,28855,2872,2072,87170,2015
9," ""51023""","Botetourt, VA",610368,42959,75880,65590,990358,-1207,-2688,75754,1556166,65876,46568,1554959,455744,275625,288976,33391,4157,63188,108675,15044,10887,438505,2015
10," ""51025""","Brunswick, VA",207369,15769,31127,22496,249465,2346,251,27017,496514,12639,29627,498860,69113,72464,176931,16838,1283,12890,42375,5746,4463,152104,2015
11," ""51027""","Buchanan, VA",449807,33912,63939,49708,337440,-259,-319,58766,714540,26502,31374,714281,-53601,92547,284294,22767,1216,26183,88793,8588,7372,334831,2015
12," ""51029""","Buckingham, VA",199203,14579,31244,19920,257394,2319,1053,24539,462615,21083,27314,464934,82730,69008,138532,17022,1352,22136,41204,4946,3594,135863,2015
13," ""51033""","Caroline, VA",336761,24222,53189,36466,819437,-4646,-6776,42455,1260122,33713,41979,1255476,525131,206133,229906,29907,2737,26937,71422,8948,6211,238402,2015
14," ""51036""","Charles City, VA",112361,8061,13494,11224,170162,2305,934,13673,293053,15808,41936,295358,71474,57637,67559,7043,561,16742,19106,2411,1850,76513,2015
15," ""51037""","Charlotte, VA",162709,12708,24122,15586,198822,-540,-2547,20501,391389,26578,32084,390849,56614,64726,127301,12182,1845,24031,31915,5039,3194,106763,2015
16," ""51041""","Chesterfield, VA",8763352,537103,1019164,955172,11421140,73,-955,1014689,16591184,750746,49512,16591257,3672477,2877923,2292194,335093,40056,749791,1496750,180781,140725,6516811,2015
17," ""51043""","Clarke, VA",275492,18105,27928,26786,511974,4136,-289,31498,828702,51962,58437,832838,267980,217891,102973,14252,2984,51673,41321,7127,4143,182498,2015
18," ""51045""","Craig, VA",41904,3854,5993,3958,102696,-865,-1444,5833,184956,8348,35815,184091,66625,33068,48327,5140,630,6904,7972,1386,756,27028,2015
19," ""51047""","Culpeper, VA",1010270,63985,123656,102804,1370567,-566,-6785,115387,2093949,154421,42240,2093383,475684,372539,350277,49559,6981,147636,175058,23717,16736,687576,2015
20," ""51049""","Cumberland, VA",83993,6569,11241,6798,195071,9834,8641,9968,324612,15041,34274,334446,121046,47049,92326,9758,778,23682,14640,2271,1493,45671,2015
21," ""51051""","Dickenson, VA",213550,17491,32293,22202,202759,-1037,-1107,28592,448808,16240,29459,447771,17801,54407,190605,15200,732,15133,43394,4676,3944,155023,2015
22," ""51057""","Essex, VA",182891,13606,24097,20118,220727,-8069,-9014,23665,423929,22773,37495,415860,61501,82913,112220,11091,1370,13759,34156,5429,4059,134976,2015
23," ""51061""","Fauquier, VA",1658792,102384,175695,162238,2817069,-2760,-15933,183503,4371241,304377,63821,4368481,1341780,1108882,442530,68449,11520,288444,256814,35233,23713,1113534,2015
24," ""51063""","Floyd, VA",161277,13272,20575,15234,308320,-119,-3979,20889,540363,36199,34709,540244,167932,94970,136954,15565,2584,32220,28192,5931,3347,100865,2015
25," ""51065""","Fluvanna, VA",285433,21774,39277,28034,649059,-2327,-2948,35791,1067758,42950,40752,1065431,399417,222882,193490,26144,3026,40002,53294,7880,4854,192137,2015
26," ""51067""","Franklin, VA",784680,58700,97102,81072,1158114,5949,740,99236,2110071,119213,37629,2116020,472670,448653,509253,56234,6627,119953,137638,22416,15789,527089,2015
27," ""51071""","Giles, VA",286697,20777,41536,30420,352513,99,-453,35987,608917,25789,36320,609016,101803,89671,166832,16768,1723,25336,56746,6816,5093,204615,2015
28," ""51073""","Gloucester, VA",481224,34952,66776,48446,1033971,748,53,59175,1667856,58196,45058,1668604,611922,316288,318345,37032,3775,58249,90999,13871,10096,331976,2015
29," ""51075""","Goochland, VA",1703707,102905,146664,171504,1175248,-3442,-5230,188657,1990998,76455,88953,1987556,-339802,618717,193591,22344,3681,71225,232416,19582,15901,1400066,2015
30," ""51077""","Grayson, VA",135128,12892,22930,13296,226274,-2949,-4762,19540,454567,22845,28297,451618,110686,69944,155400,15960,2012,18083,29578,4851,2839,87467,2015
31," ""51079""","Greene, VA",224908,16041,24941,20402,504624,525,-502,26242,775181,53693,40391,775706,305958,132725,138357,19205,2098,53191,35142,6004,3906,136575,2015
32," ""51083""","Halifax, VA",646050,45832,95668,71182,584961,-727,-4506,81423,1138798,51966,32420,1138071,20334,178145,374965,35104,3387,47460,131259,16511,13124,467331,2015
33," ""51085""","Hanover, VA",3223176,196920,331458,337256,3983124,4949,-2795,365548,5720883,447346,55539,5725832,1125496,1025635,717073,103095,13956,444551,500086,67704,53748,2278539,2015
34," ""51087""","Henrico, VA",16402895,953447,1430456,1549606,13664034,1033,-162,1728250,19225677,3371299,59264,19226710,-1010611,3360144,2202532,324424,43871,3371137,2205259,244126,200255,10826499,2015
35," ""51091""","Highland, VA",32529,2218,4396,2492,33514,7092,6378,3464,82069,3149,40602,89161,4449,32933,22714,2196,717,9527,5642,1313,596,17360,2015
36," ""51093""","Isle of Wight, VA",702973,47460,81027,71838,1237641,-1309,-3126,83379,1834815,69398,50670,1833506,618047,288284,307581,36185,3891,66272,116946,15634,11743,519755,2015
37," ""51097""","King and Queen, VA",69759,5786,9038,6760,161949,-264,-1339,9166,269652,13408,38001,269388,101356,42483,64956,7089,741,12069,12418,1883,1142,45272,2015
38," ""51099""","King George, VA",1319361,72070,205327,143124,936212,-1648,-2138,143632,1349383,170851,52973,1347735,-239517,258457,153066,25442,2526,168713,276889,14463,11937,873759,2015
39," ""51101""","King William, VA",251475,17393,28330,26496,437753,-2226,-2899,30641,676822,36923,41419,674596,216919,112508,124335,16287,1747,34024,41578,5757,4010,175873,2015
40," ""51103""","Lancaster, VA",245602,18658,28884,25114,203011,-611,-1030,31215,565470,31941,52167,564859,-11376,215850,145998,10828,2015,30911,41441,6888,4873,173250,2015
41," ""51105""","Lee, VA",240698,20734,42514,25352,301969,-1427,-2399,33410,664080,23575,26911,662653,94681,91467,269217,24624,2373,21176,55190,7315,4942,164332,2015
42," ""51107""","Loudoun, VA",13881758,805271,1376796,1442286,21367043,-1028,-14105,1526414,26752456,1307756,71494,26751428,9011699,4051671,1332714,374176,53554,1293651,2097939,220455,166901,10490168,2015
43," ""51109""","Louisa, VA",685813,45277,91649,72914,836695,-788,-2346,81734,1370299,63451,39725,1369511,232616,249820,282996,34475,3783,61105,128106,13948,10165,496602,2015
44," ""51111""","Lunenburg, VA",135239,10699,21181,14320,182308,912,-1205,17859,362545,11832,29434,363457,64928,67823,113326,12348,1027,10627,28341,3900,2873,96271,2015
45," ""51113""","Madison, VA",249012,16581,22054,17930,383475,-910,-3950,25546,614399,105467,46996,613489,160009,128213,101801,13054,2087,101517,31019,5520,3433,116476,2015
46," ""51115""","Mathews, VA",90895,8261,10050,7162,222813,412,362,11842,450288,27660,51025,450700,143760,129806,98081,8833,1348,28022,13631,2954,1606,49242,2015
47," ""51117""","Mecklenburg, VA",564721,41337,78242,64314,498044,3101,-2281,73494,1031895,35823,33458,1034996,6817,193501,343451,30934,3155,33542,110399,15765,12610,420780,2015
48," ""51119""","Middlesex, VA",191373,14299,25828,17330,219960,717,-483,22964,480249,37390,45022,480966,51551,136858,124148,10683,1863,36907,34493,5366,3503,119973,2015
49," ""51125""","Nelson, VA",231150,17300,28774,20602,343318,1804,-1201,27601,676598,54724,45950,678402,139769,175221,159863,14764,2799,53523,39075,7054,4255,138552,2015
50," ""51127""","New Kent, VA",253201,18082,30786,24196,1034292,-1144,-1368,30180,1383605,50024,67828,1382461,811271,197248,150921,20382,3006,48656,42884,7363,4357,161661,2015
51," ""51131""","Northampton, VA",270380,16769,32570,27392,251775,33396,20966,30465,477290,27916,42300,510686,11860,117887,141024,12073,1802,48882,46266,7026,5224,175232,2015
52," ""51133""","Northumberland, VA",150698,13884,18773,15282,210709,317,-594,21525,560226,24327,45785,560543,81536,198721,151113,12243,1772,23733,26414,4397,2625,100551,2015
53," ""51135""","Nottoway, VA",325339,20937,60139,37810,233630,10004,7745,39842,484046,10915,31644,494050,-51867,90796,169624,15613,1443,18660,79044,7790,6347,227635,2015
54," ""51137""","Orange, VA",539933,37902,68501,52562,945723,14116,3353,64183,1576629,81654,45226,1590745,469973,331346,313676,35173,4423,85007,94782,14362,9939,360144,2015
55," ""51139""","Page, VA",321230,22734,39470,31864,466899,34710,31826,38666,803271,42867,35407,837981,184335,151930,219152,23667,2672,74693,55402,8746,6074,191135,2015
56," ""51141""","Patrick, VA",241040,18988,34481,24826,278214,1731,-124,31401,548310,34363,30605,550041,68575,85709,186118,17972,2144,34239,46894,7637,5493,159907,2015
57," ""51145""","Powhatan, VA",445933,30109,58507,43154,957749,343,-447,51686,1420992,67567,50639,1421335,563502,263414,200172,28068,3563,67120,80084,11215,7652,298729,2015
58," ""51147""","Prince Edward, VA",469201,29883,69724,50002,344118,2546,1535,54884,643005,42243,27899,645551,-70199,112831,188602,23139,2243,43778,94725,11851,9608,330698,2015
59," ""51155""","Pulaski, VA",781710,52121,109372,90498,712276,4307,2818,97370,1249597,50763,36496,1253904,27936,188902,352726,34357,2565,53581,154621,17441,14876,573508,2015
60," ""51157""","Rappahannock, VA",146246,10325,13143,10076,223312,-2348,-4242,15363,423263,45124,56811,420915,92429,134692,62911,7409,1721,40882,18181,3465,1744,87183,2015
61," ""51159""","Richmond, VA",160355,10557,26185,16768,154676,751,-1613,18941,291594,12603,33300,292345,13262,64234,73435,8779,1001,10990,34569,4089,3088,114796,2015
62," ""51167""","Russell, VA",412346,32455,55451,48108,424332,1776,-175,56509,840726,24391,30237,842502,68495,114651,303519,27863,2425,24216,79505,10196,7771,308625,2015
63," ""51169""","Scott, VA",239648,21283,35868,26280,334608,-2099,-2785,34423,679496,22570,30379,677397,129383,99375,243414,22298,2581,19785,49008,7838,5257,170855,2015
64," ""51171""","Shenandoah, VA",795333,53359,97619,78660,1037566,23208,19429,92689,1722464,107042,40727,1745672,334922,333384,374722,42863,5688,126471,136949,20934,15246,531913,2015
65," ""51173""","Smyth, VA",667396,45424,99767,70568,585973,8408,6539,80708,1052263,63333,33732,1060671,-715,142832,331866,31444,3085,69872,135051,15996,12911,462473,2015
66," ""51179""","Stafford, VA",3095126,181698,430891,336194,5135169,-3426,-3895,349795,7204032,233697,51055,7200606,2389838,1244334,821103,141035,14099,229802,598988,59304,45205,2266336,2015
67," ""51181""","Surry, VA",277003,16279,46085,29770,171829,-1750,-2585,31164,272299,7004,40538,270549,-74010,38491,60229,6674,669,4419,60970,3354,2685,211614,2015
68," ""51183""","Sussex, VA",205097,13485,33258,22452,176061,767,-691,24711,326261,9884,27970,327028,-4325,49298,101669,11692,861,9193,44484,4929,4068,151420,2015
69," ""51185""","Tazewell, VA",794508,57103,115025,84866,744538,6518,5435,99536,1454165,70334,34025,1460683,49566,232799,483346,42930,3683,75769,157458,20172,16489,561281,2015
70," ""51187""","Warren, VA",702678,45711,87722,76442,1080389,-1807,-2632,83932,1627156,76230,41953,1625349,461643,259716,285244,38742,4396,73598,125943,17331,12935,503137,2015
71," ""51193""","Westmoreland, VA",176499,14294,24343,17524,334550,13337,8009,23056,672246,21023,39058,685583,181107,175418,175615,17553,2115,29032,33105,5925,3810,114362,2015
72," ""51197""","Wythe, VA",587227,39731,85719,63376,506715,10141,7304,71419,926828,45178,32192,936969,-9093,143118,287136,29106,3400,52482,117407,15731,12331,417338,2015
73," ""51510""","Alexandria (Independent City), VA",10223260,573443,1140448,1147078,8932999,0,0,1146982,12502135,907067,81257,12502135,-143279,2816255,752881,153859,24325,907067,1713987,126918,102593,7602206,2015
74," ""51550""","Chesapeake (Independent City), VA",5864676,356303,724110,671618,7456421,3672,-1308,692112,11041623,322041,46951,11045295,2283857,1934058,1654816,235253,22682,320733,1059919,127558,104876,4484024,2015
75," ""51650""","Hampton (Independent City), VA",4203034,236868,690159,516584,3206346,0,0,495160,5373683,133887,39403,5373683,-501528,977445,1189892,136379,11367,133887,948451,75674,64307,3120696,2015
76," ""51700""","Newport News (Independent City), VA",7769411,429450,1153732,897138,4521762,0,0,878019,7083384,335806,39109,7083384,-2369630,1158447,1403175,181121,15521,335806,1602301,123799,108278,5831304,2015
77," ""51710""","Norfolk (Independent City), VA",14332476,727591,2419938,1839268,5177024,0,0,1647225,9122280,274794,36982,9122280,-7508227,2117495,1827761,246667,20718,274794,3339572,211487,190769,10718110,2015
78," ""51740""","Portsmouth (Independent City), VA",3911245,211281,734709,485750,2061915,0,0,454156,3547748,78615,36800,3547748,-1395174,601775,884058,96407,7171,78615,977584,60430,53259,2855046,2015
79," ""51760""","Richmond (Independent City), VA",12990792,738498,1594210,1337700,6493827,0,0,1407348,11011119,1218875,49805,11011119,-5089617,2712727,1804565,221084,25000,1218875,2263060,186071,161071,9508857,2015
80," ""51770""","Roanoke (Independent City), VA",4449021,269542,531977,527300,2228073,0,0,533192,4001638,275472,40120,4001638,-1687756,783803,989762,99741,9447,275472,795627,81492,72045,3377922,2015
81," ""51800""","Suffolk (Independent City), VA",2025326,125166,256915,225016,2730091,10794,-133,237674,4213574,159540,47901,4224368,942439,767060,727217,88190,9131,159407,369423,39711,30580,1496496,2015
82," ""51810""","Virginia Beach (Independent City), VA",12752638,732348,1627341,1405158,15197098,-4712,-6405,1434927,23597008,1457387,52353,23592296,3879387,5197746,3197452,450635,53217,1450982,2329920,255345,202128,8971736,2015
83," ""51901""","Albemarle + Charlottesville, VA*",7244441,412689,963144,740628,5304676,-5382,-16484,783003,9473982,732251,62467,9468600,-1156762,3210384,953540,151578,25459,715767,1333458,124844,99385,5195216,2015
84," ""51903""","Alleghany + Covington, VA*",483734,34309,63319,56064,400428,-1314,-1704,62341,762063,27556,36049,760749,-20965,120695,239626,21103,1514,25852,91351,9961,8447,366531,2015
85," ""51907""","Augusta, Staunton + Waynesboro, VA*",2867325,185363,366059,294378,2892203,53341,44823,332552,4767154,311828,40151,4820495,357430,888720,1039572,120059,13690,356651,513248,64144,50454,1997426,2015
86," ""51911""","Campbell + Lynchburg, VA*",4147231,259443,498343,474054,2584125,514,-1796,496470,4703852,194912,34941,4704366,-1066636,811148,1309093,134637,12569,193116,735370,87095,74526,3218745,2015
87," ""51913""","Carroll + Galax, VA*",595097,43492,82231,63852,606614,7353,4951,75418,1178740,64240,32342,1186093,86935,170581,408898,36673,3414,69191,114157,16561,13147,411749,2015
88," ""51918""","Dinwiddie, Colonial Heights + Petersburg, VA*",1690074,110757,230838,192010,1562058,-1441,-2725,206762,2889210,92612,37262,2887769,78746,473368,852343,77498,7684,89887,326843,41879,34195,1273344,2015
89," ""51919""","Fairfax, Fairfax City + Falls Church, VA*",73298696,4300682,6632634,7689848,62997123,5936,3688,8145606,89563615,6515620,76031,89569551,-2155967,20702347,5870081,1178064,184591,6519308,10477558,877357,692766,56301830,2015
90," ""51921""","Frederick + Winchester, VA*",3562609,215100,431137,381376,3380031,-6317,-10929,405788,5061563,365644,45533,5055246,223210,906017,769198,111025,13429,354715,621825,71689,58260,2586069,2015
91," ""51923""","Greensville + Emporia, VA*",373743,24128,59704,43186,255439,-525,-1574,45721,492051,5615,28312,491526,-72583,68512,167575,17361,1349,4041,81297,9514,8165,288405,2015
92," ""51929""","Henry + Martinsville, VA*",1231769,89843,164498,135402,1131215,6985,6173,157544,2279457,109302,35050,2286442,56990,379202,776025,65233,5420,115475,232199,31747,26327,884095,2015
93," ""51931""","James City + Williamsburg, VA*",2424538,155281,297477,252720,3014250,-3879,-4550,281641,5335993,282988,60775,5332114,871353,1527330,790534,87735,12037,278438,423837,56417,44380,1722263,2015
94," ""51933""","Montgomery + Radford, VA*",3015624,172957,499748,319450,2359943,4430,1174,332682,3807904,187936,33229,3812334,-322999,817412,634979,114728,10874,189110,659473,63192,52318,2167041,2015
95," ""51939""","Pittsylvania + Danville, VA*",1978854,138981,267960,221566,1832366,15496,7040,249764,3494375,125386,33745,3509871,103276,539219,1138286,104011,9741,132426,378743,51253,41512,1467685,2015
96," ""51941""","Prince George + Hopewell, VA*",2515434,126589,479502,328640,1231389,-3165,-3611,290909,2128810,38155,35107,2125645,-993136,406600,487656,60547,3622,34544,643822,36512,32890,1837068,2015
97," ""51942""","Prince William, Manassas + Manassas Park, VA*",11776446,669517,1430715,1272704,19176025,-3527,-6391,1305869,25690072,1400480,50485,25686545,8705448,4067770,2442750,508796,61700,1394089,2067067,228558,166858,8315290,2015
98," ""51944""","Roanoke + Salem, VA*",4122325,257157,498117,420084,3692517,-768,-1603,467199,5738532,416223,48291,5737764,37391,1030737,1014510,118817,13128,414620,708159,76199,63071,2999546,2015
99," ""51945""","Rockbridge, Buena Vista + Lexington, VA*",744551,50055,99308,81866,694140,791,-1422,90988,1330590,90251,36855,1331381,40577,325398,311843,36125,4651,88829,140241,19007,14356,515481,2015
100," ""51947""","Rockingham + Harrisonburg, VA*",3872617,220104,469815,382260,3119619,214142,193545,411234,4583723,400778,36567,4797865,-341764,852618,825628,131208,16353,594323,660945,82108,65755,2617349,2015
101," ""51949""","Southampton + Franklin, VA*",404317,28964,66211,42834,528643,-12033,-16461,50381,986476,37787,36802,974443,174707,184874,260926,26478,2433,21326,87628,11379,8946,295363,2015
102," ""51951""","Spotsylvania + Fredericksburg, VA*",3524002,216358,402229,372274,4967982,139,-1416,402495,7379762,378814,46674,7379901,1846475,1357007,1054912,158117,16857,377398,588366,78689,61832,2558238,2015
103," ""51953""","Washington + Bristol, VA*",1660865,116943,230228,182694,1356889,10109,6576,208290,2632388,115788,36961,2642497,-95686,570432,715176,71494,8254,122364,321575,40319,32065,1216926,2015
104," ""51955""","Wise + Norton, VA*",844947,59312,133036,95182,631993,349,241,106903,1317433,39250,30218,1317782,-106051,181563,504226,43609,2733,39491,180627,19858,17125,624829,2015
105," ""51958""","York + Poquoson, VA*",1461366,91706,195473,163002,2838583,679,-205,173207,4348839,143410,54425,4349518,1550424,970606,540329,79918,6920,143205,276974,33142,26222,1041187,2015
0," ""51000""",Virginia,311566614,18663880,36969072,33423844,296120034,258043,-57008,35375802,449572063,26839062,53439,449830106,19929222,91993130,61716942,8417651,1042791,26782054,53680994,5156641,4113850,231103566,2016
1," ""51001""","Accomack, VA",845991,52881,128688,91406,710353,24931,17865,98584,1328923,64464,41147,1353854,-37054,299253,344248,32903,3801,82329,174391,18612,14811,589271,2016
2," ""51007""","Amelia, VA",164396,11941,18128,14286,332600,15396,10719,19084,513682,30566,41318,529078,187288,74011,122467,12805,1681,41285,25271,4411,2730,97840,2016
3," ""51009""","Amherst, VA",470750,35272,70007,49642,620441,-1872,-2844,60093,1098357,35224,34369,1096485,209784,172811,303233,31903,2970,32380,94828,12148,9178,343542,2016
4," ""51011""","Appomattox, VA",160890,13922,23383,15516,319666,-3006,-4062,21680,560383,22878,35879,557377,180456,83225,154486,15535,1768,18816,31141,5294,3526,110933,2016
5," ""51013""","Arlington, VA",22040503,1220142,2524614,2448002,14854712,0,0,2444143,20198584,1287387,87136,20198584,-4741648,4386558,957314,231805,34625,1287387,3748615,227324,192699,17004501,2016
6," ""51017""","Bath, VA",132251,8906,16772,14082,111698,724,99,15947,249098,7327,56675,249822,-4606,87629,50495,4408,626,7426,23813,3092,2466,101012,2016
7," ""51019""","Bedford, VA*",1121882,86884,134026,116514,1981559,-7827,-10172,145141,3341913,151129,42732,3334086,1004818,642642,709885,78024,9913,140957,192283,30483,20570,788642,2016
8," ""51021""","Bland, VA",125266,8836,21794,13382,111587,-476,-910,15527,212766,9398,32746,212290,1848,35390,65313,6483,743,8488,28485,2821,2078,88293,2016
9," ""51023""","Botetourt, VA",611979,44432,76005,64442,981568,-2841,-4515,76653,1580479,62107,47379,1577638,446242,288452,307618,33298,4286,57592,108226,15314,11028,446161,2016
10," ""51025""","Brunswick, VA",210433,16508,31371,23278,252558,1242,-1130,28147,505903,10751,30538,507145,70272,74935,179652,16607,1363,9621,43010,5786,4423,157802,2016
11," ""51027""","Buchanan, VA",395768,31909,59295,43920,300376,-297,-366,53869,690173,20298,31035,689876,-41523,93094,296406,22229,1263,19932,81255,8224,6961,294581,2016
12," ""51029""","Buckingham, VA",200915,15343,32434,20210,258573,-841,-2267,25448,470295,20497,27544,469454,83106,70375,140506,17044,1496,18230,42539,5150,3654,140146,2016
13," ""51033""","Caroline, VA",346682,25444,54974,36932,756989,-3505,-5914,43910,1204561,31956,39914,1201056,454217,208175,235892,30091,2878,26042,73440,9191,6313,247200,2016
14," ""51036""","Charles City, VA",110786,8278,13727,11362,171652,2615,1069,13959,300244,10971,43105,302859,74825,60849,70358,7026,728,12040,19408,2580,1852,79338,2016
15," ""51037""","Charlotte, VA",168330,13591,24974,16624,204596,-3015,-5274,21903,404051,24831,33108,401036,58169,66700,129740,12113,1774,19557,33286,5081,3307,115487,2016
16," ""51041""","Chesterfield, VA",8990786,558580,1060217,972532,11695065,217,-943,1044846,17120682,727435,50552,17120899,3749125,3016510,2409324,338677,41079,726492,1546483,185375,144296,6717811,2016
17," ""51043""","Clarke, VA",272966,18612,28513,26678,542949,2450,-2552,31951,884762,48506,62004,887212,301934,234707,109556,14309,2754,45954,41852,6975,4221,185160,2016
18," ""51045""","Craig, VA",41194,4005,6384,3926,97188,-1583,-2235,5968,180419,6985,34807,178836,61962,32756,48892,5138,647,4750,8347,1417,770,28097,2016
19," ""51047""","Culpeper, VA",1031761,66816,125588,102924,1445045,-1806,-8835,118278,2202220,155961,43714,2200414,531562,386559,368810,50337,6548,147126,177050,23169,16621,707585,2016
20," ""51049""","Cumberland, VA",85149,7134,11849,7406,198442,6559,5213,10837,332759,13695,34830,339318,124130,49302,91574,9742,1020,18908,15552,2554,1534,50689,2016
21," ""51051""","Dickenson, VA",189696,16661,29562,20260,189499,-789,-867,26791,438928,12324,29172,438139,26594,54280,194360,15019,730,11457,39692,4393,3663,138547,2016
22," ""51057""","Essex, VA",187092,14205,25113,20644,224222,-7628,-8697,24527,433564,20114,38466,425936,61657,88870,112844,11073,1350,11417,35435,5483,4133,140240,2016
23," ""51061""","Fauquier, VA",1708638,107641,183436,164534,2932592,-4031,-18927,189908,4501488,298892,65341,4497457,1413862,1100291,464574,68831,12061,279965,265703,36207,24146,1162970,2016
24," ""51063""","Floyd, VA",160796,13945,21668,15682,311293,-3073,-7435,21786,558949,33290,35440,555876,172283,102387,142196,15685,2652,25855,29509,6088,3436,105432,2016
25," ""51065""","Fluvanna, VA",274664,22002,39669,26114,668971,-3013,-3715,35059,1090275,43489,41456,1087262,429366,219019,199272,26227,3000,39774,52726,7556,4556,182164,2016
26," ""51067""","Franklin, VA",789204,61453,98400,81590,1167308,-310,-6187,102248,2157813,115079,38412,2157503,480352,460612,529583,56167,6756,108892,139195,22654,15898,541117,2016
27," ""51071""","Giles, VA",279162,21091,40487,29894,348679,-1673,-2292,36038,620569,23870,36719,618896,105555,93809,176408,16855,1649,21578,55434,6735,5086,202150,2016
28," ""51073""","Gloucester, VA",495462,36892,69382,49712,1087695,689,-84,61748,1736045,56683,46786,1736734,653981,325066,323973,37121,3871,56599,94238,14001,10130,344625,2016
29," ""51075""","Goochland, VA",1759634,107007,152518,176390,1152675,-5101,-7120,195202,2056367,81277,90504,2051266,-411757,698621,199970,22665,4424,74157,240713,20699,16275,1444764,2016
30," ""51077""","Grayson, VA",131517,13747,24108,13762,226375,-11186,-13232,20628,474507,22073,29195,463321,115486,74470,162476,15870,2096,8841,30989,5020,2924,91687,2016
31," ""51079""","Greene, VA",241394,17639,25785,21122,524859,-153,-1315,28200,803913,62339,41618,803760,311665,137071,141830,19313,2286,61024,36346,6289,4003,144024,2016
32," ""51083""","Halifax, VA",654071,47637,98714,71416,594073,-3593,-7860,83345,1174624,50183,33455,1171031,23347,192442,384516,35003,3385,42323,134422,16393,13008,477326,2016
33," ""51085""","Hanover, VA",3293419,205060,340006,342170,4112610,5190,-3567,376145,5958627,418842,57155,5963817,1195336,1093238,757969,104345,14959,415275,511091,69455,54496,2367053,2016
34," ""51087""","Henrico, VA",16803782,989321,1456538,1560502,14006701,1067,-285,1769572,19860830,3551355,60893,19861897,-1027509,3551914,2303282,326178,43855,3551070,2236789,246887,203032,11015923,2016
35," ""51091""","Highland, VA",30005,2341,4495,2532,30942,3857,3053,3607,84834,3042,40077,88691,4544,34379,23370,2213,702,6095,5761,1295,593,18149,2016
36," ""51093""","Isle of Wight, VA",702871,48667,83031,72166,1273663,-2387,-4438,84750,1903044,59016,52144,1900657,655542,306905,320089,36450,3992,54578,119114,15812,11820,529179,2016
37," ""51097""","King and Queen, VA",69845,6037,9077,6728,165461,-189,-1403,9401,279561,12850,39577,279372,105017,45645,68266,7059,754,11447,12441,1899,1145,45957,2016
38," ""51099""","King George, VA",1309128,71310,227041,150952,900858,-1564,-2115,146786,1328221,73171,51061,1326657,-261484,264790,161009,25982,2509,71056,302517,15256,12747,935555,2016
39," ""51101""","King William, VA",255066,18167,29771,26554,478748,-2281,-3038,31444,726589,31807,44122,724308,255126,118640,126920,16416,1819,28769,43048,6017,4198,183249,2016
40," ""51103""","Lancaster, VA",256639,19796,29919,25760,211959,-136,-612,32676,585924,35348,54360,585788,-12004,225484,148345,10776,1965,34736,42799,6888,4923,179104,2016
41," ""51105""","Lee, VA",244950,21707,43808,25536,299377,-3267,-4353,34475,665745,24122,27377,662478,88902,90713,272388,24198,2430,19769,56576,7351,4921,168605,2016
42," ""51107""","Loudoun, VA",14413547,838396,1415654,1484628,22892461,2313,-12452,1580710,28701870,1443075,74411,28704183,10059624,4355512,1456210,385750,57298,1430623,2157968,229519,172221,10824956,2016
43," ""51109""","Louisa, VA",678470,45820,95518,69712,853905,-1275,-3031,80676,1407325,68935,39942,1406050,256111,253640,298505,35202,4161,65904,130374,13967,9806,482192,2016
44," ""51111""","Lunenburg, VA",136742,11230,21483,14268,184827,-120,-2522,18364,376025,11248,30462,375905,66449,71896,119182,12340,1131,8726,28617,4018,2887,99399,2016
45," ""51113""","Madison, VA",238102,16753,22477,18552,390011,-3448,-6875,26029,637521,89368,48414,634073,177938,135593,108469,13097,2305,82493,31753,5699,3394,123856,2016
46," ""51115""","Mathews, VA",92321,8711,10400,7178,227955,579,523,12300,457767,27540,52197,458346,147934,132443,97948,8781,1360,28063,13989,2987,1627,50269,2016
47," ""51117""","Mecklenburg, VA",572380,42876,80244,64198,503995,1606,-4479,74975,1047790,34163,34055,1049396,6590,200682,344719,30815,3055,29684,112343,15617,12562,430353,2016
48," ""51119""","Middlesex, VA",195077,15054,26849,17778,224333,737,-624,23943,496080,34016,46216,496817,53199,143872,128612,10750,1743,33392,35738,5327,3584,125947,2016
49," ""51125""","Nelson, VA",235745,18307,29532,21120,354773,1606,-1789,28867,697329,50372,47219,698935,147895,180813,163349,14802,2577,48583,40092,6795,4218,147070,2016
50," ""51127""","New Kent, VA",270968,19902,32090,25114,1015807,-1570,-1824,32459,1385574,56445,65858,1384004,777298,207805,160392,21015,3049,54621,44647,7584,4535,171700,2016
51," ""51131""","Northampton, VA",269334,17105,32998,26616,283260,35329,21252,30413,517875,28053,46089,553204,44339,121888,148056,12003,1845,49305,46306,6957,5112,173723,2016
52," ""51133""","Northumberland, VA",157615,14680,19836,16100,221117,990,-41,22730,585873,23678,48206,586863,86232,209492,156254,12174,1833,23637,27886,4534,2701,106092,2016
53," ""51135""","Nottoway, VA",316770,20959,61041,36124,227785,8253,5706,39021,491074,6849,32210,499327,-49964,95236,176306,15502,1350,12555,79103,7535,6185,225112,2016
54," ""51137""","Orange, VA",575852,40818,73367,56394,985500,16644,4474,69015,1633172,82103,46646,1649816,478663,344486,319830,35369,4314,86577,101564,14743,10429,387711,2016
55," ""51139""","Page, VA",319636,23997,41509,32894,470339,24430,21180,40444,824244,40161,35911,848674,191147,151637,226698,23633,2688,61341,57956,8841,6153,200339,2016
56," ""51141""","Patrick, VA",235608,19376,34178,24770,274428,1541,-552,31761,550578,28235,30966,552119,70581,87470,190221,17830,2109,27683,46563,7499,5390,161362,2016
57," ""51145""","Powhatan, VA",465272,32294,59873,44488,1023896,-228,-1120,54538,1506972,69670,52937,1506744,613162,275507,207341,28463,3891,68550,82117,11733,7842,314605,2016
58," ""51147""","Prince Edward, VA",485804,31488,73866,51638,353486,1634,492,57307,663485,38673,28857,665119,-75011,116511,195122,23049,2065,39165,99685,11970,9905,346954,2016
59," ""51155""","Pulaski, VA",724165,50541,103607,80416,700893,306,-1371,90749,1261785,49806,36830,1262091,67477,196111,365087,34268,2950,48435,143815,16972,14022,531915,2016
60," ""51157""","Rappahannock, VA",142922,10630,13265,10510,232390,-3353,-5491,15885,436645,40525,58680,433292,105353,136642,64260,7384,1951,35034,18520,3752,1801,89368,2016
61," ""51159""","Richmond, VA",165503,11112,27331,17296,160592,1508,-1164,19760,303405,10880,34827,304913,14849,68376,75945,8755,969,9716,35979,4130,3161,119808,2016
62," ""51167""","Russell, VA",412231,33481,55727,46954,408946,-2288,-4483,56958,841184,27448,30591,838896,53673,118653,311297,27423,2495,22965,79204,10196,7701,310062,2016
63," ""51169""","Scott, VA",231073,21709,35196,25178,329237,-3953,-4725,34298,684835,21543,30851,680882,132462,104062,247583,22070,2559,16818,47785,7657,5098,166470,2016
64," ""51171""","Shenandoah, VA",801126,55823,99159,78818,1055138,13623,9386,95232,1757904,106227,41235,1771527,349244,338059,378330,42962,5631,115613,138568,20710,15079,546945,2016
65," ""51173""","Smyth, VA",668506,47014,102305,71558,580342,557,-1553,82793,1075135,52045,34540,1075692,-5371,153544,341806,31143,3019,50492,138084,16441,13422,479930,2016
66," ""51179""","Stafford, VA",3185204,189046,452651,340874,5355657,-3771,-4298,359483,7461237,229978,51917,7457466,2529936,1233626,868183,143641,14772,225680,623088,61061,46289,2336436,2016
67," ""51181""","Surry, VA",245030,14343,48858,25868,159575,-1716,-2658,27277,261565,4620,39611,259849,-58178,36229,64045,6560,695,1962,61792,3198,2503,181276,2016
68," ""51183""","Sussex, VA",200095,13517,33485,21950,171050,-325,-1968,24492,320773,7633,28048,320448,-4553,47683,101715,11425,836,5665,44460,4838,4002,149970,2016
69," ""51185""","Tazewell, VA",736821,56360,112230,79918,681376,1142,-74,96319,1405623,50104,33315,1406765,40874,233787,491602,42226,3611,50030,152189,19396,15785,534602,2016
70," ""51187""","Warren, VA",704542,46824,90361,76484,1148346,-2173,-3103,85066,1711849,71329,43618,1709676,528870,268341,292989,39197,4442,68226,128603,17429,12987,507713,2016
71," ""51193""","Westmoreland, VA",190258,15369,25722,18206,356338,17061,11041,24472,703464,23600,40835,720525,190552,184592,179595,17645,2203,34641,34825,6090,3887,120792,2016
72," ""51197""","Wythe, VA",586938,41258,87055,63184,495955,-501,-3705,72850,940373,44402,32524,939872,-18133,145158,298759,28898,3298,40697,118647,15726,12428,427594,2016
73," ""51510""","Alexandria (Independent City), VA",10309655,580197,1167248,1140802,9090789,0,0,1150598,12825150,912487,81887,12825150,-68268,2935212,799149,156621,25705,912487,1737649,127045,101340,7659519,2016
74," ""51550""","Chesapeake (Independent City), VA",5973251,368266,733064,673456,7678167,4162,-1484,704994,11377244,324839,47890,11381406,2409910,1972938,1730301,237656,23684,323355,1069792,130010,106326,4580104,2016
75," ""51650""","Hampton (Independent City), VA",4265648,241639,713526,516126,3197284,0,0,499702,5407022,120158,39897,5407022,-568662,983244,1226494,135525,11984,120158,971589,76158,64174,3173901,2016
76," ""51700""","Newport News (Independent City), VA",7483867,421550,1104050,856912,4454730,0,0,850006,7094057,285826,39308,7094057,-2179131,1190235,1449092,180472,16159,285826,1532506,122232,106073,5665535,2016
77," ""51710""","Norfolk (Independent City), VA",14765230,746629,2539191,1851664,5227277,0,0,1672461,9291230,266906,37763,9291230,-7865492,2188663,1875290,246042,21457,266906,3465023,219880,198423,11033301,2016
78," ""51740""","Portsmouth (Independent City), VA",3945920,211584,775205,480778,2026236,0,0,451973,3503984,56964,36773,3503984,-1467711,573797,903951,95287,7547,56964,1015594,60852,53305,2873362,2016
79," ""51760""","Richmond (Independent City), VA",13361681,762268,1659215,1362882,6674446,0,0,1443709,11335985,1259089,50233,11335985,-5243526,2821486,1840053,225669,28126,1259089,2340656,193558,165432,9761936,2016
80," ""51770""","Roanoke (Independent City), VA",4546407,276290,547382,526530,2168976,0,0,539555,3947144,277382,39716,3947144,-1837876,771903,1006265,99383,9197,277382,810647,81833,72636,3458378,2016
81," ""51800""","Suffolk (Independent City), VA",2084421,130529,268820,228308,2820725,12081,-306,244683,4387508,162452,49234,4399589,980987,815869,762995,89360,9323,162146,382974,41291,31968,1539301,2016
82," ""51810""","Virginia Beach (Independent City), VA",13300405,765949,1748165,1466546,15444863,-5381,-7283,1499222,24299094,1362716,53805,24293713,3643680,5537995,3310855,451510,54935,1355433,2481438,266272,211337,9463534,2016
83," ""51901""","Albemarle + Charlottesville, VA*",7529609,433158,993360,751614,5507074,-5609,-18085,808965,10098274,836157,65691,10092665,-1213570,3589005,996586,153638,26991,818072,1369167,128766,101775,5342370,2016
84," ""51903""","Alleghany + Covington, VA*",477152,34635,64037,55830,393876,-1089,-1526,62550,770397,19484,36503,769308,-20726,123913,251519,21075,1524,17958,91952,9933,8409,367242,2016
85," ""51907""","Augusta, Staunton + Waynesboro, VA*",2895380,191203,379907,300584,2928024,26362,16802,341495,4913582,281155,40876,4939944,374139,939864,1072056,120852,14075,297957,530199,65224,51149,2067224,2016
86," ""51911""","Campbell + Lynchburg, VA*",4166055,264636,505339,472846,2553923,-2719,-5312,501059,4713233,169584,34825,4710514,-1111073,804705,1351886,135262,12609,164272,741762,87201,74592,3260021,2016
87," ""51913""","Carroll + Galax, VA*",600827,45296,83818,64150,608212,2867,161,77371,1191891,60273,32820,1194758,84756,177113,409433,36403,3825,60434,115893,17214,13389,424500,2016
88," ""51918""","Dinwiddie, Colonial Heights + Petersburg, VA*",1731411,115118,238843,194254,1543056,-2863,-4305,212245,2873580,79617,37168,2870717,23890,453347,874314,77237,6405,75312,335970,41064,34659,1320129,2016
89," ""51919""","Fairfax, Fairfax City + Falls Church, VA*",74346374,4432450,6744312,7834244,63333122,4527,2001,8349572,90940532,5711856,76947,90945059,-2663680,21576801,6035136,1181911,188947,5713857,10661434,893525,704578,57971083,2016
90," ""51921""","Frederick + Winchester, VA*",3686448,225348,446748,389420,3550864,-5989,-11176,420058,5326627,379908,47290,5320638,284474,961335,808439,112511,13812,368732,641458,72849,59037,2676258,2016
91," ""51923""","Greensville + Emporia, VA*",387139,25192,62331,43788,264407,576,-609,47086,497681,4446,29306,498257,-75646,67140,166710,17002,1196,3837,84225,9430,8234,299077,2016
92," ""51929""","Henry + Martinsville, VA*",1249580,93075,167956,135542,1145423,6614,5696,160846,2310357,100972,35822,2316971,56689,377399,794149,64681,5207,106668,235727,31856,26649,907185,2016
93," ""51931""","James City + Williamsburg, VA*",2519707,164238,312974,261508,3135233,-4622,-5376,294992,5567778,269468,62529,5563156,910518,1603027,824896,88969,11541,264092,443728,56826,45285,1811887,2016
94," ""51933""","Montgomery + Radford, VA*",3130407,181581,519361,326562,2404581,1893,-1768,344862,3928220,201173,33991,3930113,-380964,867332,658200,115623,10561,199405,682642,63956,53395,2248360,2016
95," ""51939""","Pittsylvania + Danville, VA*",2008496,144654,274016,224080,1854292,11463,1945,256694,3539003,114053,34329,3550466,102490,522758,1173416,103426,9808,115998,386056,51625,41817,1506442,2016
96," ""51941""","Prince George + Hopewell, VA*",2370568,122852,446718,294402,1241974,-2703,-3202,270053,2123490,46198,35002,2120787,-858541,378190,500623,60591,4046,42996,593919,35686,31640,1733653,2016
97," ""51942""","Prince William, Manassas + Manassas Park, VA*",12054958,699241,1434743,1275308,19814770,-4273,-7485,1336895,26524117,1428986,51548,26519844,9096707,4128470,2576604,514470,65172,1421501,2072397,236044,170872,8561060,2016
98," ""51944""","Roanoke + Salem, VA*",3904368,247973,489309,410206,3671874,-950,-1882,453076,5805902,395505,48868,5804952,220582,1075551,1057527,118788,12976,393623,694412,75898,62922,2816333,2016
99," ""51945""","Rockbridge, Buena Vista + Lexington, VA*",748350,51603,102630,81754,691871,-2439,-4924,92480,1352319,85818,37379,1349880,36001,339827,318182,36113,4662,80894,143507,19147,14485,523949,2016
100," ""51947""","Rockingham + Harrisonburg, VA*",3891020,228657,489703,390428,3101507,144208,121030,423871,4704687,376545,36434,4848895,-365642,894868,852520,133086,16227,497575,684917,84320,68093,2708528,2016
101," ""51949""","Southampton + Franklin, VA*",404754,29692,67394,43062,529110,-9470,-14465,51223,1013027,29818,38158,1003557,175579,199880,274567,26300,2439,15353,88925,11287,8848,300476,2016
102," ""51951""","Spotsylvania + Fredericksburg, VA*",3583253,223431,417683,373902,5127829,18,-1726,410382,7643733,376980,47812,7643751,1954958,1404724,1111198,159870,18032,375254,604634,80991,62959,2603365,2016
103," ""51953""","Washington + Bristol, VA*",1549048,115410,230953,177978,1251899,-2049,-6016,204399,2559097,32889,35854,2557048,-92750,566499,738650,71318,8492,26873,319942,40485,31993,1202233,2016
104," ""51955""","Wise + Norton, VA*",789418,57850,128114,87606,584967,-243,-364,101653,1286418,33472,29876,1286175,-102798,186587,514621,43051,2633,33108,171917,18875,16242,584393,2016
105," ""51958""","York + Poquoson, VA*",1486437,95131,199819,164902,2918763,1039,42,177582,4452698,131630,55773,4453737,1609908,971528,563446,79854,8081,131672,282270,35008,26927,1072495,2016
0," ""51000""",Virginia,322968435,19638663,37881106,34821992,306338411,514932,198726,37049659,466922719,26670599,55181,467437651,20419635,96852878,64246362,8471011,1077432,26869325,55292102,5229033,4151601,240807008,2017
1," ""51001""","Accomack, VA",986168,59694,152088,110926,789373,31252,24155,115157,1438191,64196,44897,1469443,-81638,321957,358113,32729,3782,88351,207551,19360,15578,690266,2017
2," ""51007""","Amelia, VA",169112,12511,18446,14938,339759,17658,12955,19980,527342,28808,42007,545000,190627,76121,129120,12974,1788,41763,25915,4538,2750,101434,2017
3," ""51009""","Amherst, VA",464023,36063,66164,49276,634062,-162,-1140,60701,1126554,36409,35318,1126392,230740,177504,314826,31893,2996,35269,90802,11849,8853,337952,2017
4," ""51011""","Appomattox, VA",166767,14682,23708,16146,333063,-2021,-3077,22755,581627,22872,36882,579606,189051,86864,159679,15715,1804,19795,31781,5369,3565,115191,2017
5," ""51013""","Arlington, VA",23134430,1294824,2653609,2595288,15580620,0,0,2592468,21259091,1193632,90390,21259091,-4961342,4676182,1002289,235193,35939,1193632,3951253,233632,197693,17989545,2017
6," ""51017""","Bath, VA",134169,9138,16607,14176,113422,1504,878,16226,258342,7668,60854,259846,-4521,95479,50945,4270,601,8546,23695,3055,2454,101928,2017
7," ""51019""","Bedford, VA*",1132115,90225,135790,117540,2077484,-7265,-9613,148995,3502046,148879,44551,3494781,1094364,676634,740663,78445,10203,139266,194560,30585,20382,798289,2017
8," ""51021""","Bland, VA",130568,9349,22180,14244,116980,149,-280,16471,223396,9758,35143,223545,2883,36133,70432,6361,716,9478,29302,2818,2102,91788,2017
9," ""51023""","Botetourt, VA",640071,47101,78586,67192,989117,-2105,-3787,80697,1609968,64986,48205,1607863,429743,298501,320245,33355,4212,61199,112182,15316,11104,466690,2017
10," ""51025""","Brunswick, VA",206450,16869,30347,22838,255529,1579,-807,28288,515653,11014,31211,517232,77367,79998,181705,16572,1311,10207,41766,5457,4146,154477,2017
11," ""51027""","Buchanan, VA",432546,34451,61730,46764,328627,-301,-370,57833,719851,30910,33279,719550,-46086,86332,304591,21622,1263,30540,85112,8352,7089,316894,2017
12," ""51029""","Buckingham, VA",202651,15915,31409,20682,269251,202,-1224,26256,488411,21838,28664,488613,92856,72378,146984,17046,1554,20614,41750,5126,3572,140287,2017
13," ""51033""","Caroline, VA",365672,27214,55266,38594,793696,542,-1876,46511,1259303,35590,41386,1259845,474535,217644,248505,30441,3198,33714,74563,9498,6300,257395,2017
14," ""51036""","Charles City, VA",116788,8878,14150,12272,174719,3716,2170,15014,310426,8887,44724,314142,72945,65507,73916,7024,750,11057,20286,2623,1873,85445,2017
15," ""51037""","Charlotte, VA",168408,13936,24891,16656,205264,-1630,-3897,22264,412102,25868,33985,410472,59120,68589,136619,12078,1728,21971,33219,5009,3281,113218,2017
16," ""51041""","Chesterfield, VA",9440773,595388,1094803,1012512,12191519,1379,217,1101644,17916430,814721,52162,17917809,3852390,3179991,2546299,343500,42936,814938,1601059,188769,145833,7024776,2017
17," ""51043""","Clarke, VA",293428,20290,29787,28814,563869,2552,-2475,34697,910444,53762,63105,912996,305138,230468,118659,14468,2709,51287,44194,7089,4380,197947,2017
18," ""51045""","Craig, VA",42853,4302,6169,4036,101303,-1439,-2098,6320,188343,7931,36865,186904,64770,33822,51779,5070,658,5833,8187,1428,770,28833,2017
19," ""51047""","Culpeper, VA",1069650,70401,127080,106522,1509795,1601,-5469,123662,2291411,162560,44732,2293012,563807,397693,385524,51261,6811,157091,180341,23634,16823,732218,2017
20," ""51049""","Cumberland, VA",93160,7795,11966,7990,208246,7749,6397,11790,350041,16486,36361,357790,126876,51847,97697,9840,1058,22883,15961,2578,1520,54316,2017
21," ""51051""","Dickenson, VA",194538,17498,31106,20852,192224,-421,-500,27924,444976,10694,30184,444555,25610,49974,202357,14728,726,10194,41532,4350,3624,142812,2017
22," ""51057""","Essex, VA",192075,14728,24718,20648,231230,-3806,-4885,25052,446709,21350,40411,442903,64207,93031,118642,10960,1371,16465,35042,5387,4016,140568,2017
23," ""51061""","Fauquier, VA",1777668,112920,185442,170460,3114083,5792,-9175,198150,4726982,326359,68044,4732774,1534565,1133108,485583,69555,12236,317184,270672,36419,24183,1189812,2017
24," ""51063""","Floyd, VA",169245,14924,21880,16756,316216,-1205,-5584,23302,577763,33045,36530,576558,170273,110671,149671,15783,2592,27461,30258,6167,3575,111526,2017
25," ""51065""","Fluvanna, VA",289832,23628,38801,26452,703493,-2088,-2791,36854,1148065,55772,43217,1145977,450515,232305,210179,26517,3092,52981,52027,7617,4525,184824,2017
26," ""51067""","Franklin, VA",826457,65373,101165,84588,1199021,3460,-2443,107667,2215501,122110,39384,2218961,480231,475331,544609,56341,6736,119667,143459,22931,16195,563331,2017
27," ""51071""","Giles, VA",276158,21630,38914,29312,355558,-549,-1169,36286,634609,25129,37834,634060,115686,98648,179854,16759,1656,23960,53570,6590,4934,198628,2017
28," ""51073""","Gloucester, VA",514625,39241,69460,51616,1121272,1102,334,65049,1795798,62093,48133,1796900,671696,336220,339408,37332,3956,62427,95268,14075,10119,356930,2017
29," ""51075""","Goochland, VA",2050560,125595,167281,205160,1276959,-4092,-6115,228175,2222628,102046,96909,2218536,-545426,740151,201426,22893,4490,95931,269861,21602,17112,1684768,2017
30," ""51077""","Grayson, VA",140823,14772,24774,14668,230496,-9730,-11781,22106,482730,23596,30129,473000,111779,73679,168825,15699,2036,11815,32108,5168,3132,96900,2017
31," ""51079""","Greene, VA",249286,18484,26108,21414,541199,579,-589,29191,840873,66028,42914,841452,321104,151230,149023,19608,2415,65439,36815,6450,4035,147032,2017
32," ""51083""","Halifax, VA",671776,49998,96850,73430,607636,-1567,-5852,86713,1199798,54239,34639,1198231,22573,198803,391792,34592,3366,48387,133565,16366,13000,489824,2017
33," ""51085""","Hanover, VA",3419406,216090,353428,354984,4233515,8658,-141,393582,6186168,400672,58592,6194826,1207691,1159571,801740,105729,15314,400531,530920,70445,55131,2487955,2017
34," ""51087""","Henrico, VA",17670838,1046430,1519107,1628524,14677821,1732,372,1860692,20860034,3764609,63601,20861766,-1132325,3787498,2396447,328008,45561,3764981,2333369,252963,207402,11572488,2017
35," ""51091""","Highland, VA",32117,2513,4430,2614,32913,5456,4650,3820,88783,3448,42546,94239,4616,35671,25655,2215,663,8098,5737,1256,593,18282,2017
36," ""51093""","Isle of Wight, VA",732323,51476,84413,74278,1308211,3736,1681,88615,1949229,61343,53130,1952965,664503,309204,335550,36758,4229,63024,121552,15933,11704,547747,2017
37," ""51097""","King and Queen, VA",73829,6451,9154,7074,174500,1306,85,9988,289261,13041,41450,290567,110659,47029,69038,7010,817,13126,12691,1981,1164,48012,2017
38," ""51099""","King George, VA",1365232,74830,241319,157968,934355,-449,-1000,153814,1377998,70746,52221,1377549,-277063,275557,167637,26379,2621,69746,320303,15410,12789,975183,2017
39," ""51101""","King William, VA",265126,19165,30477,27354,505510,-47,-807,32842,763436,31399,45695,763389,273226,124072,133807,16706,1883,30592,44154,6160,4277,190380,2017
40," ""51103""","Lancaster, VA",266234,20876,29943,26714,219660,296,-181,34233,617068,37096,57568,617364,-12341,248593,149111,10724,1986,36915,43300,6904,4918,186019,2017
41," ""51105""","Lee, VA",244591,22567,43663,25258,303476,-4227,-5310,35196,674179,27007,27992,669952,94081,83482,282994,23934,2361,21697,56292,7132,4771,166602,2017
42," ""51107""","Loudoun, VA",15195627,894124,1487783,1570984,24031218,8308,-6523,1679616,30265376,1419374,76219,30273684,10515207,4717275,1525191,397192,60013,1412851,2273275,237388,177375,11509501,2017
43," ""51109""","Louisa, VA",720919,49646,94847,74150,912020,-761,-2525,86721,1507220,78194,42076,1506459,277822,280609,313830,35803,4366,75669,131922,14728,10362,513328,2017
44," ""51111""","Lunenburg, VA",140816,11845,21632,14620,188152,579,-1842,19155,385601,11982,31262,386180,66491,74505,123523,12353,1214,10140,28942,4104,2890,101734,2017
45," ""51113""","Madison, VA",212708,15823,22254,19068,366768,-1556,-4998,25357,620647,58767,46837,619091,179417,140720,111603,13218,2325,53769,31788,5760,3435,127151,2017
46," ""51115""","Mathews, VA",93893,9138,10476,7550,232836,860,802,12913,468778,28163,53957,469638,151856,132175,104627,8704,1374,28965,14251,3003,1629,50677,2017
47," ""51117""","Mecklenburg, VA",586697,44958,79283,64690,517739,2500,-3608,77303,1081456,38643,35302,1083956,8345,206675,359542,30705,3032,35035,111628,15374,12342,440034,2017
48," ""51119""","Middlesex, VA",211174,16378,28064,19116,240137,1179,-194,25936,522702,37379,49358,523881,54899,152067,131677,10614,1720,37185,37622,5478,3758,136367,2017
49," ""51125""","Nelson, VA",238076,19252,28826,21738,363625,3563,156,30121,719164,47293,48833,722727,155670,192616,166486,14800,2494,47449,39695,6655,4161,150932,2017
50," ""51127""","New Kent, VA",279061,21135,32501,25826,1101481,-1663,-1918,34048,1501551,58221,69346,1499888,856468,222647,175760,21629,3172,56303,45414,7728,4556,177344,2017
51," ""51131""","Northampton, VA",258915,16728,29352,24994,315404,42414,28262,29225,555894,30150,50418,598308,85714,129616,153288,11867,1832,58412,41849,6534,4702,158654,2017
52," ""51133""","Northumberland, VA",168959,15780,20538,16698,233868,2209,1168,24129,607118,28021,49660,609327,89038,213772,161687,12270,1819,29189,28887,4477,2658,110883,2017
53," ""51135""","Nottoway, VA",318643,21575,59597,36508,232637,11549,8991,39829,500342,6150,33156,511891,-46177,98573,180681,15439,1404,15141,77851,7422,6018,225651,2017
54," ""51137""","Orange, VA",600829,43077,73560,57716,1029917,25470,13241,71935,1698213,86822,48038,1723683,501023,365723,328043,35882,4430,100063,102418,14867,10437,398348,2017
55," ""51139""","Page, VA",332082,25434,41805,33764,487707,28096,24831,42316,847034,41807,36769,875130,197941,152033,235390,23801,2684,66638,58687,8803,6119,206757,2017
56," ""51141""","Patrick, VA",240257,20248,34192,25108,280323,2718,620,32802,568952,27634,32249,571670,72868,93220,198127,17727,2072,28254,46746,7394,5322,165257,2017
57," ""51145""","Powhatan, VA",470000,33512,56999,44104,1076257,530,-365,55564,1584770,78977,55195,1585300,661821,289617,219426,28722,4049,78612,79051,11782,7733,312337,2017
58," ""51147""","Prince Edward, VA",502174,33181,73718,54186,363176,2625,1481,60274,689664,36374,30500,692289,-78724,123006,206107,22698,2057,37855,100811,12121,10064,363508,2017
59," ""51155""","Pulaski, VA",746066,52975,104226,81218,711672,1417,-269,93584,1288620,52372,37660,1290037,59190,204081,374284,34255,2863,52103,144835,16656,13793,549128,2017
60," ""51157""","Rappahannock, VA",152309,11373,13471,11060,233617,-2597,-4741,16903,454706,43642,61022,452109,98211,151512,66980,7409,1965,38901,19001,3766,1801,94407,2017
61," ""51159""","Richmond, VA",168761,11503,27027,17482,166010,3474,785,20244,312942,11015,35624,316416,17493,71466,78940,8882,1011,11800,35768,4144,3133,121193,2017
62," ""51167""","Russell, VA",417372,34747,55803,48514,416382,2,-2201,59004,846363,23432,31284,846365,58014,112611,317372,27054,2399,21231,80060,9966,7567,316081,2017
63," ""51169""","Scott, VA",243428,23147,35462,26634,338197,-2408,-3183,36464,688172,24162,31318,685764,131233,97699,249868,21897,2523,20979,48779,7573,5050,173670,2017
64," ""51171""","Shenandoah, VA",821895,58514,99627,82854,1091915,16816,12571,99941,1816848,106425,42329,1833664,369961,345419,396330,43319,5657,118996,141054,20481,14824,561845,2017
65," ""51173""","Smyth, VA",650801,47340,100710,69364,567045,999,-1124,82022,1075823,44407,34994,1076822,-1734,155373,354404,30772,2977,43283,135392,15945,12968,472126,2017
66," ""51179""","Stafford, VA",3345379,201913,467333,357716,5604219,-3022,-3549,380771,7836469,239107,53337,7833447,2639611,1298240,930988,146868,15934,235558,646191,62993,47059,2463630,2017
67," ""51181""","Surry, VA",254691,15463,43745,28228,169642,49,-892,29577,275842,4858,42393,275891,-55472,38926,67323,6508,711,3966,57859,3276,2565,192866,2017
68," ""51183""","Sussex, VA",203157,14056,32284,21972,177215,1338,-311,25042,331699,8966,29293,333037,-900,49331,106491,11369,868,8655,43270,4711,3843,151232,2017
69," ""51185""","Tazewell, VA",813392,61392,115898,87120,744886,3550,2336,104952,1483300,72270,35947,1486850,36446,237638,504326,41362,3526,74606,159458,19444,15918,579328,2017
70," ""51187""","Warren, VA",735421,49905,91177,79628,1177619,-1565,-2500,89719,1752668,76859,44356,1751103,531917,270105,303379,39478,4603,74359,130991,17820,13217,530071,2017
71," ""51193""","Westmoreland, VA",198546,16208,26134,18638,370712,22393,16348,25527,725344,23603,42190,747737,197693,189245,187780,17723,2185,39951,35453,6103,3918,123142,2017
72," ""51197""","Wythe, VA",607859,43302,87231,65274,514079,4030,815,75939,967103,48115,33682,971133,-17841,148492,308562,28832,3238,48930,119868,15559,12321,439061,2017
73," ""51510""","Alexandria (Independent City), VA",10388774,597764,1194080,1156800,9315742,0,0,1176164,13253775,829092,83477,13253775,103132,3105267,832766,158772,26829,829092,1772480,127192,100363,7787202,2017
74," ""51550""","Chesapeake (Independent City), VA",6266367,392287,755128,701518,7899938,6051,370,743046,11707591,338298,48722,11713642,2376617,2008850,1804854,240416,25680,338668,1105887,133277,107597,4821812,2017
75," ""51650""","Hampton (Independent City), VA",4479176,258235,741831,540854,3242673,0,0,528662,5511596,117003,40825,5511596,-707841,1003349,1265574,135007,12279,117003,1012258,77128,64849,3349915,2017
76," ""51700""","Newport News (Independent City), VA",7745425,443578,1121380,904052,4511555,0,0,895604,7219257,251913,40165,7219257,-2338266,1220312,1487390,179738,16818,251913,1573406,124759,107941,5920106,2017
77," ""51710""","Norfolk (Independent City), VA",14507789,758972,2442971,1824954,5346318,0,0,1671449,9496221,200147,38775,9496221,-7490022,2207305,1942598,244908,23164,200147,3355448,215589,192425,10952194,2017
78," ""51740""","Portsmouth (Independent City), VA",4069708,222431,791160,495110,2092282,0,0,469986,3629574,76832,38221,3629574,-1507440,605579,931713,94964,8400,76832,1038715,60618,52218,2954161,2017
79," ""51760""","Richmond (Independent City), VA",13815164,796343,1693533,1424880,7011758,0,0,1508783,11933735,1225326,52428,11933735,-5294623,3006185,1915792,227620,30126,1225326,2405973,197122,166996,10183865,2017
80," ""51770""","Roanoke (Independent City), VA",4516751,278506,546129,524192,2164808,0,0,540602,4020316,265384,40614,4020316,-1811341,814550,1040958,98989,9622,265384,808225,81197,71575,3443142,2017
81," ""51800""","Suffolk (Independent City), VA",2172822,138052,277323,237980,2905176,19256,6791,257042,4498967,164413,50076,4518223,989396,816451,796596,90228,9725,171204,396313,42715,32990,1605305,2017
82," ""51810""","Virginia Beach (Independent City), VA",13828256,804832,1802447,1532304,15857085,-2722,-4627,1570984,25124692,1394983,55775,25121970,3599813,5828296,3436589,450417,58104,1390356,2568599,272430,214326,9869301,2017
83," ""51901""","Albemarle + Charlottesville, VA*",8029618,467248,1033059,804174,5865414,1620,-10881,869335,11041499,906185,70988,11043119,-1294869,4134568,1043137,155563,27594,895304,1435146,132145,104551,5699168,2017
84," ""51903""","Alleghany + Covington, VA*",478344,35480,63569,55636,394905,-506,-948,63298,781109,18418,37524,780603,-20141,128314,257384,20803,1484,17470,91387,9829,8345,369487,2017
85," ""51907""","Augusta, Staunton + Waynesboro, VA*",2999220,201833,380386,310424,3032185,39577,30008,357045,5110857,299789,42246,5150434,390010,1002372,1115877,121915,14285,329797,535598,65109,50824,2133825,2017
86," ""51911""","Campbell + Lynchburg, VA*",4369412,281165,516008,495288,2603951,-145,-2742,528809,4844581,177108,35619,4844436,-1236652,848294,1392191,136007,13241,174366,763652,88979,75738,3431394,2017
87," ""51913""","Carroll + Galax, VA*",608087,47070,83352,66012,627196,3804,1084,80076,1228362,58676,33923,1232166,99185,180183,424787,36322,3741,59760,116358,16911,13170,431969,2017
88," ""51918""","Dinwiddie, Colonial Heights + Petersburg, VA*",1755530,119432,235693,198896,1565858,-892,-2336,218880,2944313,69940,38213,2943421,29208,469333,908230,77026,6562,67604,335141,40908,34346,1352785,2017
89," ""51919""","Fairfax, Fairfax City + Falls Church, VA*",76867292,4655226,7047066,8267188,64783278,9664,7136,8788820,93459161,4957890,78751,93468825,-3295194,22400637,6284910,1186893,191361,4965026,11180660,905772,714411,60721606,2017
90," ""51921""","Frederick + Winchester, VA*",3903280,241270,466382,411476,3736772,-1530,-6727,447008,5611740,405871,48905,5610210,280500,1022149,851289,114716,14078,399144,672120,74537,60459,2832016,2017
91," ""51923""","Greensville + Emporia, VA*",413213,27213,62739,47038,279747,2763,1576,50732,517308,5135,30519,520071,-82734,67354,172970,17041,1250,6711,86258,9623,8373,320244,2017
92," ""51929""","Henry + Martinsville, VA*",1260140,95952,168445,135644,1155579,7502,6575,163774,2349755,104322,36719,2357257,59213,385832,815846,64197,5192,110897,236267,31552,26360,912976,2017
93," ""51931""","James City + Williamsburg, VA*",2593123,172285,320535,274112,3163844,-4259,-5017,309341,5765525,248196,63717,5761266,880062,1734839,862583,90419,11948,243179,457591,57938,45990,1892353,2017
94," ""51933""","Montgomery + Radford, VA*",3231357,190231,523667,339294,2484017,4234,570,359878,4078167,213510,35284,4082401,-387462,912955,685429,115700,10882,214080,693314,64532,53650,2323963,2017
95," ""51939""","Pittsylvania + Danville, VA*",2041758,150236,273386,226948,1885403,14561,5017,263710,3631105,116640,35598,3645666,107355,551030,1209233,102412,9735,121657,386860,51198,41463,1533241,2017
96," ""51941""","Prince George + Hopewell, VA*",2432544,128068,451774,303334,1276832,-1579,-2079,279735,2200936,46698,36304,2199357,-875977,392772,529753,60582,4308,44619,603441,37106,32798,1784484,2017
97," ""51942""","Prince William, Manassas + Manassas Park, VA*",12492824,735712,1463248,1303200,20543447,-2421,-5634,1387312,27711185,1546119,53104,27708764,9437935,4453329,2711988,521780,68448,1540485,2114848,241305,172857,8837491,2017
98," ""51944""","Roanoke + Salem, VA*",3940031,255194,488435,413046,3694620,-472,-1399,461717,5926289,404602,49687,5925817,216306,1137035,1094162,119262,13444,403203,694958,75903,62459,2841870,2017
99," ""51945""","Rockbridge, Buena Vista + Lexington, VA*",771421,54178,101114,84424,709263,664,-1828,96390,1400532,88115,38517,1401196,34232,362827,329106,36379,4767,86287,143326,19424,14657,541808,2017
100," ""51947""","Rockingham + Harrisonburg, VA*",4072057,241448,490325,404818,3262892,172234,148996,443857,4944744,425419,38114,5116978,-365308,956346,897740,134255,16412,574415,692734,85321,68909,2804908,2017
101," ""51949""","Southampton + Franklin, VA*",421467,30537,65184,43544,551429,10007,4996,52309,1022922,28745,39731,1032929,182271,201019,280481,25998,2521,33741,86956,11105,8584,300770,2017
102," ""51951""","Spotsylvania + Fredericksburg, VA*",3782103,239219,433786,396784,5320048,1392,-350,437611,7946295,388885,49179,7947687,1975556,1465187,1162452,161607,19415,388535,632178,84148,64733,2761390,2017
103," ""51953""","Washington + Bristol, VA*",1648905,117147,225691,177062,1381277,3098,-872,205678,2728899,145289,38393,2731997,-61950,587439,763281,71158,8414,144417,314222,39983,31569,1190266,2017
104," ""51955""","Wise + Norton, VA*",801864,60244,126820,89536,597109,-513,-630,105012,1296573,37445,30481,1296060,-99743,171940,527011,42520,2694,36815,171588,18978,16284,593461,2017
105," ""51958""","York + Poquoson, VA*",1522165,99388,201696,167418,2964489,1552,555,183097,4573197,142430,57072,4574749,1625421,1022521,587739,80158,8268,142985,285405,35254,26986,1093775,2017
0," ""51000""",Virginia,334435477,20565737,39168914,35490844,316992086,287856,-16156,38311159,484648971,27175205,56978,484936827,20867768,100361594,67583147,8510920,1111606,27159049,56914336,5298892,4187286,250362092,2018
1," ""51001""","Accomack, VA",1048492,64186,164864,118196,809850,26915,20098,123284,1487331,59456,46445,1514246,-115358,332528,371868,32603,3924,79554,223962,19890,15966,744976,2018
2," ""51007""","Amelia, VA",163803,13105,18791,14736,341554,12648,8127,20473,539668,26149,42496,552316,198224,76348,134414,12997,1803,34276,26159,4599,2796,103368,2018
3," ""51009""","Amherst, VA",470945,38165,66059,49602,649675,-2286,-3225,62966,1165526,36607,36613,1163240,241696,184684,328881,31771,2947,33382,90860,11668,8721,346703,2018
4," ""51011""","Appomattox, VA",169310,15710,24283,16322,349110,-3133,-4148,23871,608706,20554,38149,605573,203671,89762,166701,15874,1857,16406,32444,5401,3544,120460,2018
5," ""51013""","Arlington, VA",24441065,1366746,2815553,2675786,16352972,0,0,2704639,22485727,1213255,95012,22485727,-5383454,5067199,1065556,236662,36632,1213255,4153446,237177,200545,19074364,2018
6," ""51017""","Bath, VA",128767,9007,17256,13294,109434,1246,639,15654,262698,6488,61741,263944,-3679,101694,52816,4275,600,7127,23903,3029,2429,97737,2018
7," ""51019""","Bedford, VA*",1168381,96408,141752,121534,2139277,-8838,-11100,157175,3650546,147220,46031,3641708,1128071,722233,780198,79115,10543,136120,202519,31222,20679,829742,2018
8," ""51021""","Bland, VA",136749,9977,23328,14570,119220,-148,-562,17262,228392,8895,36258,228244,-267,36125,72899,6295,713,8333,30613,2864,2151,97803,2018
9," ""51023""","Botetourt, VA",685761,51446,83449,72158,1013934,-4208,-5822,87525,1672629,60772,49935,1668421,415698,318177,336310,33412,4329,54950,119528,15913,11584,511283,2018
10," ""51025""","Brunswick, VA",190272,16701,29444,20766,249652,-400,-2689,27084,515665,8960,31633,515265,86464,79315,186298,16289,1415,6271,39827,5377,3962,144174,2018
11," ""51027""","Buchanan, VA",455573,36888,65058,47524,342172,-331,-398,60650,742531,30806,34726,742200,-52751,88777,311251,21373,1271,30408,88820,8422,7151,336345,2018
12," ""51029""","Buckingham, VA",205126,16674,32398,20474,276489,586,-790,26911,500962,20887,29430,501548,98274,72292,152767,17042,1600,20097,42635,5174,3574,142394,2018
13," ""51033""","Caroline, VA",371269,28722,57817,38890,811927,-1548,-3873,48167,1296131,33056,42078,1294583,488825,221795,260861,30766,3192,29183,77262,9638,6446,264824,2018
14," ""51036""","Charles City, VA",120536,9516,14593,12532,172147,2648,1156,15782,316046,8907,45639,318694,67393,69294,77253,6983,745,10063,20859,2624,1879,89614,2018
15," ""51037""","Charlotte, VA",163335,14266,24929,16178,202344,-2522,-4698,22355,415275,22229,34668,412753,61364,70582,139827,11906,1662,17531,33018,4847,3185,112786,2018
16," ""51041""","Chesterfield, VA",9865540,630213,1148237,1045190,12586420,887,-231,1152808,18639962,812847,53458,18640849,3873688,3338064,2716365,348704,44725,812616,1670832,193665,148940,7382092,2018
17," ""51043""","Clarke, VA",292603,20995,30679,28312,578868,1251,-3574,35151,932550,53444,64325,933801,321416,227971,126962,14517,2744,49870,44835,7037,4293,197898,2018
18," ""51045""","Craig, VA",43483,4618,6503,4038,105139,-1831,-2460,6637,196605,8197,38154,194774,68293,35836,53799,5105,633,5737,8522,1425,792,29224,2018
19," ""51047""","Culpeper, VA",1111613,74642,132804,109528,1573447,190,-6601,129406,2398624,168966,46323,2398814,591240,414508,410859,51785,6918,162365,187568,23994,17076,761680,2018
20," ""51049""","Cumberland, VA",87992,8061,11623,7358,210778,6172,4872,11740,356277,16633,36748,362449,134526,50791,100880,9863,1046,21505,15302,2476,1430,51185,2018
21," ""51051""","Dickenson, VA",198303,18556,32421,20334,195647,-538,-616,28723,459367,9919,31639,458829,26067,55116,208066,14502,701,9303,42588,4294,3593,146412,2018
22," ""51057""","Essex, VA",187547,15262,24728,20210,230585,-6879,-7913,25367,456580,20445,41299,449701,68405,94712,124404,10889,1372,12532,34833,5306,3934,140182,2018
23," ""51061""","Fauquier, VA",1863056,120716,195175,174472,3245031,918,-13458,207952,4942899,338340,69905,4943817,1589927,1178147,520639,70722,12617,324882,282411,37379,24762,1255763,2018
24," ""51063""","Floyd, VA",179232,16374,23171,17260,337177,-2663,-6873,25004,608723,35357,38387,606060,182949,111932,156951,15788,2673,28484,31801,6425,3752,118947,2018
25," ""51065""","Fluvanna, VA",305441,25781,40271,27824,730694,-2106,-2784,39693,1207044,57198,44742,1204938,464946,250894,223350,26931,3294,54414,54183,7922,4628,196844,2018
26," ""51067""","Franklin, VA",846665,69818,105328,86304,1216939,-2909,-8582,112970,2283588,118481,40512,2280679,483244,494120,569620,56297,6878,109899,148480,23285,16407,588286,2018
27," ""51071""","Giles, VA",290116,23333,40597,30412,372267,-1427,-2027,38539,662358,24903,39273,660931,120690,101938,186726,16829,1692,22876,55803,6690,4998,211437,2018
28," ""51073""","Gloucester, VA",534537,42152,72537,53446,1111096,754,12,68875,1818077,61518,48634,1818831,645434,348301,359434,37398,4033,61530,99260,14392,10359,373747,2018
29," ""51075""","Goochland, VA",2097285,128532,175537,204732,1312574,-5481,-7431,230898,2331176,111835,99291,2325695,-553813,789069,224052,23423,4717,104404,277903,22082,17365,1714978,2018
30," ""51077""","Grayson, VA",140191,15800,25897,14620,232627,-13946,-15920,23110,501848,22564,31234,487902,115546,80324,174951,15621,2011,6644,33207,5265,3254,100340,2018
31," ""51079""","Greene, VA",253470,19645,27058,21408,578865,17,-1110,30349,888279,67621,45048,888296,355744,150417,159014,19719,2461,66511,37762,6458,3997,149197,2018
32," ""51083""","Halifax, VA",672212,51807,97088,71624,613370,-3737,-7850,87619,1218645,51985,35511,1214908,28777,195903,405635,34212,3423,44135,132900,16104,12681,495177,2018
33," ""51085""","Hanover, VA",3560325,227204,370472,365716,4363351,8359,-94,410062,6407660,428164,60063,6416019,1213088,1199140,853528,106821,15919,428070,553330,72748,56829,2578925,2018
34," ""51087""","Henrico, VA",18049377,1077843,1560747,1645088,15097194,1421,111,1900387,21579359,3869615,65413,21580780,-1051796,3952044,2531542,329917,47378,3869726,2383291,254114,206736,11796360,2018
35," ""51091""","Highland, VA",30341,2662,4489,2502,31285,4032,3252,3913,88698,3258,42035,92730,4857,34797,26648,2206,674,6510,5740,1245,571,18091,2018
36," ""51093""","Isle of Wight, VA",735669,53599,83203,74224,1322310,2541,563,90711,2006864,50849,54012,2009405,677352,330658,356437,37203,4339,51412,120315,15767,11428,563942,2018
37," ""51097""","King and Queen, VA",74476,6873,9567,7082,180220,155,-1022,10414,300189,13334,42705,300344,116158,47962,72162,7033,760,12312,13108,1968,1208,49056,2018
38," ""51099""","King George, VA",1406733,77594,255358,162068,953906,-495,-1026,158628,1410396,62867,52859,1409901,-294199,278382,177613,26673,2577,61841,336392,15608,13031,1008500,2018
39," ""51101""","King William, VA",269769,20255,31862,28058,518941,-1840,-2571,34284,788060,27354,46352,786220,283456,126188,141091,16962,1934,24783,45891,6291,4357,199095,2018
40," ""51103""","Lancaster, VA",269146,21872,30624,26502,224390,-568,-1028,35123,620735,37380,58003,620167,-9633,240490,155287,10692,1978,36352,43875,6906,4928,188919,2018
41," ""51105""","Lee, VA",239440,23634,43325,24490,304944,-6014,-7060,35879,692320,27504,28954,686306,101383,89232,292130,23703,2326,20444,55570,7002,4676,163426,2018
42," ""51107""","Loudoun, VA",16377021,961559,1598666,1638896,25580339,5569,-8680,1781007,32179387,1563510,79280,32184956,10984325,4936767,1667850,405964,63490,1554830,2418114,246582,183092,12404077,2018
43," ""51109""","Louisa, VA",766841,53885,99109,77866,960119,-684,-2376,92818,1593208,81447,43445,1592524,286096,298802,333603,36656,4611,79071,138042,15034,10423,549728,2018
44," ""51111""","Lunenburg, VA",140434,12462,22353,14474,188799,-1458,-3778,19699,391809,11215,31847,390351,68064,74164,127388,12257,1229,7437,29590,4102,2873,103407,2018
45," ""51113""","Madison, VA",187351,15249,22345,18152,356674,-4205,-7516,24325,621143,39681,46745,616938,193648,143641,116623,13198,2536,32165,31421,5871,3335,123765,2018
46," ""51115""","Mathews, VA",99284,10010,11126,7962,235392,807,750,13991,479325,28783,54772,480132,150099,135924,108816,8766,1377,29533,15107,3087,1710,54644,2018
47," ""51117""","Mecklenburg, VA",598944,47543,81250,64666,527598,-3443,-9315,79876,1114277,43580,36175,1110834,8530,210363,372873,30707,3072,34265,113583,15494,12422,451096,2018
48," ""51119""","Middlesex, VA",207974,16994,28310,19164,239284,771,-543,26576,538989,32024,50365,539760,57886,163042,137434,10717,1734,31481,37892,5365,3631,138601,2018
49," ""51125""","Nelson, VA",245703,20742,30787,22500,357896,1875,-1405,31992,744178,46068,50287,746053,144185,211697,176460,14836,2600,44663,42037,6841,4241,159003,2018
50," ""51127""","New Kent, VA",294411,23089,34577,27232,1217752,-2700,-2947,36705,1644699,60753,73715,1641999,960046,234261,189986,22275,3393,57806,48193,8138,4745,188412,2018
51," ""51131""","Northampton, VA",246636,16625,28748,21988,333552,46047,32458,27619,577825,26700,52920,623872,114535,129319,161001,11789,1927,59158,39742,6437,4510,147736,2018
52," ""51133""","Northumberland, VA",182378,17404,22628,18110,246515,635,-362,26459,617910,27719,50817,618545,90596,203769,168261,12172,1780,27357,31683,4530,2750,123338,2018
53," ""51135""","Nottoway, VA",326672,22739,62356,37176,236513,9006,6551,41327,509682,5396,33723,518688,-48832,96589,185586,15381,1433,11947,80944,7626,6193,233781,2018
54," ""51137""","Orange, VA",611890,45483,76152,57744,1069756,24178,12431,74355,1774206,85430,49109,1798384,532221,377624,351004,36620,4513,97861,105024,15050,10537,409005,2018
55," ""51139""","Page, VA",338731,27193,43659,34830,502970,24271,21130,44608,881014,38372,37712,905285,208847,158319,243996,24005,2718,59502,61074,8932,6214,218155,2018
56," ""51141""","Patrick, VA",235055,20960,33709,23850,282021,1981,-38,32885,579746,26770,32942,581727,79851,94061,205645,17659,2129,26732,45634,7219,5090,162689,2018
57," ""51145""","Powhatan, VA",479551,35350,57118,45966,1116304,43,-821,58333,1671524,76656,57247,1671567,695086,321538,233725,29199,4256,75835,80101,12198,7942,323615,2018
58," ""51147""","Prince Edward, VA",513574,34572,77122,55694,363893,2301,1204,62419,698709,28493,30640,701010,-87262,122874,214243,22879,2080,29697,104969,12423,10343,378908,2018
59," ""51155""","Pulaski, VA",824126,58899,112997,91954,749274,751,-867,104876,1347992,49722,39556,1348743,30024,211544,387925,34097,2928,48855,158974,17559,14631,616297,2018
60," ""51157""","Rappahannock, VA",119790,9917,10646,8734,241323,-3537,-5601,14284,485979,47136,65434,482442,135817,171601,69518,7373,1914,41535,15013,3606,1692,63242,2018
61," ""51159""","Richmond, VA",183711,12600,30449,18904,177484,2044,-536,22052,330528,10559,37026,332572,15825,71607,83481,8982,1012,10023,39901,4219,3207,133787,2018
62," ""51167""","Russell, VA",416033,36228,56454,48362,423319,-1842,-3958,60409,877782,21250,32660,875940,67695,124666,327955,26820,2406,17292,80635,9888,7482,318106,2018
63," ""51169""","Scott, VA",256118,25075,38187,27172,345248,-3808,-4553,38661,715785,25559,32915,711977,127791,108276,258453,21631,2482,21006,51773,7823,5341,183339,2018
64," ""51171""","Shenandoah, VA",870876,63374,107494,85350,1151944,10712,6628,106049,1917009,111266,44352,1927721,387117,359953,415824,43464,5735,117894,150169,21136,15401,602813,2018
65," ""51173""","Smyth, VA",647728,48906,102635,69622,563253,-3422,-5459,83717,1100502,35267,35959,1097080,-758,168273,365554,30509,2868,29808,137446,15829,12961,480474,2018
66," ""51179""","Stafford, VA",3559051,216862,498100,376156,5884787,-4189,-4698,404940,8216333,250015,54787,8212144,2730676,1323093,1004264,149891,17025,245317,686178,65743,48718,2627556,2018
67," ""51181""","Surry, VA",281127,17272,46830,29508,172942,-1236,-2140,32026,283109,4555,43803,281873,-76159,38383,70548,6435,770,2415,61584,3405,2635,217128,2018
68," ""51183""","Sussex, VA",202270,14480,32733,21662,176694,35,-1549,25311,338895,7829,30278,338930,-265,51961,110275,11194,931,6280,43564,4740,3809,152426,2018
69," ""51185""","Tazewell, VA",844376,65314,119115,89178,765589,1802,627,109903,1520033,69926,36981,1521835,31116,236627,519619,41152,3485,70553,163704,19378,15893,610119,2018
70," ""51187""","Warren, VA",786688,54085,97255,83666,1225031,-1945,-2843,95918,1831382,79769,45672,1829437,534261,284252,320154,40056,4719,76926,139088,18422,13703,570674,2018
71," ""51193""","Westmoreland, VA",205088,17724,26838,18540,386175,20430,14618,26994,752699,26142,43390,773129,208081,190164,196790,17818,2158,40760,36108,6075,3917,128220,2018
72," ""51197""","Wythe, VA",608575,45219,88044,64536,522410,-2700,-5790,77487,998955,49804,34762,996255,-8678,152372,321473,28659,3272,44014,120312,15448,12176,444249,2018
73," ""51510""","Alexandria (Independent City), VA",10595890,610440,1228993,1163500,9835738,0,0,1192190,13899351,846872,87761,13899351,432038,3180275,883338,158377,27685,846872,1810743,126029,98344,7938275,2018
74," ""51550""","Chesapeake (Independent City), VA",6564439,414743,793396,726824,7956060,5599,143,778155,11862332,348981,48890,11867931,2169776,1997658,1914213,242748,26547,349124,1156808,136139,109592,5058507,2018
75," ""51650""","Hampton (Independent City), VA",4465642,261118,745419,535568,3261397,0,0,528902,5552548,118573,41191,5552548,-675343,978438,1312713,134800,12549,118573,1013203,77373,64824,3333866,2018
76," ""51700""","Newport News (Independent City), VA",8110823,465738,1184661,935202,4454791,0,0,933339,7217889,256042,40345,7217889,-2722693,1215433,1547665,178904,17534,256042,1652262,130190,112656,6202519,2018
77," ""51710""","Norfolk (Independent City), VA",13644651,744246,2243362,1667380,5299188,0,0,1577936,9342405,110736,38262,9342405,-6767527,2033600,2009617,244168,23922,110736,3077052,201340,177418,10456863,2018
78," ""51740""","Portsmouth (Independent City), VA",4103703,229783,792930,485554,2112302,0,0,472560,3664519,100455,38623,3664519,-1518841,588971,963246,94879,8656,100455,1035707,60714,52058,2967541,2018
79," ""51760""","Richmond (Independent City), VA",13995024,825621,1754267,1450870,6987338,0,0,1551056,12132940,941696,52839,12132940,-5456630,3165381,1980221,229621,31511,941696,2479702,200153,168642,10573626,2018
80," ""51770""","Roanoke (Independent City), VA",4643564,288001,560128,532804,2270926,0,0,554403,4173414,271169,42171,4173414,-1818235,829084,1073404,98964,9796,271169,826530,81560,71764,3545865,2018
81," ""51800""","Suffolk (Independent City), VA",2231688,144475,288164,244158,2960159,16885,4924,266554,4593687,141217,50591,4610572,995025,808600,841813,91135,10245,146141,410243,44258,34013,1675304,2018
82," ""51810""","Virginia Beach (Independent City), VA",13756874,820580,1780859,1494560,15810698,-3910,-5741,1567860,25214658,1371838,55963,25210748,3621684,5780772,3619278,450488,59745,1366097,2528139,269425,209680,9862638,2018
83," ""51901""","Albemarle + Charlottesville, VA*",8371238,492131,1084544,828344,6101827,-7375,-19402,906303,11664297,917181,74603,11656922,-1363108,4446318,1108777,156253,28194,897779,1498716,134520,106326,5974743,2018
84," ""51903""","Alleghany + Covington, VA*",496378,37511,65000,57372,407335,-702,-1125,66197,805813,19775,38939,805111,-22846,132979,264797,20676,1476,18650,93686,9736,8260,384042,2018
85," ""51907""","Augusta, Staunton + Waynesboro, VA*",3130258,214899,395684,317810,3161889,27143,17929,373804,5304302,318968,43388,5331445,405435,998711,1170845,122879,14320,336897,554589,65922,51602,2238772,2018
86," ""51911""","Campbell + Lynchburg, VA*",4550305,293419,537636,508436,2718347,-2367,-4861,547637,5039675,188529,36870,5037308,-1284321,884231,1434730,136622,13802,183668,791854,90667,76865,3574783,2018
87," ""51913""","Carroll + Galax, VA*",606751,48999,83820,64726,639120,366,-2245,81362,1266808,56359,35078,1267174,113731,188434,439620,36124,3789,54114,116183,16587,12798,436454,2018
88," ""51918""","Dinwiddie, Colonial Heights + Petersburg, VA*",1817614,125850,243804,205498,1586713,-4061,-5454,228599,3000396,63160,39061,2996335,-2302,469916,939706,76710,6725,57706,346553,41545,34820,1413355,2018
89," ""51919""","Fairfax, Fairfax City + Falls Church, VA*",81092029,4902196,7413010,8574376,67982475,7472,5036,9189384,98412510,5487036,82888,98419982,-3920170,23754704,6682803,1187385,197205,5492072,11700198,929138,731933,63899759,2018
90," ""51921""","Frederick + Winchester, VA*",4078193,254969,490464,423356,3899993,-7328,-12327,466647,5852132,425612,50271,5844804,288447,1042468,902343,116267,14426,413285,702142,76227,61801,2962766,2018
91," ""51923""","Greensville + Emporia, VA*",414635,27940,64237,46042,278220,66,-1074,50961,523636,5787,31217,523702,-85454,67462,178020,16776,1224,4713,87258,9527,8303,322664,2018
92," ""51929""","Henry + Martinsville, VA*",1299290,101086,175693,137290,1189564,8697,7809,169731,2406148,99607,37923,2414845,60005,387675,837606,63677,5039,107416,244338,31682,26643,947536,2018
93," ""51931""","James City + Williamsburg, VA*",2653497,180154,332430,282294,3105075,-4625,-5354,321301,5768384,217750,63189,5763759,772879,1738329,920355,91215,12221,212396,473577,58991,46770,1967524,2018
94," ""51933""","Montgomery + Radford, VA*",3382697,201633,547106,347206,2608027,2335,-1195,375236,4304427,223184,36906,4306762,-399434,976615,722120,116694,11188,221989,720709,64692,53504,2439999,2018
95," ""51939""","Pittsylvania + Danville, VA*",2113256,159516,280205,230718,1945848,7101,-2081,274875,3738236,115868,36858,3745337,107467,544509,1254980,101615,9563,113787,395564,50890,41327,1603905,2018
96," ""51941""","Prince George + Hopewell, VA*",2503602,132846,473538,306842,1300521,-3166,-3652,286267,2251369,44515,37053,2248203,-916814,393173,554509,60676,4359,40863,626959,36995,32636,1835780,2018
97," ""51942""","Prince William, Manassas + Manassas Park, VA*",13144142,781254,1538304,1367624,21352524,-2506,-5603,1465066,28775121,1575692,54733,28772615,9673448,4531209,2888882,525694,73036,1570089,2222116,249351,176315,9351937,2018
98," ""51944""","Roanoke + Salem, VA*",4018407,264382,503618,418750,3756078,-628,-1521,473757,6100929,385926,51078,6100301,211428,1198117,1146106,119432,13582,384405,712993,76226,62644,2921009,2018
99," ""51945""","Rockbridge, Buena Vista + Lexington, VA*",780128,56489,104334,84276,716723,-2082,-4482,98627,1430835,85559,39023,1428753,35222,368929,343101,36613,4711,81077,146472,19529,14818,552579,2018
100," ""51947""","Rockingham + Harrisonburg, VA*",4227209,256031,514470,414430,3383481,131493,109138,463246,5199734,461365,39471,5331227,-380482,1001296,946450,135068,16996,570503,721685,86458,69462,2935021,2018
101," ""51949""","Southampton + Franklin, VA*",423209,32038,66436,43650,562571,4455,-366,53863,1048112,26358,40813,1052567,193225,200229,289767,25790,2573,25992,88261,11270,8697,308956,2018
102," ""51951""","Spotsylvania + Fredericksburg, VA*",3973683,254146,455952,413824,5543966,1059,-626,461058,8278124,395465,50610,8279183,2031341,1498449,1236768,163589,19764,394839,662864,85370,65606,2915980,2018
103," ""51953""","Washington + Bristol, VA*",1679991,122272,231926,176950,1417175,-1780,-5604,210747,2806587,153854,39541,2804807,-52069,591232,796400,70935,8425,148250,320401,40056,31631,1211340,2018
104," ""51955""","Wise + Norton, VA*",819242,63390,129228,89872,611913,-702,-817,108326,1334276,42406,31879,1333574,-99003,176876,544785,41833,2687,41589,174164,18838,16151,603489,2018
105," ""51958""","York + Poquoson, VA*",1565472,104669,208629,169760,3005432,1436,479,189549,4664047,141455,58119,4665483,1629509,1038254,621797,80274,8472,141934,293509,35601,27129,1130029,2018
0," ""51000""",Virginia,348959675,21543775,39856588,36755448,328989253,445734,202582,39921499,502155049,28861792,58738,502600783,19951077,102012433,71599097,8556642,1088188,29064374,58234312,5327163,4238975,261660989,2019
1," ""51001""","Accomack, VA",1119986,67460,181644,129706,858335,25567,20126,132313,1580822,57189,49695,1606389,-129338,355088,392966,32325,3801,77315,246497,19926,16125,796174,2019
2," ""51007""","Amelia, VA",170244,13804,19010,15622,353626,12812,9223,21615,559980,24982,43865,572792,204997,78275,140891,13058,1813,34205,26821,4615,2802,109218,2019
3," ""51009""","Amherst, VA",469950,38937,64076,49606,661161,-787,-1537,63740,1190613,35007,37560,1189826,254951,182621,346044,31678,2935,33470,88879,11571,8636,347601,2019
4," ""51011""","Appomattox, VA",173150,16319,24220,16908,356267,-2546,-3399,24773,624064,20654,39084,621518,207890,88961,176290,15902,1757,17255,32674,5308,3551,123221,2019
5," ""51013""","Arlington, VA",26118990,1456928,2994913,2799020,17124579,0,0,2856438,23390078,1412876,98116,23390078,-6137973,5132688,1132811,238392,35307,1412876,4394423,241448,206141,20311691,2019
6," ""51017""","Bath, VA",135703,9449,17580,14588,114862,1488,999,16743,272339,6350,65682,273827,-4098,105319,53646,4169,594,7349,24874,2986,2392,103480,2019
7," ""51019""","Bedford, VA*",1189208,100154,136570,122348,2180296,-5660,-7505,161328,3727551,147709,46857,3721891,1152416,722491,819104,79431,10292,140204,197744,30939,20647,851260,2019
8," ""51021""","Bland, VA",138487,10278,22522,14820,120812,258,-91,17688,232125,8699,36933,232383,13,35741,75830,6292,668,8608,29932,2821,2153,99947,2019
9," ""51023""","Botetourt, VA",731961,54930,86862,78130,1036106,-2306,-3588,93995,1711398,56513,51018,1709092,398140,319912,353074,33500,4283,52925,125927,16612,12329,553109,2019
10," ""51025""","Brunswick, VA",198299,17557,29509,21816,255914,-792,-2600,28465,535511,8072,33056,534719,86080,81478,197327,16176,1360,5472,40417,5364,4004,152410,2019
11," ""51027""","Buchanan, VA",495288,39893,62281,51070,367404,-296,-351,65428,773354,47883,36758,773058,-62456,87464,318190,21031,1106,47532,87816,8084,6978,359940,2019
12," ""51029""","Buckingham, VA",213881,17509,32501,21530,284436,2029,925,28274,519497,20267,30438,521526,98829,74072,163018,17134,1553,21192,43266,5158,3605,149423,2019
13," ""51033""","Caroline, VA",385963,30089,58319,40376,847477,2353,502,50277,1341030,33655,43694,1343383,511791,219950,275956,30745,3090,34157,78507,9712,6622,273299,2019
14," ""51036""","Charles City, VA",122030,9676,14366,12454,181328,4558,3364,15903,328231,9561,47753,332789,75201,70563,80898,6969,758,12925,20593,2587,1829,88512,2019
15," ""51037""","Charlotte, VA",163439,14467,24165,16738,205157,-831,-2572,22836,423473,18742,35669,422642,64554,72017,145468,11849,1615,16170,32534,4766,3151,114735,2019
16," ""51041""","Chesterfield, VA",10066532,650937,1133676,1062236,13109606,2177,1280,1182055,19455611,876338,55063,19457788,4225129,3438154,2910028,353376,45044,877618,1664794,193488,148444,7524120,2019
17," ""51043""","Clarke, VA",303632,22004,30811,28680,606319,2828,-1001,36344,969580,58243,66713,972408,339031,234620,131469,14576,2606,57242,45151,6973,4367,201239,2019
18," ""51045""","Craig, VA",45137,4865,6589,4202,107791,-1451,-1956,6966,200429,7876,38810,198978,69620,35685,55502,5127,642,5920,8690,1452,810,30527,2019
19," ""51047""","Culpeper, VA",1169965,79429,133658,115120,1645902,3341,-2054,136989,2494940,183565,47386,2498281,612926,414541,437838,52722,6562,181511,191218,23843,17281,797236,2019
20," ""51049""","Cumberland, VA",86337,8128,11270,7314,219094,6230,5192,11785,374119,15992,38161,380349,144542,52260,108995,9967,1028,21184,14927,2404,1376,50226,2019
21," ""51051""","Dickenson, VA",209001,19685,31731,21944,205200,-354,-421,30657,479579,9635,33524,479225,26856,54857,219168,14295,703,9214,42703,4475,3772,157084,2019
22," ""51057""","Essex, VA",192916,15735,24431,20744,238063,-3699,-4518,26107,471169,18773,42746,467470,71254,97329,132078,10936,1289,14255,34803,5178,3889,143858,2019
23," ""51061""","Fauquier, VA",1921075,125435,197482,177416,3380659,11507,97,214143,5116670,348058,71927,5128177,1673727,1189989,557529,71297,12218,348155,286190,36841,24623,1286730,2019
24," ""51063""","Floyd, VA",186821,17322,23033,18394,345484,-1201,-4552,26519,621266,33726,39255,620065,185182,107035,167546,15796,2560,29174,32230,6400,3840,125417,2019
25," ""51065""","Fluvanna, VA",321422,27505,40718,29124,752406,-975,-1511,42067,1246102,60048,45666,1245127,473051,252520,240201,27266,3196,58537,55280,7873,4677,207605,2019
26," ""51067""","Franklin, VA",876246,72881,105317,88204,1256632,1186,-3344,116983,2351037,125793,41866,2352223,497369,494303,601288,56185,6595,122449,149419,22879,16284,604378,2019
27," ""51071""","Giles, VA",290150,23572,40730,30300,380791,-746,-1231,38722,675977,23773,40450,675231,129363,96446,197994,16693,1614,22542,55880,6521,4907,211728,2019
28," ""51073""","Gloucester, VA",555980,44535,73089,55916,1144670,1419,798,72493,1882903,62794,50250,1884322,661183,357020,382632,37499,3844,63592,101047,14212,10368,391341,2019
29," ""51075""","Goochland, VA",2395438,146525,180627,228208,1440807,-2301,-3852,260629,2494253,193746,104052,2491952,-694002,808089,243056,23949,4723,189894,294731,23430,18707,1910813,2019
30," ""51077""","Grayson, VA",151162,16977,26083,16058,236965,-12549,-14128,25006,511870,21341,32061,499321,110809,78208,184148,15574,1966,7213,34112,5514,3548,109837,2019
31," ""51079""","Greene, VA",257758,20545,27173,22644,587744,881,-17,31867,915063,61687,46025,915944,361853,153769,174431,19901,2405,61670,38495,6527,4122,157593,2019
32," ""51083""","Halifax, VA",703259,54245,98567,75702,634012,-378,-3664,92096,1264445,49861,37140,1264067,22849,200627,429428,34035,3212,46197,136418,16289,13077,520644,2019
33," ""51085""","Hanover, VA",3751465,241452,374746,384238,4545257,11958,5233,433571,6670373,452086,62141,6682331,1227363,1228771,908303,107535,15179,457319,566865,73913,58734,2727281,2019
34," ""51087""","Henrico, VA",18779549,1135068,1555376,1688924,15750443,1721,685,1979530,22473581,4095433,67592,22475302,-1049576,4032916,2691943,332513,47548,4096118,2399838,256481,208933,12283593,2019
35," ""51091""","Highland, VA",31463,2823,4323,2508,32429,4225,3599,4077,91922,4080,44185,96147,5043,35985,27733,2176,649,7679,5577,1204,555,18207,2019
36," ""51093""","Isle of Wight, VA",710178,52627,79738,75320,1364882,11177,9595,90287,2080619,45769,55930,2091796,744991,345582,381332,37400,4227,55364,117398,15662,11435,537416,2019
37," ""51097""","King and Queen, VA",74308,7029,9270,7110,185904,1361,425,10584,311081,12206,44565,312442,122180,49456,77082,7011,730,12631,12825,1906,1176,48852,2019
38," ""51099""","King George, VA",1509430,83437,277093,170334,1013153,300,-121,168604,1487910,82079,55158,1488210,-327673,279401,195656,26981,2478,81958,362260,15892,13414,1065212,2019
39," ""51101""","King William, VA",278696,21172,31332,29210,541457,-334,-927,35777,825855,28950,48001,825521,298538,129256,154808,17198,1882,28023,45937,6305,4423,204736,2019
40," ""51103""","Lancaster, VA",278641,22778,30680,27430,233776,511,145,36493,643375,39393,60635,643886,-8372,246210,163900,10619,1931,39538,44395,6996,5065,194708,2019
41," ""51105""","Lee, VA",240052,24190,43395,24906,308684,-5621,-6478,36643,704859,24700,29704,699238,105275,88000,302554,23540,2242,18222,55848,6871,4629,165982,2019
42," ""51107""","Loudoun, VA",17256444,1015671,1670915,1749314,26539255,9216,-2137,1890328,33402363,1588533,80535,33411579,11173139,5068759,1803565,414872,63185,1586396,2545572,254097,190912,13124476,2019
43," ""51109""","Louisa, VA",758588,54422,98762,77026,976635,397,-956,92935,1634283,82489,43618,1634680,310982,298721,359324,37477,4443,81533,137275,14882,10439,539780,2019
44," ""51111""","Lunenburg, VA",143073,13028,22044,14924,190458,-2189,-4015,20490,405130,10643,32890,402941,67875,76028,136455,12251,1184,6628,29506,4002,2818,106939,2019
45," ""51113""","Madison, VA",201605,16254,22941,19244,374548,-2098,-4745,25876,644261,42397,48601,642163,198819,143545,124070,13213,2459,37652,32563,5826,3367,131390,2019
46," ""51115""","Mathews, VA",104828,10582,11379,8540,243016,1149,1099,14852,495688,29848,56574,496837,153040,139105,114716,8782,1266,30947,15649,3046,1780,58232,2019
47," ""51117""","Mecklenburg, VA",607339,49047,79487,65884,538513,-4997,-9670,81989,1149157,44601,37241,1144160,13163,215422,390225,30723,3057,34931,112429,15401,12344,459979,2019
48," ""51119""","Middlesex, VA",205691,17311,27687,19118,244102,1150,111,26870,556824,30647,52833,557974,65281,167275,146597,10561,1660,30758,37246,5314,3654,137687,2019
49," ""51125""","Nelson, VA",259997,21973,30464,23274,376267,2776,164,33610,773522,55075,52216,776298,149880,211752,188279,14867,2407,55239,42101,6689,4282,162657,2019
50," ""51127""","New Kent, VA",344016,26625,38821,33246,1264764,-2488,-2687,43248,1714138,62093,74471,1711650,963996,239852,207034,22984,3298,59406,55444,8583,5285,229166,2019
51," ""51131""","Northampton, VA",253591,17284,28481,22834,356693,49477,38728,28701,610611,24414,55940,660088,131803,133746,169649,11800,1867,63142,39898,6370,4503,150551,2019
52," ""51133""","Northumberland, VA",205444,19058,23339,20620,266557,2904,2112,29368,652150,26402,54276,655054,90481,208653,179844,12069,1646,28514,33649,4491,2845,143281,2019
53," ""51135""","Nottoway, VA",343598,24007,62978,38910,248330,8792,6821,43462,530191,7181,35445,538983,-51806,99136,191517,15206,1393,14002,82433,7586,6193,247163,2019
54," ""51137""","Orange, VA",640100,47744,76722,62166,1117928,26441,17111,78827,1842280,80962,50587,1868721,556655,377255,373538,36941,4409,98073,107805,15082,10673,434222,2019
55," ""51139""","Page, VA",338311,28020,43466,35548,512494,21384,18869,45794,913180,35701,39043,934564,219977,162580,259490,23937,2587,54570,61240,8749,6162,222501,2019
56," ""51141""","Patrick, VA",230975,21158,32344,23338,282987,2908,1294,32827,586915,26646,33528,589823,84839,96833,210003,17592,2061,27940,44013,6960,4899,159022,2019
57," ""51145""","Powhatan, VA",521025,38801,58623,49416,1163750,1094,403,63509,1742865,82538,58652,1743959,706234,329051,251158,29734,4107,82941,83331,12434,8327,354753,2019
58," ""51147""","Prince Edward, VA",526704,36020,76279,57612,371319,2526,1647,64826,719290,26405,31621,721816,-90559,125965,224532,22827,2012,28052,105085,12356,10344,393567,2019
59," ""51155""","Pulaski, VA",867140,62265,115290,102898,759564,1159,-139,113714,1360063,41701,40025,1361222,6138,200562,401096,34009,2817,41562,166739,18103,15286,658839,2019
60," ""51157""","Rappahannock, VA",130403,10660,10746,9270,256095,-1899,-3547,15295,504005,52392,68110,502106,140987,173467,72544,7372,1787,48845,15381,3488,1701,66177,2019
61," ""51159""","Richmond, VA",178841,12785,28400,18352,175658,2784,737,21961,333176,10867,37057,335960,18778,71602,88700,9066,967,11604,37576,4170,3203,129661,2019
62," ""51167""","Russell, VA",425120,37448,56140,48654,428911,-569,-2261,61775,896674,20852,33513,896105,65566,123719,343475,26739,2369,18591,80467,9875,7506,326062,2019
63," ""51169""","Scott, VA",272370,26538,38727,29178,348453,-2390,-2995,41127,724165,25367,33450,721775,117210,107119,266203,21578,2378,22372,53316,7969,5591,196682,2019
64," ""51171""","Shenandoah, VA",899251,66129,107919,89538,1203925,11638,8326,110898,2006486,117591,46333,2018124,415572,370600,443599,43557,5494,125917,152688,20822,15328,620646,2019
65," ""51173""","Smyth, VA",663595,50720,100221,72720,566765,-3531,-5153,87080,1114214,33448,36800,1110683,-9750,166201,377717,30182,2798,28295,136581,15838,13040,498719,2019
66," ""51179""","Stafford, VA",3769893,231648,515244,399422,6097128,-3171,-3575,431359,8536718,244572,55494,8533547,2758594,1348936,1087483,153775,17256,240997,714955,67722,50466,2813941,2019
67," ""51181""","Surry, VA",255312,15617,45837,26842,169607,3076,2348,29038,279098,4473,44042,282174,-56667,38754,73813,6407,729,6821,59258,3057,2328,189233,2019
68," ""51183""","Sussex, VA",218286,15318,33370,23060,188918,5581,4314,26848,350462,7518,32099,356043,-2520,52548,114577,11092,928,11832,44900,4783,3855,161554,2019
69," ""51185""","Tazewell, VA",803873,64417,113027,86772,748945,2415,1468,107803,1523559,55294,37462,1525974,52875,235632,541397,40734,3235,56762,156413,18852,15617,590698,2019
70," ""51187""","Warren, VA",809288,56444,96957,86882,1270216,-1469,-2188,99885,1905196,80252,47315,1903727,560813,291941,341570,40235,4538,78064,140398,18286,13748,590826,2019
71," ""51193""","Westmoreland, VA",208451,18313,26153,18944,412151,23645,19017,27785,789315,24821,45092,812960,231485,193234,207575,18029,2015,43838,35625,5906,3891,128988,2019
72," ""51197""","Wythe, VA",612425,46401,86564,66536,533289,-4515,-6986,79669,1024568,46149,35644,1020053,533,150210,336554,28618,3180,39163,119832,15203,12023,453430,2019
73," ""51510""","Alexandria (Independent City), VA",10464576,610359,1205799,1148492,10129189,0,0,1184605,14296000,794110,89884,14296000,849218,3239706,927105,159050,26977,794110,1780045,124505,97528,7890421,2019
74," ""51550""","Chesapeake (Independent City), VA",6844595,435812,802678,753614,8205304,5390,1074,812619,12266703,367816,50008,12272093,2173328,2023864,2042925,245403,26296,368890,1179485,137671,111375,5296220,2019
75," ""51650""","Hampton (Independent City), VA",4610261,271177,769292,549030,3343308,0,0,545692,5713242,104901,42305,5713242,-721261,983059,1386875,135048,12737,104901,1043807,77430,64693,3461553,2019
76," ""51700""","Newport News (Independent City), VA",8511159,490488,1192017,1000516,4567517,0,0,990746,7467480,240590,41547,7467480,-2952896,1256498,1643465,179736,17374,240590,1692275,132486,115112,6578294,2019
77," ""51710""","Norfolk (Independent City), VA",13395684,744926,2167004,1604474,5469687,0,0,1547163,9610101,125227,39453,9610101,-6378834,2044641,2095773,243581,24079,125227,2969241,193566,169487,10301216,2019
78," ""51740""","Portsmouth (Independent City), VA",4430689,246547,849649,514532,2223456,0,0,503813,3857256,153513,40782,3857256,-1703420,621620,1012180,94582,8607,153513,1106915,61320,52713,3170261,2019
79," ""51760""","Richmond (Independent City), VA",14931755,881642,1780724,1531298,7437338,0,0,1647291,12750699,1162921,55191,12750699,-5847126,3254085,2059276,231027,31527,1162921,2546373,204415,172888,11222461,2019
80," ""51770""","Roanoke (Independent City), VA",4663469,291624,554444,539960,2261475,0,0,561604,4215302,208394,42486,4215302,-1840390,835817,1118010,99216,9721,208394,824424,81099,71378,3630651,2019
81," ""51800""","Suffolk (Independent City), VA",2388109,156009,292172,262554,3043349,21957,12518,287286,4779177,131246,52030,4801134,942526,846602,911183,92277,10472,143764,423449,45458,34986,1820896,2019
82," ""51810""","Virginia Beach (Independent City), VA",14300231,867009,1825039,1544850,16247369,-743,-2214,1639434,25925615,1374400,57513,25924872,3586572,5835099,3842404,450766,58390,1372186,2597464,269803,211413,10330581,2019
83," ""51901""","Albemarle + Charlottesville, VA*",8516598,503727,1099244,847618,6196611,-1492,-11201,927536,11925057,861952,75885,11923565,-1392451,4541613,1185341,157126,27056,850751,1523053,136653,109597,6142794,2019
84," ""51903""","Alleghany + Covington, VA*",501496,38180,65423,58456,412284,-444,-783,67408,821559,18452,40015,821115,-21804,131915,276916,20520,1424,17669,94651,9760,8336,389176,2019
85," ""51907""","Augusta, Staunton + Waynesboro, VA*",3215529,223273,396442,331416,3267718,25425,17967,388981,5519631,319772,44917,5545056,441170,1037180,1240158,123452,13897,337739,562150,66458,52561,2315640,2019
86," ""51911""","Campbell + Lynchburg, VA*",4670118,302204,531780,522744,2788659,57,-1971,563576,5169824,209356,37702,5169881,-1317883,891779,1489443,137124,13302,207385,793152,90810,77508,3669581,2019
87," ""51913""","Carroll + Galax, VA*",601741,49830,80197,64844,648234,648,-1446,82252,1291416,54536,35549,1292064,128745,182962,460868,36346,3657,53090,112619,16386,12729,436032,2019
88," ""51918""","Dinwiddie, Colonial Heights + Petersburg, VA*",1856197,129819,238657,210662,1650933,-2502,-3632,235150,3112517,65660,40661,3110015,29886,477328,981754,76486,6963,62028,343988,41676,34713,1450181,2019
89," ""51919""","Fairfax, Fairfax City + Falls Church, VA*",86066941,5166567,7675958,8914642,71279737,14822,12854,9623888,102379618,6387410,86031,102394440,-5163316,24048682,7066021,1190204,189384,6400264,12133279,935200,745816,67533398,2019
90," ""51921""","Frederick + Winchester, VA*",4299769,271097,496876,447390,4056851,-5606,-9640,494792,6105645,447038,51907,6100039,251874,1075441,967747,117519,14139,437398,720571,76886,62747,3141800,2019
91," ""51923""","Greensville + Emporia, VA*",421851,28557,62323,46496,286421,4724,3809,51805,537703,5801,32485,542427,-83625,68696,187310,16698,1195,9610,85571,9252,8057,326670,2019
92," ""51929""","Henry + Martinsville, VA*",1310069,103418,172207,139780,1195201,9901,9192,173308,2465140,98049,39183,2475041,58440,398799,881041,63167,4709,107241,242097,31483,26774,960731,2019
93," ""51931""","James City + Williamsburg, VA*",2736840,188229,328421,290122,3209866,-3417,-4007,333290,5990310,235025,65176,5986893,806316,1782748,994279,91857,11830,231018,473482,58761,46931,2032340,2019
94," ""51933""","Montgomery + Radford, VA*",3439979,207282,544742,356718,2653188,4308,1456,385641,4368019,205088,37377,4372327,-401150,959177,759962,116979,10914,206544,723101,64863,53949,2510334,2019
95," ""51939""","Pittsylvania + Danville, VA*",2110008,161860,271942,229704,1955473,10096,2706,276712,3820896,121119,38117,3830992,122177,559895,1315624,100506,9350,123825,386794,49555,40205,1599389,2019
96," ""51941""","Prince George + Hopewell, VA*",2565215,137891,476390,307248,1397517,-1985,-2383,291515,2373513,93882,38845,2371528,-876183,395557,578454,61051,4531,91499,630014,36808,32277,1843702,2019
97," ""51942""","Prince William, Manassas + Manassas Park, VA*",13821530,825234,1623688,1448030,22065067,-238,-2752,1549249,29818310,1522363,56181,29818072,9792786,4640361,3112644,530752,73304,1519611,2347703,254845,181541,9954216,2019
98," ""51944""","Roanoke + Salem, VA*",4087174,272427,494005,428860,3819250,31,-698,486857,6232127,362532,52094,6232158,218933,1206467,1206441,119632,13039,361834,708435,76160,63121,3016905,2019
99," ""51945""","Rockbridge, Buena Vista + Lexington, VA*",814783,59193,107302,88344,747773,802,-1136,103365,1496780,81745,41029,1497582,36355,382203,367606,36501,4463,80609,151474,19605,15142,582700,2019
100," ""51947""","Rockingham + Harrisonburg, VA*",4385580,269136,521585,438542,3465586,119739,101771,488407,5356952,445553,40413,5476691,-431587,1004398,1006707,135519,16410,547324,740856,87230,70820,3097400,2019
101," ""51949""","Southampton + Franklin, VA*",445966,33079,65737,44344,591903,22538,18682,55251,1092048,24602,43430,1114586,201188,212952,309731,25664,2500,43284,87909,11172,8672,314773,2019
102," ""51951""","Spotsylvania + Fredericksburg, VA*",4121624,266832,453936,426326,5773418,2942,1573,479995,8596224,427286,51896,8599166,2131789,1496004,1329744,165701,19484,428859,667099,84803,65319,3025666,2019
103," ""51953""","Washington + Bristol, VA*",1670965,124175,221479,176628,1428899,-703,-3802,212489,2847824,156792,40164,2847121,-29577,588026,830196,70888,8106,152990,309793,39157,31051,1208182,2019
104," ""51955""","Wise + Norton, VA*",839644,65536,129250,91456,631798,-239,-338,111264,1368936,43724,33052,1368697,-96582,175647,561252,41410,2681,43386,174978,19026,16345,621280,2019
105," ""51958""","York + Poquoson, VA*",1650761,110577,221383,178758,3095743,1467,698,199956,4838224,144961,59892,4839691,1644938,1067740,676208,80807,8133,145659,310762,35493,27360,1194340,2019
