,GeoName,Earnings by place of work,Employee and self-employed contributions for government social insurance,Employer contributions for employee pension and insurance funds 8,Employer contributions for government social insurance,Equals: Net earnings by place of residence,Farm income 2,Farm proprietors' income,Less: Contributions for government social insurance 5,Nonfarm personal income 1,Nonfarm proprietors' income,Per capita personal income (dollars) 4,Personal income (thousands of dollars),Plus: Adjustment for residence 6,"Plus: Dividends, interest, and rent 7",Plus: Personal current transfer receipts,Population (persons) 3,Proprietors employment,Proprietors' income 9,Supplements to wages and salaries,Total employment,Wage and salary employment,Wages and salaries,year
0,"Accomack, VA",53367,1495,3775,2364,52841,3330,952,2677,69545,9546,2487,72875,2151,11604,8430,29308,2569,10498,4957,11427,8858,37912,1969
1,"Albemarle + Charlottesville, VA*",241622,7886,14148,14278,197246,3288,1718,15025,270215,21727,3617,273503,-29351,59822,16435,75621,4223,23445,21287,41492,37269,196890,1969
2,"Alexandria (Independent City), VA",419942,12458,33618,24612,515498,0,0,24764,662412,22627,6016,662412,120320,126243,20671,110100,7990,22627,45924,60630,52640,351391,1969
3,"Alleghany + Covington, VA*",78477,3033,4615,6038,62301,321,252,6052,79122,5652,2806,79443,-10124,8293,8849,28308,1053,5904,7634,11784,10731,64939,1969
4,"Amelia, VA",10021,298,394,428,14362,1848,1305,512,16275,1926,2353,18123,4853,2046,1715,7702,1008,3231,608,2938,1930,6182,1969
5,"Amherst, VA",32502,1149,1699,1792,51658,1018,668,2045,62889,4681,2457,63907,21201,6802,5447,26007,1237,5349,2595,7043,5806,24558,1969
6,"Appomattox, VA",15823,538,622,892,21894,1361,1130,984,26071,3057,2798,27432,7055,2856,2682,9803,1016,4187,1068,3692,2676,10568,1969
7,"Arlington, VA",1449325,28246,205237,69306,913117,0,0,62899,1195040,44472,6830,1195040,-473309,248372,33551,174981,7678,44472,239890,142138,134460,1164963,1969
8,"Augusta, Staunton + Waynesboro, VA*",256009,8469,13307,15340,231039,8519,6765,16139,274865,24318,3329,283384,-8831,34397,17948,85124,5667,31083,20977,41707,36040,203949,1969
9,"Bath, VA",10431,362,465,626,9824,663,422,675,12650,990,2560,13313,68,1850,1639,5201,478,1412,778,2614,2136,8241,1969
10,"Bedford, VA*",52469,1766,2886,3044,77692,3359,2392,3288,95338,7197,3017,98697,28511,12726,8279,32709,2436,9589,4408,11128,8692,38472,1969
11,"Bland, VA",6154,214,282,300,9065,638,441,364,10809,1107,2081,11447,3275,1038,1344,5502,653,1548,432,1831,1178,4174,1969
12,"Botetourt, VA",23724,912,1114,1586,43609,1237,488,1705,52753,4867,2966,53990,21590,5415,4966,18205,1273,5355,1907,4795,3522,16462,1969
13,"Brunswick, VA",27380,805,1090,1358,32058,4671,3899,1484,34691,4071,2399,39362,6162,3918,3386,16405,1979,7970,1769,6600,4621,17641,1969
14,"Buchanan, VA",72538,2343,7321,4354,57363,144,118,4520,69218,11659,2127,69362,-10655,4350,7649,32609,1277,11777,9498,10119,8842,51263,1969
15,"Buckingham, VA",13328,439,604,724,16700,1505,1228,801,20044,2423,2013,21549,4173,2484,2365,10703,902,3651,966,2945,2043,8711,1969
16,"Campbell + Lynchburg, VA*",349220,11884,19187,21912,264871,2906,2113,22840,332973,30189,3458,335879,-61509,45975,25033,97127,5065,32302,30143,56132,51067,286775,1969
17,"Caroline, VA",19020,554,1502,922,30251,381,-15,1015,37632,3289,2734,38013,12246,4890,2872,13904,923,3274,1963,3739,2816,13783,1969
18,"Carroll + Galax, VA*",57886,2026,2553,3616,50102,1409,954,3834,64290,7717,2226,65699,-3950,7900,7697,29508,2530,8671,4361,13116,10586,44854,1969
19,"Charles City, VA",2980,97,140,120,10935,597,344,157,13624,654,2331,14221,8112,2212,1074,6102,167,998,200,745,578,1782,1969
20,"Charlotte, VA",20355,611,769,1056,24024,3602,2967,1139,26807,3456,2432,30409,4808,3563,2822,12504,2117,6423,1297,5297,3180,12635,1969
21,"Chesapeake (Independent City), VA",121639,4216,6997,7460,274767,3198,1702,7946,321500,14370,3705,324698,161074,33895,16036,87641,3219,16072,10727,21800,18581,94840,1969
22,"Chesterfield, VA",229340,7024,16461,12546,273049,1103,562,13297,323949,22044,4373,325052,57006,37531,14472,74325,1341,22606,22734,28443,27102,184000,1969
23,"Clarke, VA",19368,547,829,884,21295,2666,1306,989,26419,3728,3590,29085,2916,5758,2032,8102,974,5034,1271,4312,3338,13063,1969
24,"Craig, VA",3103,115,185,156,6632,159,112,193,8814,581,2563,8973,3722,1345,996,3501,320,693,263,896,576,2147,1969
25,"Culpeper, VA",36898,1214,1957,1994,40668,1813,455,2211,52887,6055,3021,54700,5981,9603,4429,18105,1649,6510,2954,8161,6512,27434,1969
26,"Cumberland, VA",6256,180,187,188,11446,1320,916,274,12749,2315,2268,14069,5464,1301,1322,6202,662,3231,281,1566,904,2744,1969
27,"Dickenson, VA",30584,984,3399,1742,26822,151,89,1855,34460,5068,2110,34611,-1907,2312,5477,16405,617,5157,4270,4361,3744,21157,1969
28,"Dinwiddie, Colonial Heights + Petersburg, VA*",166547,5537,10719,10060,176814,3329,2725,10567,224207,18036,2798,227536,20834,32440,18282,81323,3881,20761,15749,31131,27250,130037,1969
29,"Essex, VA",15132,510,842,870,12904,222,-41,945,17729,2643,2528,17951,-1283,3263,1784,7102,751,2602,1277,3503,2752,11253,1969
30,"Fairfax, Fairfax City + Falls Church, VA*",1187757,30688,109048,60942,2176988,1383,806,61159,2667741,96484,5673,2669124,1050390,434261,57875,470534,15121,97290,139519,146481,131360,950948,1969
31,"Fauquier, VA",59252,1585,4774,2698,67678,5282,2917,2934,94992,9991,3769,100274,11360,27109,5487,26607,2370,12908,6123,12064,9694,40221,1969
32,"Floyd, VA",10440,371,424,482,21240,819,604,612,25964,3111,2705,26783,11412,2861,2682,9903,1341,3715,665,2909,1568,6060,1969
33,"Fluvanna, VA",10473,352,471,464,15109,773,503,584,18983,2601,2599,19756,5220,2757,1890,7602,501,3104,703,2277,1776,6666,1969
34,"Franklin, VA",46257,1482,1911,2572,63951,4598,3598,2768,73559,7064,2771,78157,20462,7956,6250,28208,2841,10662,3197,9913,7072,32398,1969
35,"Frederick + Winchester, VA*",120155,4143,5883,7484,110810,1772,-155,7885,137980,14440,3227,139752,-1460,18255,10687,43312,2952,14285,9625,22692,19740,96245,1969
36,"Giles, VA",41561,1445,2761,2598,38623,317,164,2744,47460,3847,2826,47777,-194,4391,4763,16905,846,4011,4060,6830,5984,33490,1969
37,"Gloucester, VA",16132,575,767,702,38603,140,-8,926,51614,5137,3696,51754,23397,9688,3463,14004,1002,5129,1118,3487,2485,9885,1969
38,"Goochland, VA",12128,398,494,518,23131,742,378,657,28547,3544,2899,29289,11660,4164,1994,10103,666,3922,753,2511,1845,7453,1969
39,"Grayson, VA",18876,658,837,1160,24701,1509,1070,1238,30257,2587,2036,31766,7063,2960,4105,15604,1451,3657,1417,5105,3654,13802,1969
40,"Greene, VA",4521,155,171,148,9479,211,123,229,11986,1836,2345,12197,5187,1571,1147,5201,335,1959,245,918,583,2317,1969
41,"Greensville + Emporia, VA*",31540,1056,1563,1976,28463,972,545,2044,35813,3828,2452,36785,-1033,4206,4116,15004,1330,4373,2551,6963,5633,24616,1969
42,"Halifax, VA",74823,2243,3032,4158,78798,11472,9875,4322,86485,8472,2625,97957,8297,10632,8527,37311,5636,18347,5111,16820,11184,51365,1969
43,"Hampton (Independent City), VA",396018,8303,55383,19506,370196,0,0,18056,461047,13653,3878,461047,-7766,69898,20953,118900,2919,13653,65136,51479,48560,317229,1969
44,"Hanover, VA",51741,1769,2078,2644,116264,2563,1793,3091,137763,12125,3812,140326,67614,17190,6872,36810,2288,13918,3400,9920,7632,34423,1969
45,"Henrico, VA",300366,10577,15358,18916,569378,1211,421,20035,647054,34633,4253,648265,289047,56062,22825,152415,1473,35054,24816,42184,40711,240496,1969
46,"Henry + Martinsville, VA*",233828,7986,12136,15762,186976,981,692,15867,226266,15399,3245,227247,-30985,27224,13047,70020,3043,16091,20017,39306,36263,197720,1969
47,"Highland, VA",3901,115,142,160,4046,911,802,195,4898,793,2233,5809,340,951,812,2601,674,1595,222,1215,541,2084,1969
48,"Isle of Wight, VA",53230,1727,3012,3386,47466,2791,2117,3420,56074,3577,3216,58865,-2344,7722,3677,18305,1546,5694,4705,9132,7586,42831,1969
49,"James City + Williamsburg, VA*",69710,2297,3798,4066,73640,-35,-174,4330,92745,6064,3511,92710,8260,15304,3766,26407,1023,5890,5831,13111,12088,57989,1969
50,"King George, VA",47035,377,7027,1018,27274,17,-82,886,36006,1652,4502,36023,-18875,7426,1323,8002,404,1570,7536,4672,4268,37929,1969
51,"King William, VA",18717,640,965,1160,18273,344,-132,1220,23546,2150,3184,23890,776,3932,1685,7502,602,2018,1545,3274,2672,15154,1969
52,"King and Queen, VA",5995,200,244,260,11124,447,240,330,13697,1558,2525,14144,5459,1685,1335,5602,534,1798,374,1742,1208,3823,1969
53,"Lancaster, VA",17008,610,815,910,15757,66,-103,1065,25392,3736,2766,25458,-186,6539,3162,9203,756,3633,1270,3923,3167,12105,1969
54,"Lee, VA",20266,675,1034,884,22996,3275,2781,1117,31370,3532,1665,34645,3847,3713,7936,20806,2328,6313,1476,5626,3298,12477,1969
55,"Loudoun, VA",91666,2345,5932,3924,123293,5132,3074,4307,169000,11898,4809,174132,35934,44232,6607,36210,3064,14972,7894,15344,12280,68800,1969
56,"Louisa, VA",17941,617,771,970,27166,845,485,1102,34425,4045,2519,35270,10327,4496,3608,14004,1234,4530,1256,4223,2989,12155,1969
57,"Lunenburg, VA",20831,613,895,1048,22626,3933,3410,1137,24779,2915,2433,28712,2932,3136,2950,11803,1608,6325,1419,4963,3355,13087,1969
58,"Madison, VA",11991,381,427,468,17778,1034,336,615,22118,4521,2661,23152,6402,3181,2193,8702,1037,4857,661,2980,1943,6473,1969
59,"Mathews, VA",8113,315,307,314,14349,280,94,472,21215,3319,2985,21495,6708,4328,2818,7202,619,3413,464,2001,1382,4236,1969
60,"Mecklenburg, VA",68325,2062,3097,3988,59431,8603,7278,4056,66373,6633,2524,74976,-4838,9165,6380,29708,4103,13911,5091,15682,11579,49323,1969
61,"Middlesex, VA",8171,296,354,332,10060,257,-92,462,15155,2998,2446,15412,2351,2941,2411,6302,715,2906,520,2135,1420,4745,1969
62,"Montgomery + Radford, VA*",192684,6289,13728,11794,133957,861,136,12186,163586,9512,2849,164447,-46541,19743,10747,57716,2491,9648,19625,31220,28729,163411,1969
63,"Nelson, VA",15536,578,864,900,20882,598,30,1028,27027,2823,2341,27625,6374,3535,3208,11803,846,2853,1314,3374,2528,11369,1969
64,"New Kent, VA",5838,210,238,290,13136,87,-8,355,16477,1672,3125,16564,7653,2212,1216,5301,426,1664,383,1515,1089,3791,1969
65,"Newport News (Independent City), VA",566815,16403,59576,36802,456253,0,0,34804,555383,21346,3964,555383,-75758,73927,25203,140100,3727,21346,77977,77556,73829,467492,1969
66,"Norfolk (Independent City), VA",1499480,38092,208073,90896,969147,0,0,83540,1249556,53508,4374,1249556,-446793,217092,63317,285700,7998,53508,253521,220363,212365,1192451,1969
67,"Northampton, VA",26157,823,1279,1404,24194,3652,1817,1525,30386,4389,2331,34038,-438,5404,4440,14604,1145,6206,1981,6629,5484,17970,1969
68,"Northumberland, VA",12081,423,584,572,15420,583,372,709,22683,3074,2474,23266,4048,4657,3189,9403,857,3446,870,3014,2157,7765,1969
69,"Nottoway, VA",36355,1209,2376,2478,31218,1456,1044,2448,39422,3138,2838,40878,-2689,5684,3976,14404,1333,4182,3615,7326,5993,28558,1969
70,"Orange, VA",31515,1048,1238,1738,31692,2108,1302,1917,46657,5714,3533,48765,2094,13340,3733,13804,1279,7016,2107,6763,5484,22392,1969
71,"Page, VA",29699,1089,1357,1948,34119,918,670,2063,43529,4323,2677,44447,6483,5586,4742,16605,1259,4993,2331,6390,5131,22375,1969
72,"Patrick, VA",22966,761,977,1322,33441,2027,1604,1422,38226,3937,2613,40253,11897,3218,3594,15404,1641,5541,1638,5269,3628,15787,1969
73,"Pittsylvania + Danville, VA*",244355,8041,11338,15624,233871,16618,14458,15853,275806,23119,2763,292424,5369,33427,25126,105830,9598,37577,19150,48599,39001,187628,1969
74,"Portsmouth (Independent City), VA",352865,6999,42495,15156,320410,0,0,14577,399325,13421,3187,399325,-17878,54238,24677,125300,3092,13421,50073,49814,46722,289371,1969
75,"Powhatan, VA",9134,301,407,366,15637,688,263,484,19130,2649,2573,19818,6987,2701,1480,7702,501,2912,590,2023,1522,5632,1969
76,"Prince Edward, VA",33472,1083,1660,1910,26988,2170,1609,2038,33897,3034,2504,36067,-4446,5642,3437,14404,1317,4643,2615,7508,6191,26214,1969
77,"Prince George + Hopewell, VA*",210693,4904,31113,11930,129812,779,436,10869,165159,6497,3393,165938,-70012,28983,7143,48909,1285,6933,37078,29845,28560,166682,1969
78,"Prince William, Manassas + Manassas Park, VA*",221277,5777,28459,12496,357721,1083,711,12025,463075,24123,4390,464158,148469,94348,12089,105730,3304,24834,34707,31912,28608,161736,1969
79,"Pulaski, VA",58933,2062,2769,3844,75589,829,333,3984,89887,6929,3064,90716,20640,8287,6840,29608,1351,7262,4691,11647,10296,46980,1969
80,"Rappahannock, VA",7607,226,234,310,11360,1183,650,381,14188,2380,2955,15371,4134,2704,1307,5201,566,3030,389,1939,1373,4188,1969
81,"Richmond (Independent City), VA",1286147,42581,75685,82010,756524,0,0,83586,1022952,72620,4076,1022952,-446037,189642,76786,251000,17483,72620,116690,197744,180261,1096837,1969
82,"Richmond, VA",14576,489,773,772,12648,528,389,875,16355,2037,2597,16883,-1053,2315,1920,6502,731,2426,1159,3372,2641,10991,1969
83,"Roanoke (Independent City), VA",376395,14202,18421,27936,257276,0,0,28170,349752,28694,3761,349752,-90949,55599,36877,93000,6933,28694,32389,62934,56001,315312,1969
84,"Roanoke + Salem, VA*",235710,7895,13311,14760,274761,647,144,15275,323818,26052,3714,324465,54326,32420,17284,87352,2284,26196,20691,33702,31418,188823,1969
85,"Rockbridge, Buena Vista + Lexington, VA*",67012,2283,3576,4350,64132,1504,963,4458,81536,5301,2704,83040,1578,11713,7195,30709,1933,6264,5751,12925,10992,54997,1969
86,"Rockingham + Harrisonburg, VA*",155609,4886,7764,8708,155533,12784,10423,9240,177997,20424,3076,190781,9164,22723,12525,62017,6288,30847,12118,30328,24040,112644,1969
87,"Russell, VA",37712,1270,2958,2340,40133,2803,2132,2440,48963,4583,2087,51766,4861,4622,7011,24807,2194,6715,4128,7369,5175,26869,1969
88,"Scott, VA",19078,621,816,724,45487,3784,3486,983,52455,4051,2285,56239,27392,4614,6138,24607,2274,7537,1178,4785,2511,10363,1969
89,"Shenandoah, VA",48388,1603,2128,2812,51455,3551,2257,3009,62877,7216,2900,66428,6076,8714,6259,22906,2499,9473,3534,10768,8269,35381,1969
90,"Smyth, VA",71178,2408,3784,4506,64285,2067,921,4661,78002,7056,2541,80069,-2232,7788,7996,31509,2239,7977,6037,14605,12366,57164,1969
91,"Southampton + Franklin, VA*",35888,1133,1574,1802,48260,4803,3195,2034,58922,5039,2479,63725,14406,9873,5592,25707,2490,8234,2475,9732,7242,25179,1969
92,"Spotsylvania + Fredericksburg, VA*",85190,2880,4295,5056,87170,1253,900,5408,115401,11024,3786,116654,7388,22264,7220,30809,2270,11924,6823,15828,13558,66443,1969
93,"Stafford, VA",21282,722,912,902,69037,420,305,1173,91901,6839,3830,92321,48928,19712,3572,24107,587,7144,1363,3385,2798,12775,1969
94,"Suffolk (Independent City), VA",86142,2904,4574,5222,120999,3428,2383,5515,146417,7283,3314,149845,40372,17639,11207,45213,2520,9666,7185,18298,15778,69291,1969
95,"Surry, VA",22676,750,675,1520,13348,1141,676,1510,15065,933,2746,16206,-7818,1613,1245,5902,684,1609,1435,3106,2422,19632,1969
96,"Sussex, VA",15916,511,703,850,21400,1781,1141,936,26567,2966,2443,28348,6420,4490,2458,11603,1318,4107,1128,4242,2924,10681,1969
97,"Tazewell, VA",67094,2353,4413,4060,79828,686,68,4383,102486,8966,2553,103172,17117,10651,12693,40411,2113,9034,6443,12682,10569,51617,1969
98,Virginia,13888586,399804,1240260,798782,14079996,210334,145097,799195,17637318,1079379,3868,17847652,990605,2788894,978762,4614000,251037,1224476,1639651,2147852,1896815,11024459,1969
99,"Virginia Beach (Independent City), VA",377981,9991,55547,23060,609479,3507,2111,21521,791792,28303,4719,795299,253019,164627,21193,168547,6845,30414,67077,65704,58859,280490,1969
100,"Warren, VA",40909,1395,2422,2466,42244,805,367,2628,52970,4645,3514,53775,3963,7277,4254,15304,1045,5012,3655,7011,5966,32242,1969
101,"Washington + Bristol, VA*",117956,3875,6005,6734,116359,6822,5579,7242,141671,13719,2656,148493,5645,17332,14802,55916,4883,19298,9372,23913,19030,89286,1969
102,"Westmoreland, VA",15341,498,685,694,21539,1607,960,845,28874,3609,2518,30481,7043,5581,3361,12103,960,4569,1032,3781,2821,9740,1969
103,"Wise + Norton, VA*",76984,2711,5920,4686,74968,353,216,5054,96538,12667,2374,96891,3038,8112,13811,40811,1551,12883,8263,12380,10829,55838,1969
104,"Wythe, VA",40134,1340,1907,2318,44380,2360,1495,2499,54980,5341,2571,57340,6745,6820,6140,22306,1995,6836,3066,9136,7141,30232,1969
105,"York + Poquoson, VA*",75618,1217,9832,2528,107390,657,232,2481,135347,5815,4200,136004,34253,23885,4729,32383,885,6047,11096,9449,8564,58475,1969
0,"Accomack, VA",56061,1651,4087,2568,56420,3002,659,2935,76370,10086,2750,79372,3294,13086,9866,28863,2603,10745,5371,11462,8859,39945,1970
1,"Albemarle + Charlottesville, VA*",268950,8704,16547,15650,209748,3751,2162,16529,291213,22125,3849,294964,-42673,65599,19617,76642,4503,24287,24372,42759,38256,220291,1970
2,"Alexandria (Independent City), VA",461219,13629,37860,27544,540767,0,0,27401,719394,23189,6510,719394,106949,154130,24497,110508,8605,23189,51632,62586,53981,386398,1970
3,"Alleghany + Covington, VA*",83077,3178,4966,6418,66004,267,210,6387,84916,5989,3029,85183,-10686,8962,10217,28118,1052,6199,8175,11867,10815,68703,1970
4,"Amelia, VA",10827,322,437,470,15630,2218,1699,557,17939,1866,2658,20157,5360,2423,2104,7583,977,3565,672,2913,1936,6590,1970
5,"Amherst, VA",39214,1367,2187,2198,56111,1302,983,2466,68626,4691,2675,69928,19363,7608,6209,26141,1189,5674,3286,7551,6362,30254,1970
6,"Appomattox, VA",17041,573,672,946,23538,1710,1476,1046,28132,3223,3047,29842,7543,3228,3076,9793,1022,4699,1145,3704,2682,11197,1970
7,"Arlington, VA",1669876,30998,245706,82552,980656,0,0,72274,1327239,46073,7635,1327239,-616946,306798,39785,173825,8331,46073,286982,151200,142869,1336821,1970
8,"Augusta, Staunton + Waynesboro, VA*",265090,8856,14326,15810,239795,6572,4845,16761,292209,23876,3488,298781,-8534,38419,20567,85665,5556,28721,22231,41054,35498,214138,1970
9,"Bath, VA",10883,388,488,672,10628,535,306,724,14148,1084,2820,14683,469,2128,1927,5207,425,1390,824,2455,2030,8669,1970
10,"Bedford, VA*",53385,1841,2977,3124,79019,3308,2403,3403,99276,7024,3121,102584,29037,13973,9592,32872,2473,9427,4539,11001,8528,39419,1970
11,"Bland, VA",7093,250,328,370,9289,685,494,435,11464,1065,2229,12149,2631,1219,1641,5450,588,1559,513,1826,1238,5021,1970
12,"Botetourt, VA",25225,969,1209,1718,44811,1212,481,1828,55717,4941,3126,56929,21414,6298,5820,18209,1323,5422,2068,4865,3542,17735,1970
13,"Brunswick, VA",28485,853,1203,1428,33492,4700,3936,1567,37195,4202,2593,41895,6574,4449,3954,16155,1825,8138,1917,6415,4590,18430,1970
14,"Buchanan, VA",88043,2825,8752,5210,69001,255,232,5430,84284,14279,2621,84539,-13612,5883,9655,32251,1226,14511,11357,10581,9355,62175,1970
15,"Buckingham, VA",13376,454,634,756,17075,1324,1073,832,21462,2278,2145,22786,4531,2940,2771,10622,880,3351,1012,2879,1999,9013,1970
16,"Campbell + Lynchburg, VA*",371885,12650,21453,23102,265411,2911,2169,24201,342244,29793,3534,345155,-82273,50435,29309,97663,5100,31962,33004,57185,52085,306919,1970
17,"Caroline, VA",20030,596,1611,986,32238,576,190,1089,40858,3464,2964,41434,13297,5768,3428,13980,897,3654,2104,3569,2672,14272,1970
18,"Carroll + Galax, VA*",60464,2118,2736,3674,53248,2083,1631,3955,69304,8174,2438,71387,-3261,8938,9201,29275,2516,9805,4573,12993,10477,46086,1970
19,"Charles City, VA",3293,113,158,152,12019,539,285,189,15145,608,2539,15684,8915,2332,1333,6178,167,893,234,767,600,2166,1970
20,"Charlotte, VA",20768,623,800,1040,24798,4028,3412,1143,27968,3497,2577,31996,5173,3956,3242,12415,2035,6909,1320,5156,3121,12539,1970
21,"Chesapeake (Independent City), VA",132349,4588,7916,8186,286319,3058,1644,8681,341876,14805,3840,344934,162651,38618,19997,89819,3350,16449,12009,22542,19192,103891,1970
22,"Chesterfield, VA",224851,6757,17114,11840,288696,1138,633,12677,346375,22151,4464,347513,76522,42128,16689,77847,1469,22784,23034,26071,24602,179033,1970
23,"Clarke, VA",21672,641,936,1052,23219,2530,1208,1167,29603,3923,3952,32133,2714,6532,2382,8130,929,5131,1462,4333,3404,15079,1970
24,"Craig, VA",3135,115,199,150,6891,254,210,190,9257,590,2706,9511,3946,1425,1195,3515,311,800,274,827,516,2061,1970
25,"Culpeper, VA",39644,1313,2221,2130,44379,1956,657,2378,58219,6179,3290,60175,7113,10650,5146,18289,1698,6836,3286,8109,6411,29522,1970
26,"Cumberland, VA",6289,187,185,192,12089,1393,991,283,14233,2254,2531,15626,6083,1699,1838,6175,644,3245,281,1516,872,2763,1970
27,"Dickenson, VA",36098,1157,3537,1894,32469,190,141,2104,42337,8168,2632,42527,-1525,2823,7235,16159,628,8309,4484,4278,3650,23305,1970
28,"Dinwiddie, Colonial Heights + Petersburg, VA*",176219,5897,12133,10684,185260,2610,1995,11239,241697,17092,3020,244307,20280,37149,21898,80894,3928,19087,17475,31034,27106,139657,1970
29,"Essex, VA",15345,521,898,868,13321,332,70,955,18709,2507,2678,19041,-1069,3568,2152,7109,708,2577,1332,3384,2676,11436,1970
30,"Fairfax, Fairfax City + Falls Church, VA*",1273674,33289,118457,67542,2466519,1371,818,67060,3047428,101769,6222,3048799,1259905,513263,69017,489999,16818,102587,152228,148818,132000,1018859,1970
31,"Fauquier, VA",65936,1775,5710,3220,75471,5480,3111,3385,107211,10383,4255,112691,12920,30801,6419,26483,2393,13494,7320,12200,9807,45122,1970
32,"Floyd, VA",10912,392,423,484,20709,1068,861,634,25895,3356,2761,26963,10431,3153,3101,9766,1241,4217,665,2783,1542,6030,1970
33,"Fluvanna, VA",10471,351,512,448,16365,988,681,575,20758,2684,2829,21746,6469,3257,2124,7686,489,3365,736,2134,1645,6370,1970
34,"Franklin, VA",44722,1512,2049,2588,63495,2795,1742,2806,77206,6938,2828,80001,21579,9235,7271,28291,2867,8680,3343,9775,6908,32699,1970
35,"Frederick + Winchester, VA*",129061,4441,6648,7944,120232,1767,-171,8413,151262,15203,3489,153029,-416,20596,12201,43866,3159,15032,10620,22982,19823,103409,1970
36,"Giles, VA",40976,1435,2795,2516,37870,299,156,2693,48256,3714,2906,48555,-413,4960,5725,16710,805,3870,4053,6334,5529,33053,1970
37,"Gloucester, VA",17504,633,870,752,40184,125,-2,1009,55203,5363,3916,55328,23689,10900,4244,14127,1031,5361,1246,3491,2460,10897,1970
38,"Goochland, VA",13010,424,545,552,24409,963,617,700,30899,3661,3173,31862,12099,5032,2421,10041,639,4278,821,2438,1799,7911,1970
39,"Grayson, VA",20981,722,894,1260,27474,2122,1718,1352,33662,2776,2298,35784,7845,3371,4939,15569,1435,4494,1524,5241,3806,14963,1970
40,"Greene, VA",4721,169,178,154,9926,250,162,246,12853,1954,2476,13103,5451,1840,1337,5291,360,2116,255,928,568,2350,1970
41,"Greensville + Emporia, VA*",33831,1129,1762,2096,30548,1260,865,2177,38893,3849,2698,40153,-1106,4656,4949,14883,1215,4714,2810,6928,5713,26307,1970
42,"Halifax, VA",74852,2317,3253,4192,79509,10179,8622,4413,90973,8226,2738,101152,9070,11486,10157,36941,5373,16848,5349,16370,10997,52655,1970
43,"Hampton (Independent City), VA",405899,8854,57852,22240,383021,0,0,19974,492790,13381,4085,492790,-2904,83903,25866,120636,3157,13381,68972,50298,47141,323546,1970
44,"Hanover, VA",57256,1992,2429,3046,124349,2437,1642,3515,149848,12111,4028,152285,70608,19700,8236,37811,2369,13753,3952,10507,8138,39551,1970
45,"Henrico, VA",331143,11589,17881,20944,607474,1312,526,22061,698742,33131,4513,700054,298392,66348,26232,155114,1427,33657,28353,44396,42969,269133,1970
46,"Henry + Martinsville, VA*",234751,8015,12568,15512,188455,910,633,15771,233014,15411,3312,233924,-30525,29631,15838,70626,3161,16044,20324,38167,35006,198383,1970
47,"Highland, VA",4102,122,147,160,4232,1036,922,202,5187,812,2431,6223,332,1067,924,2560,632,1734,227,1198,566,2141,1970
48,"Isle of Wight, VA",58612,1896,3447,3724,51018,3093,2422,3758,60902,3633,3474,63995,-3836,8647,4330,18422,1439,6055,5309,9299,7860,47248,1970
49,"James City + Williamsburg, VA*",85576,2804,4568,5024,86243,35,-96,5316,109027,7184,4013,109062,5983,18115,4704,27180,1120,7088,7080,14407,13287,71408,1970
50,"King George, VA",47615,381,7740,1146,28119,91,-29,954,38000,1676,4714,38091,-18542,8444,1528,8080,409,1647,8313,4560,4151,37655,1970
51,"King William, VA",20610,701,1089,1276,19691,522,71,1339,25339,2120,3473,25861,420,4201,1969,7447,630,2191,1727,3329,2699,16692,1970
52,"King and Queen, VA",6235,213,264,268,11639,489,271,347,14589,1672,2749,15078,5751,1934,1505,5485,522,1943,398,1716,1194,3894,1970
53,"Lancaster, VA",19109,691,907,1026,17616,123,-40,1204,28567,3990,3164,28690,-289,7402,3672,9068,876,3950,1420,4022,3146,13739,1970
54,"Lee, VA",24071,811,1312,1112,27056,3838,3383,1367,37642,3554,2015,41480,4352,4278,10146,20588,2209,6937,1868,5790,3581,15266,1970
55,"Loudoun, VA",99295,2523,7270,4362,128718,4958,2955,4704,182911,12439,5038,187869,34127,51268,7883,37288,3300,15394,9451,15763,12463,74450,1970
56,"Louisa, VA",26225,894,1024,1526,31603,1477,1141,1657,39635,4024,2891,41112,7035,5382,4127,14223,1251,5165,1787,4765,3514,19273,1970
57,"Lunenburg, VA",21422,673,1009,1170,23169,3073,2541,1258,26863,2880,2573,29936,3005,3463,3304,11633,1464,5421,1594,4961,3497,14407,1970
58,"Madison, VA",13337,415,480,516,19550,1638,908,673,24159,4727,2979,25797,6886,3700,2547,8659,998,5635,738,2985,1987,6964,1970
59,"Mathews, VA",8294,338,320,332,14795,236,56,504,22808,3432,3190,23044,7005,4943,3306,7224,634,3488,486,1973,1339,4320,1970
60,"Mecklenburg, VA",68806,2163,3355,4124,59674,6636,5369,4225,70416,6818,2610,77052,-4907,10097,7281,29520,3830,12187,5417,15423,11593,51202,1970
61,"Middlesex, VA",9075,333,405,376,11028,250,-137,521,17115,3255,2771,17365,2474,3491,2846,6267,694,3118,593,2189,1495,5364,1970
62,"Montgomery + Radford, VA*",181055,5875,12857,10598,134217,1140,466,11174,167960,10356,2869,169100,-35664,21985,12898,58939,2494,10822,18156,28815,26321,152077,1970
63,"Nelson, VA",16123,589,899,882,21850,1183,672,1030,28227,2977,2534,29410,6757,3826,3734,11605,804,3649,1340,3170,2366,11134,1970
64,"New Kent, VA",6105,220,265,306,13658,167,81,373,17582,1606,3341,17749,7926,2693,1398,5313,402,1687,418,1478,1076,4000,1970
65,"Newport News (Independent City), VA",580843,16922,61889,38516,448022,0,0,36180,567803,20407,4112,567803,-96641,87530,32251,138069,4058,20407,81147,75739,71681,479289,1970
66,"Norfolk (Independent City), VA",1548876,40382,213176,102818,1001934,0,0,91791,1343026,54913,4386,1343026,-455151,261243,79849,306216,8380,54913,264585,211482,203102,1229378,1970
67,"Northampton, VA",28293,904,1451,1540,26445,3627,1866,1674,33974,4547,2601,37601,-174,6048,5108,14454,1217,6413,2221,6718,5501,19659,1970
68,"Northumberland, VA",13451,485,647,642,17071,513,310,806,25708,3467,2820,26221,4426,5427,3723,9298,848,3777,968,3047,2199,8706,1970
69,"Nottoway, VA",37865,1257,2673,2662,32663,1466,942,2588,42271,3172,3061,43737,-2614,6450,4624,14288,1270,4114,4004,7220,5950,29747,1970
70,"Orange, VA",32833,1106,1365,1812,34166,2168,1350,2012,50404,5625,3778,52572,3345,14066,4340,13914,1340,6975,2271,6655,5315,23587,1970
71,"Page, VA",33083,1212,1531,2202,37683,1022,772,2313,48523,4536,2977,49545,6913,6260,5602,16641,1220,5308,2632,6594,5374,25143,1970
72,"Patrick, VA",22978,777,1007,1304,33678,2033,1612,1429,39427,4080,2702,41460,12129,3576,4206,15345,1673,5692,1659,5252,3579,15627,1970
73,"Pittsylvania + Danville, VA*",254661,8590,12583,16490,243286,11953,9885,16835,298211,23282,2947,310164,5460,36712,30166,105238,9251,33167,20828,49002,39751,200666,1970
74,"Portsmouth (Independent City), VA",351916,7472,43631,16680,302234,0,0,15812,397326,13596,3583,397326,-33870,63368,31724,110896,3226,13596,51971,48093,44867,286349,1970
75,"Powhatan, VA",10377,345,514,436,16277,772,360,563,20422,2517,2729,21194,6463,3183,1734,7766,539,2877,732,2092,1553,6768,1970
76,"Prince Edward, VA",36954,1187,1923,2046,29779,2614,2093,2210,37335,3333,2770,39949,-4965,6347,3823,14423,1289,5426,2946,7581,6292,28582,1970
77,"Prince George + Hopewell, VA*",200052,4747,28879,12074,123684,862,535,10784,164424,6937,3467,165286,-65584,32918,8684,47671,1308,7472,34916,26091,24783,157664,1970
78,"Prince William, Manassas + Manassas Park, VA*",255314,6789,33301,16068,395013,900,514,14823,528627,24030,4710,529527,154522,119746,14768,112424,3712,24544,41335,34397,30685,189435,1970
79,"Pulaski, VA",61579,2164,3093,4018,73427,949,421,4173,89897,6251,3066,90846,16021,9147,8272,29630,1328,6672,5102,11670,10342,49805,1970
80,"Rappahannock, VA",7940,246,231,342,11807,1226,690,417,15068,2424,3138,16294,4284,2966,1521,5192,616,3114,402,1978,1362,4424,1970
81,"Richmond (Independent City), VA",1415215,46817,85507,89434,776923,0,0,91534,1075625,72934,4333,1075625,-546758,201923,96779,248240,18581,72934,130224,204791,186210,1212057,1970
82,"Richmond, VA",15941,535,947,874,13497,509,350,972,18166,2035,2867,18675,-1472,2994,2184,6514,724,2385,1384,3398,2674,12172,1970
83,"Roanoke (Independent City), VA",409073,15242,20740,30256,264861,0,0,30370,367861,35020,3998,367861,-113842,59745,43255,92013,7440,35020,35868,63884,56444,338185,1970
84,"Roanoke + Salem, VA*",253654,8480,14984,15930,287019,810,285,16445,343706,25217,3846,344516,49810,37398,20099,89568,2343,25502,22949,34196,31853,205203,1970
85,"Rockbridge, Buena Vista + Lexington, VA*",68613,2344,3762,4366,65958,1793,1276,4527,85756,5482,2866,87549,1872,13027,8564,30544,1871,6758,5945,12772,10901,55910,1970
86,"Rockingham + Harrisonburg, VA*",171800,5452,9184,9774,170278,12385,9765,10339,197799,20480,3347,210184,8817,25491,14415,62807,6209,30245,14071,31524,25315,127484,1970
87,"Russell, VA",42760,1439,3402,2696,45310,3030,2395,2787,55743,4689,2394,58773,5337,5236,8227,24553,2066,7084,4750,7532,5466,30926,1970
88,"Scott, VA",21136,674,906,786,47880,5044,4783,1067,55179,4027,2467,60223,27811,5205,7138,24407,2072,8810,1299,4564,2492,11027,1970
89,"Shenandoah, VA",53335,1768,2403,3084,55884,4270,2963,3310,68867,7754,3181,73137,5859,10094,7159,22989,2485,10717,3945,11006,8521,38673,1970
90,"Smyth, VA",71973,2430,3854,4460,65658,2589,1546,4660,81547,7163,2677,84136,-1655,8817,9661,31435,2251,8709,6084,14135,11884,57180,1970
91,"Southampton + Franklin, VA*",39256,1233,1788,1940,53737,5657,4089,2203,66110,5226,2826,71767,16684,10898,7132,25395,2459,9315,2758,9518,7059,27183,1970
92,"Spotsylvania + Fredericksburg, VA*",88995,3017,4662,5186,95339,1283,950,5610,128309,11614,4162,129592,11954,25744,8509,31136,2407,12564,7255,15840,13433,69176,1970
93,"Stafford, VA",24109,825,1022,1064,73845,423,309,1357,101955,7483,4139,102378,51093,24382,4151,24735,600,7792,1554,3677,3077,14763,1970
94,"Suffolk (Independent City), VA",91624,3090,5109,5508,125238,3722,2657,5844,154469,6543,3509,158191,39458,19666,13287,45076,2510,9200,7863,18051,15541,74561,1970
95,"Surry, VA",36300,1203,1107,2452,11815,1446,1006,2429,13728,890,2547,15174,-22056,1788,1571,5957,653,1896,2333,3663,3010,32071,1970
96,"Sussex, VA",16854,548,760,914,22552,2017,1393,1005,28262,2950,2648,30279,6703,4852,2875,11435,1258,4343,1217,4128,2870,11294,1970
97,"Tazewell, VA",75188,2626,5140,4476,90697,997,388,4864,118085,9810,2968,119082,20373,12343,16042,40117,1970,10198,7378,12715,10745,57612,1970
98,Virginia,14888650,430167,1357475,878334,14928357,210892,146828,869334,19160751,1112316,4157,19371643,909041,3263757,1179529,4659930,256564,1259144,1796642,2157657,1901093,11832864,1970
99,"Virginia Beach (Independent City), VA",407958,11107,58432,27808,647905,3538,2308,25011,878180,30447,5086,881718,264958,207907,25906,173363,7421,32755,72336,66030,58609,302867,1970
100,"Warren, VA",38951,1339,2314,2260,42856,912,518,2469,55490,4765,3658,56402,6374,8373,5173,15420,1028,5283,3444,6533,5505,30224,1970
101,"Washington + Bristol, VA*",124403,4111,6567,7076,121334,7480,6232,7649,151730,13538,2849,159210,4580,19486,18390,55877,4804,19770,10105,23838,19034,94528,1970
102,"Westmoreland, VA",15923,539,754,738,22828,1461,823,908,31923,3726,2724,33384,7813,6451,4105,12256,1022,4549,1123,3867,2845,10251,1970
103,"Wise + Norton, VA*",89998,3138,6848,5382,88018,270,146,5829,114555,15600,2849,114825,3849,9775,17032,40299,1585,15746,9539,13029,11444,64713,1970
104,"Wythe, VA",44811,1505,2232,2596,47370,2712,1870,2803,59684,5439,2808,62396,5362,7669,7357,22220,1986,7309,3530,9417,7431,33972,1970
105,"York + Poquoson, VA*",78511,1305,10697,2822,112159,689,294,2716,146345,6106,4400,147034,36364,29274,5601,33416,939,6400,12108,9423,8484,60003,1970
0,"Accomack, VA",62352,1908,5298,3046,60877,2198,-437,3431,84775,11095,3045,86973,1956,14709,11387,28560,2732,10658,6821,12325,9593,44873,1971
1,"Albemarle + Charlottesville, VA*",294474,9914,19776,17930,228524,3639,1807,18879,319973,24466,4153,323612,-47071,71633,23455,77920,4537,26273,28741,43709,39172,239460,1971
2,"Alexandria (Independent City), VA",499434,15236,44248,31508,581449,0,0,30990,793095,25972,7191,793095,113005,182523,29123,110296,9329,25972,60002,63101,53772,413460,1971
3,"Alleghany + Covington, VA*",86134,3401,5229,6788,68013,232,178,6795,89717,6394,3092,89949,-11326,9703,12233,29092,1100,6572,8623,11605,10505,70939,1971
4,"Amelia, VA",11697,372,540,556,17435,2055,1484,650,20661,2109,2968,22716,6388,2876,2405,7654,963,3593,818,3006,2043,7286,1971
5,"Amherst, VA",42493,1544,2666,2494,58944,1098,765,2791,73576,5005,2789,74674,19242,8545,7185,26779,1200,5770,3913,7635,6435,32810,1971
6,"Appomattox, VA",17801,626,787,1038,24724,1560,1289,1145,30318,3388,3193,31878,8068,3620,3534,9984,974,4677,1306,3684,2710,11818,1971
7,"Arlington, VA",1879891,35275,308086,100944,1058566,0,0,85747,1465465,55552,8398,1465465,-735578,360205,46694,174500,8918,55552,358558,152078,143160,1465781,1971
8,"Augusta, Staunton + Waynesboro, VA*",275302,9584,15585,17064,248502,6372,4440,18116,309360,26138,3600,315732,-8684,42696,24534,87707,5620,30578,24117,40415,34795,220607,1971
9,"Bath, VA",11666,446,543,782,11446,217,-30,837,15806,1158,3043,16023,617,2417,2160,5266,465,1128,934,2529,2064,9604,1971
10,"Bedford, VA*",55596,2020,3236,3430,84123,2997,2032,3735,108064,7388,3273,111061,32262,15396,11542,33931,2548,9420,4951,11065,8517,41225,1971
11,"Bland, VA",8724,321,401,510,10496,657,446,576,13134,1223,2435,13791,2348,1431,1864,5663,596,1669,656,1824,1228,6399,1971
12,"Botetourt, VA",26323,1042,1339,1800,49893,1145,334,1942,62985,5512,3458,64130,25512,7348,6889,18547,1338,5846,2239,4881,3543,18238,1971
13,"Brunswick, VA",28774,925,1341,1578,34363,3994,3135,1714,39919,4207,2706,43913,7303,5008,4542,16230,1794,7342,2130,6389,4595,19302,1971
14,"Buchanan, VA",93799,3122,9130,5936,72063,172,151,6090,91519,14151,2724,91691,-15646,7240,12388,33662,1302,14302,12098,10890,9588,67399,1971
15,"Buckingham, VA",13971,495,700,804,18570,1309,1047,897,23976,2432,2332,25285,5496,3408,3307,10841,809,3479,1102,2818,2009,9390,1971
16,"Campbell + Lynchburg, VA*",397105,14045,23902,25746,279876,2784,1986,26918,367067,31739,3674,369851,-90311,55109,34866,100665,5249,33725,36775,56942,51693,326605,1971
17,"Caroline, VA",22932,687,2210,1204,37826,664,232,1289,48132,3543,3376,48796,16183,6872,4098,14455,870,3775,2812,3859,2989,16345,1971
18,"Carroll + Galax, VA*",64741,2366,3132,4200,57480,1908,1391,4466,76078,8502,2629,77986,-2795,10040,10466,29666,2631,9893,5232,13515,10884,49616,1971
19,"Charles City, VA",3493,126,185,170,13339,610,324,211,16867,613,2754,17477,10057,2560,1578,6347,188,937,270,807,619,2286,1971
20,"Charlotte, VA",19661,618,834,986,24388,4019,3336,1111,28852,3471,2573,32871,5838,4349,4134,12775,1957,6807,1327,4788,2831,11527,1971
21,"Chesapeake (Independent City), VA",142367,5138,8986,9272,315431,2257,734,9774,383085,16586,4195,385342,182838,45549,24362,91859,3541,17320,13622,23002,19461,111425,1971
22,"Chesterfield, VA",239876,7436,19944,13152,330753,893,354,14012,397799,23971,4881,398692,104889,48465,19474,81689,1475,24325,26520,26218,24743,189031,1971
23,"Clarke, VA",23170,706,1096,1168,25393,2583,1117,1290,33030,4323,4205,35613,3513,7517,2703,8469,925,5440,1680,4415,3490,16050,1971
24,"Craig, VA",3229,129,234,176,7216,128,79,217,9955,602,2857,10083,4204,1501,1366,3529,328,681,322,861,533,2226,1971
25,"Culpeper, VA",42525,1483,2544,2426,49332,1665,253,2696,65634,6606,3572,67299,9503,11858,6109,18839,1637,6859,3757,8211,6574,31909,1971
26,"Cumberland, VA",7100,219,230,242,13288,1448,992,340,16150,2461,2793,17598,6528,2106,2204,6301,595,3453,351,1614,1019,3296,1971
27,"Dickenson, VA",36134,1219,3439,2068,33009,117,75,2253,45542,7652,2747,45659,-872,3266,9384,16623,715,7727,4473,4375,3660,23934,1971
28,"Dinwiddie, Colonial Heights + Petersburg, VA*",191694,6686,13527,12490,201455,2716,2008,12931,265914,18078,3480,268630,22692,41701,25474,77193,3890,20086,19772,31465,27575,151836,1971
29,"Essex, VA",16957,603,1025,1012,15191,212,-86,1109,21535,2954,2944,21747,-657,3958,2598,7386,798,2868,1531,3609,2811,12558,1971
30,"Fairfax, Fairfax City + Falls Church, VA*",1466977,39343,149890,82676,2756094,1296,692,80681,3437021,115733,6917,3438317,1369798,599441,82782,497112,20189,116425,191228,161525,141336,1159324,1971
31,"Fauquier, VA",78734,2134,8458,4496,92777,5134,2453,4382,130993,11376,4932,136127,18425,35773,7577,27600,2508,13829,10706,13019,10511,54199,1971
32,"Floyd, VA",10969,425,470,536,21546,676,447,693,27943,3593,2875,28619,11270,3590,3483,9956,1255,4040,738,2830,1575,6191,1971
33,"Fluvanna, VA",11035,389,566,518,18287,910,526,648,23632,2873,3060,24542,7900,3729,2526,8019,526,3399,825,2192,1666,6811,1971
34,"Franklin, VA",46954,1648,2325,2850,68054,2888,1641,3073,84080,7648,2957,86968,24173,10563,8351,29410,2855,9289,3750,9889,7034,33915,1971
35,"Frederick + Winchester, VA*",144358,5121,7803,9226,132504,2291,67,9734,167694,16520,3704,169985,-2120,23221,14260,45890,3290,16587,12416,24100,20810,115355,1971
36,"Giles, VA",42073,1532,2873,2664,39247,443,290,2864,50884,4132,3038,51327,38,5551,6529,16895,821,4422,4205,6152,5331,33446,1971
37,"Gloucester, VA",19283,722,1032,872,45534,-10,-130,1158,62934,6036,4278,62924,27409,12570,4820,14710,1130,5906,1468,3618,2488,11909,1971
38,"Goochland, VA",13896,473,660,608,27555,749,375,777,35647,4160,3599,36396,14436,6003,2838,10114,701,4535,964,2534,1833,8397,1971
39,"Grayson, VA",23321,851,1052,1554,30436,1720,1291,1628,38198,3029,2443,39918,8743,3910,5572,16340,1413,4320,1829,5583,4170,17172,1971
40,"Greene, VA",5031,178,187,148,11690,405,302,252,14987,2351,2807,15392,6911,2140,1562,5483,370,2653,261,861,491,2117,1971
41,"Greensville + Emporia, VA*",36146,1276,2039,2394,32433,720,299,2473,42752,3989,2883,43472,-1240,5186,5853,15080,1206,4288,3236,7041,5835,28622,1971
42,"Halifax, VA",77585,2489,3562,4506,82763,10778,9104,4742,96849,8883,2890,107627,9920,12483,12381,37246,4946,17987,5815,15694,10748,53783,1971
43,"Hampton (Independent City), VA",455648,9985,71756,27068,417027,0,0,23519,542044,14535,4464,542044,-15102,93751,31266,121434,3310,14535,85290,51150,47840,355823,1971
44,"Hanover, VA",67769,2440,3009,3874,135774,2357,1422,4377,165932,13426,4278,168289,72382,22551,9964,39338,2610,14848,4946,11561,8951,47975,1971
45,"Henrico, VA",359172,12934,20386,23430,678868,1165,271,24649,786528,38201,4909,787693,344345,76103,32722,160467,1489,38472,32101,45356,43867,288599,1971
46,"Henry + Martinsville, VA*",251013,8919,13667,17484,200161,1033,734,17661,250613,16841,3501,251646,-33191,32640,18845,71888,3303,17575,22409,38571,35268,211029,1971
47,"Highland, VA",4057,137,169,186,4231,762,628,230,5694,902,2449,6456,404,1189,1036,2636,612,1530,262,1183,571,2265,1971
48,"Isle of Wight, VA",64403,2219,4068,4372,56968,1770,1014,4405,69972,3765,3715,71742,-3030,9944,4830,19310,1396,4779,6254,9530,8134,53370,1971
49,"James City + Williamsburg, VA*",107586,3669,6316,6932,104013,-57,-197,7135,131318,8052,4625,131261,3562,21604,5644,28379,1188,7855,9782,16332,15144,89949,1971
50,"King George, VA",60106,421,11898,1492,33874,194,32,1167,45987,1791,5555,46181,-25065,10513,1794,8314,863,1823,12644,5395,4532,45639,1971
51,"King William, VA",21807,774,1217,1418,21792,475,-17,1483,28122,2343,3863,28597,1468,4541,2264,7402,653,2326,1926,3379,2726,17555,1971
52,"King and Queen, VA",7175,263,321,354,13645,276,12,440,17307,1785,3178,17583,6910,2185,1753,5533,539,1797,498,1748,1209,4880,1971
53,"Lancaster, VA",19628,744,968,1098,18265,76,-96,1293,30857,4342,3450,30933,-70,8253,4415,8967,945,4246,1517,4036,3091,13865,1971
54,"Lee, VA",26342,963,1658,1388,30094,2976,2496,1657,44635,3709,2173,47611,5409,4840,12677,21911,2206,6205,2352,6108,3902,17785,1971
55,"Loudoun, VA",109616,2832,9699,4976,152734,4373,2160,5320,218480,13737,5788,222853,48438,60767,9352,38501,2913,15897,12187,15490,12577,81532,1971
56,"Louisa, VA",39031,1391,1482,2494,43311,1215,853,2638,53126,4932,3543,54341,6918,6231,4799,15339,1131,5785,2729,5711,4580,30517,1971
57,"Lunenburg, VA",22313,731,1073,1292,24191,3161,2544,1377,28688,3041,2757,31849,3255,3817,3841,11550,1433,5585,1719,4936,3503,15009,1971
58,"Madison, VA",13434,438,552,584,20154,1542,680,730,25853,4460,3079,27395,7450,4274,2967,8896,1019,5140,844,3061,2042,7450,1971
59,"Mathews, VA",9013,376,386,384,16555,225,26,568,25919,3681,3465,26144,8110,5697,3892,7545,680,3707,578,2052,1372,4728,1971
60,"Mecklenburg, VA",75193,2473,3926,4784,65016,6743,5364,4865,77976,7364,2799,84719,-5312,11157,8546,30264,3667,12728,6318,15724,12057,56147,1971
61,"Middlesex, VA",10115,383,506,478,12664,215,-268,622,19795,3515,3215,20010,3171,4068,3278,6224,779,3247,745,2400,1621,6123,1971
62,"Montgomery + Radford, VA*",189736,6443,14046,11664,143872,1189,476,12275,183084,11360,3041,184273,-33589,24536,15865,60597,2638,11836,19878,28753,26115,158022,1971
63,"Nelson, VA",14759,591,826,842,21535,672,144,1012,29332,3323,2626,30004,7788,4160,4309,11426,833,3467,1247,2888,2055,10045,1971
64,"New Kent, VA",6368,241,303,336,16045,158,67,409,20955,1711,3882,21113,10086,3286,1782,5439,490,1778,471,1561,1071,4119,1971
65,"Newport News (Independent City), VA",625587,18848,68933,43706,481163,0,0,40701,614039,22190,4390,614039,-103723,93697,39179,139868,4279,22190,90786,76601,72322,512611,1971
66,"Norfolk (Independent City), VA",1652481,43929,234983,118542,1040728,0,0,103200,1413563,60192,4679,1413563,-508553,273098,99737,302126,8839,60192,294254,204217,195378,1298035,1971
67,"Northampton, VA",29182,980,1650,1696,26719,3308,1371,1828,36056,4651,2687,39364,-635,6688,5957,14650,1161,6022,2498,6791,5630,20662,1971
68,"Northumberland, VA",13984,532,739,710,17975,333,107,887,28214,3711,2948,28547,4878,6266,4306,9684,947,3818,1094,3208,2261,9072,1971
69,"Nottoway, VA",41356,1397,3238,2978,36037,1488,776,2886,46999,3294,3313,48487,-2433,7181,5269,14636,1265,4070,4727,7303,6038,32559,1971
70,"Orange, VA",35603,1250,1565,2080,38722,2255,1305,2290,56782,5919,4019,59037,5409,14989,5326,14689,1366,7224,2605,6799,5433,25774,1971
71,"Page, VA",35232,1349,1714,2474,41406,619,330,2586,54243,4776,3213,54862,8760,7065,6391,17076,1293,5106,2951,6792,5499,27175,1971
72,"Patrick, VA",24424,858,1124,1462,37429,2124,1639,1589,44160,4421,2900,46284,14594,4037,4818,15961,1625,6060,1855,5228,3603,16509,1971
73,"Pittsylvania + Danville, VA*",269659,9447,13930,18160,259481,13066,10813,18527,321179,25575,3122,334245,8349,40247,34517,107068,9036,36388,23010,49076,40040,210261,1971
74,"Portsmouth (Independent City), VA",389305,8307,55499,19434,321250,0,0,18024,434620,14397,3899,434620,-50031,73150,40220,111482,3376,14397,65216,48240,44864,309692,1971
75,"Powhatan, VA",11966,410,663,530,20418,754,291,675,25453,2910,3192,26207,9127,3710,2079,8211,500,3201,928,2107,1607,7837,1971
76,"Prince Edward, VA",39526,1334,2195,2320,31697,2558,1999,2494,40528,3602,2902,43086,-5335,7027,4362,14848,1255,5601,3355,7653,6398,30570,1971
77,"Prince George + Hopewell, VA*",215232,5088,33903,14078,132300,620,257,12127,177078,7294,3367,177698,-70805,35087,10311,52781,1403,7551,40942,25553,24150,166739,1971
78,"Prince William, Manassas + Manassas Park, VA*",337549,9395,46156,24600,451977,969,518,21695,613059,27077,5150,614028,136123,144261,17790,119236,4350,27595,58456,40231,35881,251498,1971
79,"Pulaski, VA",64476,2350,3377,4372,74938,1102,468,4536,94072,6838,3114,95174,14998,10165,10071,30567,1395,7306,5563,11597,10202,51607,1971
80,"Rappahannock, VA",8356,275,268,394,12758,1003,392,472,16809,2792,3405,17812,4874,3275,1779,5231,622,3184,465,2053,1431,4707,1971
81,"Richmond (Independent City), VA",1544741,53079,99566,102168,821917,0,0,104163,1155652,79985,4689,1155652,-618661,215491,118244,246478,18775,79985,150650,207452,188677,1314106,1971
82,"Richmond, VA",17454,621,1107,1030,14758,280,78,1136,20539,2213,3155,20819,-1560,3698,2363,6598,769,2291,1622,3576,2807,13541,1971
83,"Roanoke (Independent City), VA",444818,17009,23881,33834,288531,0,0,33926,403387,35733,4307,403387,-122361,64136,50720,93666,7505,35733,40798,64804,57299,368287,1971
84,"Roanoke + Salem, VA*",278036,9488,17972,18060,308264,852,228,18518,373265,26928,4014,374117,48746,42697,23156,93205,2404,27156,27002,34985,32581,223878,1971
85,"Rockbridge, Buena Vista + Lexington, VA*",69908,2513,4035,4664,67054,1356,798,4845,90130,6047,2990,91486,1991,14324,10108,30597,1863,6845,6367,12266,10403,56696,1971
86,"Rockingham + Harrisonburg, VA*",189008,6257,10737,11350,184359,12217,8970,11932,217534,22299,3529,229751,7283,28595,16797,65099,6132,31269,16412,32660,26528,141327,1971
87,"Russell, VA",45115,1596,3656,3040,48553,2718,2030,3116,62186,4881,2580,64904,6554,5888,10463,25152,2106,6911,5176,8085,5979,33028,1971
88,"Scott, VA",20689,744,1009,878,48355,3641,3376,1183,58876,4407,2512,62517,28849,5853,8309,24889,2108,7783,1448,4579,2471,11458,1971
89,"Shenandoah, VA",57160,1991,2745,3546,61408,3833,2338,3764,77471,8259,3422,81304,8012,11632,8264,23762,2480,10597,4518,11019,8539,42045,1971
90,"Smyth, VA",72434,2566,3955,4708,66521,2462,1371,4920,85946,7656,2735,88408,-993,9982,11905,32323,2206,9027,6309,13526,11320,57098,1971
91,"Southampton + Franklin, VA*",37755,1335,2041,2110,53580,2772,1045,2390,71009,5377,2912,73781,18215,12094,8107,25337,2356,6422,3096,9479,7123,28237,1971
92,"Spotsylvania + Fredericksburg, VA*",100967,3572,5431,6238,112607,911,548,6691,151598,13307,4686,152509,18331,29777,10125,32547,2575,13855,8550,16734,14159,78562,1971
93,"Stafford, VA",27021,926,1316,1180,96791,392,261,1516,131875,8793,5162,132267,71286,30431,5045,25624,705,9054,1906,3859,3154,16061,1971
94,"Suffolk (Independent City), VA",103513,3703,6332,6714,140149,1888,666,7060,176280,7349,3862,178168,43696,22665,15354,46133,2422,8015,9689,19294,16872,85809,1971
95,"Surry, VA",36728,1302,1184,2604,11115,620,161,2604,14335,951,2337,14955,-23009,2034,1806,6398,581,1112,2486,3506,2925,33130,1971
96,"Sussex, VA",17421,608,893,1024,23497,1535,845,1120,30477,3070,2792,32012,7196,5295,3220,11464,1176,3915,1405,4089,2913,12101,1971
97,"Tazewell, VA",83979,3038,6044,5302,99666,717,32,5689,133464,10636,3208,134181,21376,13985,20530,41833,2120,10668,8695,13599,11479,64616,1971
98,Virginia,16361556,486170,1613126,1025388,16309725,190576,118906,998864,21220391,1219280,4505,21410967,947033,3687934,1413308,4752846,266215,1338186,2125820,2196371,1930156,12897550,1971
99,"Virginia Beach (Independent City), VA",463248,12960,66546,34910,739334,3630,2397,30415,989056,35622,5505,992686,306501,222125,31227,180324,8645,38019,84001,68223,59578,341228,1971
100,"Warren, VA",45200,1618,2869,2776,50529,688,280,3006,65348,5092,4064,66036,8335,9751,5756,16249,1253,5372,4257,7347,6094,35571,1971
101,"Washington + Bristol, VA*",138237,4784,7929,8328,132335,6673,5246,8948,168920,15015,3043,175593,3046,21898,21360,57707,4744,20261,12093,24550,19806,105883,1971
102,"Westmoreland, VA",17158,603,848,826,26192,1560,842,1016,37226,4143,3015,38786,10050,7658,4936,12864,1011,4985,1261,3968,2957,10912,1971
103,"Wise + Norton, VA*",95816,3449,7460,6020,91907,273,144,6459,124921,15485,3023,125194,2550,11305,21982,41419,1736,15629,10470,13078,11342,69717,1971
104,"Wythe, VA",44385,1559,2457,2652,48056,2631,1706,2885,62539,5711,2842,65170,6556,8495,8619,22931,1953,7417,3783,9116,7163,33185,1971
105,"York + Poquoson, VA*",86786,1460,13834,3392,127575,559,140,3156,167689,6252,4878,168248,43945,34306,6367,34490,947,6392,15530,9530,8583,64864,1971
0,"Accomack, VA",69060,2200,5962,3564,66564,3334,731,3982,92859,11997,3349,96193,1486,16323,13306,28721,2897,12728,7744,12902,10005,48588,1972
1,"Albemarle + Charlottesville, VA*",324730,11408,22689,21092,267105,4421,2570,21954,368328,27947,4484,372749,-35671,78723,26921,83132,4852,30517,33235,45596,40744,260978,1972
2,"Alexandria (Independent City), VA",532516,16893,47843,35892,619002,0,0,34839,852995,28374,7891,852995,121325,201666,32327,108095,9651,28374,65789,62919,53268,438353,1972
3,"Alleghany + Covington, VA*",93689,3853,5861,7768,73200,307,265,7737,97020,7019,3392,97327,-12752,10422,13705,28697,1185,7284,9745,11879,10694,76660,1972
4,"Amelia, VA",12413,404,571,576,19096,2338,1786,692,22899,2584,3194,25237,7375,3414,2727,7902,1033,4370,859,2937,1904,7184,1972
5,"Amherst, VA",46713,1765,3131,2854,65367,1098,794,3192,81924,5849,3009,83022,21846,9539,8116,27593,1233,6643,4558,7770,6537,35512,1972
6,"Appomattox, VA",19424,714,901,1198,27773,1629,1353,1313,34249,3706,3447,35878,9662,4070,4035,10408,1040,5059,1500,3755,2715,12865,1972
7,"Arlington, VA",2031055,39860,329687,114872,1118237,0,0,97296,1564904,61281,9047,1564904,-815522,395262,51405,172980,8995,61281,387123,151235,142240,1582651,1972
8,"Augusta, Staunton + Waynesboro, VA*",302435,10919,17902,20164,271187,8060,6144,21001,338325,29049,3916,346385,-10247,47384,27814,88454,5866,35193,27984,41457,35591,239258,1972
9,"Bath, VA",13503,516,591,924,13247,715,476,978,17654,1301,3498,18369,722,2745,2377,5252,452,1777,1053,2543,2091,10673,1972
10,"Bedford, VA*",62281,2317,3696,3964,96408,3830,2919,4299,122310,8966,3750,126140,38426,16907,12825,33641,2721,11885,5678,11323,8602,44718,1972
11,"Bland, VA",10624,398,504,672,12300,839,632,734,15211,1353,2857,16050,2410,1689,2061,5618,612,1985,840,1960,1348,7799,1972
12,"Botetourt, VA",30168,1214,1607,2040,57181,1687,891,2234,71571,6615,3798,73258,29247,8459,7618,19290,1384,7506,2627,5095,3711,20035,1972
13,"Brunswick, VA",32946,1094,1508,1886,39219,4714,3864,2037,45473,5118,3108,50187,8310,5683,5285,16146,1785,8982,2451,6430,4645,21513,1972
14,"Buchanan, VA",104636,3649,10276,6500,79747,305,287,6899,103418,15339,3037,103723,-17990,8682,15294,34149,1304,15626,13526,10790,9486,75484,1972
15,"Buckingham, VA",15394,572,820,918,21207,1258,1019,1031,27752,2899,2720,29010,6844,3999,3804,10664,896,3918,1279,3024,2128,10197,1972
16,"Campbell + Lynchburg, VA*",456636,16731,28782,32100,313489,3000,2245,32781,409684,35892,4003,412684,-110366,60112,39083,103090,5457,38137,44832,59245,53788,373667,1972
17,"Caroline, VA",27173,834,2485,1464,45408,1231,808,1566,56610,4501,3848,57841,19801,7865,4568,15032,1021,5309,3217,4211,3190,18647,1972
18,"Carroll + Galax, VA*",74498,2776,3757,5046,66919,3330,2811,5299,86786,9772,2985,90116,-2280,11279,11918,30185,2842,12583,6280,14305,11463,55635,1972
19,"Charles City, VA",4290,152,226,204,15586,892,605,254,19407,684,3202,20299,11550,2841,1872,6339,202,1289,328,918,716,2673,1972
20,"Charlotte, VA",21281,689,931,1096,27152,4448,3783,1237,31717,3922,2870,36165,7108,4888,4125,12601,2058,7705,1479,4837,2779,12097,1972
21,"Chesapeake (Independent City), VA",154572,5693,10625,10270,352172,3585,2134,10828,427612,21342,4571,431197,208428,50915,28110,94330,3788,23476,15760,22753,18965,115336,1972
22,"Chesterfield, VA",282993,9053,24215,16634,390990,1011,503,17370,469646,28295,5485,470657,125367,57705,21962,85810,1587,28798,32532,28520,26933,221663,1972
23,"Clarke, VA",24791,727,1487,1198,27160,3098,1657,1326,35857,4856,4499,38955,3695,8659,3136,8659,991,6513,2086,4453,3462,16192,1972
24,"Craig, VA",3618,143,249,190,8036,333,286,238,10816,723,3115,11149,4656,1608,1505,3579,352,1009,344,873,521,2265,1972
25,"Culpeper, VA",49188,1742,3000,2914,57019,2862,1489,3199,74468,7805,4038,77330,11030,13274,7037,19150,1662,9294,4457,8367,6705,35437,1972
26,"Cumberland, VA",7506,248,250,256,14423,1304,846,376,18121,2934,3021,19425,7293,2556,2446,6429,614,3780,378,1524,910,3348,1972
27,"Dickenson, VA",42013,1493,3971,2440,37760,217,188,2713,52559,7745,3051,52776,-1540,3772,11244,17299,653,7933,5191,4409,3756,28889,1972
28,"Dinwiddie, Colonial Heights + Petersburg, VA*",211844,7692,15510,14564,219699,3148,2433,14974,292584,19897,3531,295732,22829,46232,29801,83752,4151,22330,22792,32644,28493,166722,1972
29,"Essex, VA",18766,660,1116,1132,17631,967,667,1226,24017,3265,3296,24984,91,4385,2968,7580,800,3932,1682,3583,2783,13152,1972
30,"Fairfax, Fairfax City + Falls Church, VA*",1708723,48881,168417,103860,3078736,1329,746,100811,3835320,133311,7252,3836649,1470824,661268,96645,529048,22234,134057,220347,175743,153509,1354319,1972
31,"Fauquier, VA",85561,2368,8948,4876,108120,6663,3979,4806,149098,12849,5548,155761,27365,39165,8476,28073,2771,16828,11386,13106,10335,57347,1972
32,"Floyd, VA",13389,490,563,610,24816,1741,1518,795,30930,4281,3208,32671,12222,4052,3803,10184,1304,5799,868,2849,1545,6722,1972
33,"Fluvanna, VA",13790,508,713,762,20923,960,539,889,27123,3113,3515,28083,8022,4301,2859,7990,576,3652,1094,2472,1896,9044,1972
34,"Franklin, VA",55873,2025,2817,3568,78382,3413,2123,3809,96557,9631,3307,99970,26318,12084,9504,30232,2944,11754,4601,10553,7609,39518,1972
35,"Frederick + Winchester, VA*",160919,5919,9294,11008,145893,2545,313,11423,184980,18723,4115,187525,-3603,25796,15836,45571,3588,19036,14798,24735,21147,127085,1972
36,"Giles, VA",44444,1682,3097,3004,42326,635,489,3184,55078,4686,3315,55713,1066,6156,7231,16804,900,5175,4599,6103,5203,34670,1972
37,"Gloucester, VA",23435,893,1284,1124,54048,496,395,1455,73265,6921,4812,73761,32068,13968,5745,15327,1298,7316,1846,4059,2761,14273,1972
38,"Goochland, VA",16101,574,820,760,31825,954,593,954,41325,4490,4139,42279,16678,7152,3302,10214,719,5083,1200,2673,1954,9818,1972
39,"Grayson, VA",27114,1006,1208,1874,35514,2462,2061,1943,43881,3326,2907,46343,10343,4590,6239,15942,1477,5387,2145,5861,4384,19582,1972
40,"Greene, VA",5761,214,219,190,13481,445,341,309,17195,2625,3259,17640,8029,2470,1689,5413,421,2966,314,957,536,2481,1972
41,"Greensville + Emporia, VA*",39601,1449,2286,2692,35714,1163,767,2795,46664,4865,3163,47827,-1092,5699,6414,15123,1231,5632,3632,7014,5783,30337,1972
42,"Halifax, VA",87398,2960,4241,5530,93402,10629,9023,5725,109971,10203,3225,120600,11729,13710,13488,37399,5046,19226,7006,16488,11442,61166,1972
43,"Hampton (Independent City), VA",508884,11512,81067,31920,468659,0,0,27472,610230,16213,4780,610230,-12753,104778,36793,127655,3520,16213,97027,52680,49160,395644,1972
44,"Hanover, VA",81038,3023,3805,5018,157050,2921,1956,5532,190984,15373,4643,193905,81544,25557,11298,41762,2764,17329,6314,12581,9817,57395,1972
45,"Henrico, VA",380055,14233,22450,26124,731578,1480,581,27295,856076,44268,5255,857556,378818,86316,39662,163180,1592,44849,35512,44433,42841,299694,1972
46,"Henry + Martinsville, VA*",289830,10685,16346,21752,229080,1181,893,21561,285424,19292,3948,286605,-39189,35974,21551,72591,3578,20185,27222,41147,37569,242423,1972
47,"Highland, VA",4577,149,183,194,4806,1243,1102,246,6090,943,2926,7333,475,1360,1167,2506,633,2045,280,1172,539,2252,1972
48,"Isle of Wight, VA",72114,2509,4652,5082,65731,3910,3156,5050,78682,4176,4244,82592,-1333,11045,5816,19459,1473,7332,7193,9706,8233,57589,1972
49,"James City + Williamsburg, VA*",111950,3955,7184,7622,104874,320,185,7766,135217,8649,4615,135537,690,23998,6665,29368,1223,8834,10995,16320,15097,92121,1972
50,"King George, VA",67163,525,13010,1810,38374,591,409,1430,51590,2145,6214,52181,-27359,11686,2121,8398,1080,2554,13915,5845,4765,50694,1972
51,"King William, VA",25073,900,1382,1698,25374,1110,639,1749,31790,2610,4262,32900,2050,4965,2561,7720,700,3249,2231,3408,2708,19593,1972
52,"King and Queen, VA",8622,303,352,400,16237,1015,738,503,19770,2175,3773,20785,8118,2482,2066,5509,587,2913,552,1774,1187,5157,1972
53,"Lancaster, VA",22050,857,1108,1292,20517,438,273,1503,34282,4904,3783,34720,-30,9254,4949,9179,1054,5177,1754,4122,3068,15119,1972
54,"Lee, VA",31260,1144,1970,1670,36080,4177,3731,1979,52292,4476,2542,56469,6799,5559,14830,22215,2328,8207,2805,6280,3952,20248,1972
55,"Loudoun, VA",127422,3550,10905,6456,183992,5629,3463,6778,256787,15600,6482,262416,63348,67585,10839,40482,3108,19063,14133,16562,13454,94226,1972
56,"Louisa, VA",49618,1839,1836,3504,52139,1314,974,3591,63515,5790,4192,64829,6112,7155,5535,15464,1198,6764,3588,6293,5095,39266,1972
57,"Lunenburg, VA",25698,894,1296,1594,27587,2920,2297,1691,33160,3737,3014,36080,3580,4271,4222,11969,1424,6034,2093,5257,3833,17571,1972
58,"Madison, VA",15137,501,633,688,22625,2251,1357,845,28606,4623,3364,30857,8333,4998,3234,9172,1082,5980,977,3201,2119,8180,1972
59,"Mathews, VA",9986,427,445,444,18949,385,190,649,29484,3978,3796,29869,9612,6427,4493,7868,755,4168,667,2119,1364,5151,1972
60,"Mecklenburg, VA",88065,3034,4845,6056,75483,6870,5543,6062,90330,8587,3242,97200,-6520,12403,9314,29983,3711,14130,7873,16685,12974,66062,1972
61,"Middlesex, VA",11957,458,623,608,15210,703,182,762,22876,3609,3598,23579,4015,4680,3689,6554,834,3791,927,2620,1786,7239,1972
62,"Montgomery + Radford, VA*",216258,7640,16494,14282,164249,1697,1029,14781,208146,13372,3310,209843,-37228,27347,18247,63388,2813,14401,23635,30247,27434,178222,1972
63,"Nelson, VA",13931,611,793,854,22274,251,-228,1038,31414,3620,2713,31665,9381,4532,4859,11671,852,3392,1220,2841,1989,9319,1972
64,"New Kent, VA",7868,297,387,408,19884,550,464,501,25240,2005,4300,25790,12517,3895,2011,5998,486,2469,591,1609,1123,4808,1972
65,"Newport News (Independent City), VA",715466,22831,75046,52746,511267,0,0,49204,653037,23547,4715,653037,-154995,97383,44387,138488,4460,23547,101419,81824,77364,590500,1972
66,"Norfolk (Independent City), VA",1815406,49387,259437,135376,1118945,0,0,117075,1531657,65370,5354,1531657,-579386,297341,115371,286067,9157,65370,327125,204261,195104,1422911,1972
67,"Northampton, VA",31970,1101,1911,1944,28917,3857,1985,2073,39386,4957,2872,43243,-980,7415,6911,15056,1138,6942,2883,6614,5476,22145,1972
68,"Northumberland, VA",16043,605,832,820,20324,1119,897,1015,31175,4133,3495,32294,5296,7172,4798,9239,959,5030,1242,3195,2236,9771,1972
69,"Nottoway, VA",45492,1576,3730,3376,40099,1708,890,3264,52351,3998,3736,54059,-2129,8015,5945,14470,1322,4888,5418,7321,5999,35186,1972
70,"Orange, VA",41226,1491,1909,2546,45224,2764,1803,2764,64715,7134,4509,67479,6762,16329,5926,14965,1478,8937,3182,7193,5715,29107,1972
71,"Page, VA",39603,1536,2015,2836,47160,1331,1039,2954,60786,5759,3531,62117,10511,7863,7094,17593,1274,6798,3433,6728,5454,29372,1972
72,"Patrick, VA",27278,991,1283,1666,43450,2431,1944,1824,51236,5330,3322,53667,17996,4590,5627,16157,1766,7274,2116,5462,3696,17888,1972
73,"Pittsylvania + Danville, VA*",305925,11232,16482,21992,295657,11518,9358,22228,366695,29437,3486,378213,11960,44148,38408,108505,9052,38795,27478,49944,40892,239652,1972
74,"Portsmouth (Independent City), VA",427241,9622,61480,23226,341191,0,0,21235,471162,16555,4366,471162,-64815,81815,48156,107917,3260,16555,73093,48600,45340,337593,1972
75,"Powhatan, VA",13972,510,849,684,25207,527,75,852,31359,3362,3440,31886,12087,4333,2346,9270,573,3437,1191,2334,1761,9344,1972
76,"Prince Edward, VA",43457,1525,2563,2742,34754,2768,2242,2896,44780,3957,3034,47548,-5807,7819,4975,15671,1425,6199,3934,8036,6611,33324,1972
77,"Prince George + Hopewell, VA*",216515,5262,32414,13960,133127,1058,705,12242,177310,7979,3921,178368,-71146,33558,11683,45488,1395,8684,39394,23282,21887,168437,1972
78,"Prince William, Manassas + Manassas Park, VA*",394114,11278,52214,29160,522272,1465,1000,25858,699972,31755,5583,701437,154016,157934,21231,125633,4879,32755,66794,42524,37645,294565,1972
79,"Pulaski, VA",73786,2777,4064,5300,84603,1349,680,5427,105539,7901,3491,106888,16244,11209,11076,30619,1488,8581,6714,12168,10680,58491,1972
80,"Rappahannock, VA",8774,301,299,440,13775,1222,610,521,18281,2731,3680,19503,5522,3687,2041,5300,627,3341,519,2042,1415,4914,1972
81,"Richmond (Independent City), VA",1708352,60671,116553,120566,869167,0,0,120954,1234758,86436,5189,1234758,-718231,227398,138193,237955,19239,86436,176836,214639,195400,1445080,1972
82,"Richmond, VA",19951,716,1295,1220,17222,879,657,1326,23563,2584,3865,24442,-1403,4420,2800,6324,796,3241,1905,3741,2945,14805,1972
83,"Roanoke (Independent City), VA",507213,20031,28987,40702,318600,0,0,40382,443963,37991,4804,443963,-148231,68593,56770,92417,7699,37991,49338,69048,61349,419884,1972
84,"Roanoke + Salem, VA*",294877,10465,19882,20394,334167,1307,659,20662,406768,29540,4167,408075,59952,47615,26293,97921,2680,30199,30079,34754,32074,234599,1972
85,"Rockbridge, Buena Vista + Lexington, VA*",76704,2833,4782,5318,73473,2004,1463,5492,98447,6552,3239,100451,2261,15922,11056,31009,2025,8015,7441,12531,10506,61248,1972
86,"Rockingham + Harrisonburg, VA*",209220,7128,12202,13264,202578,15686,12168,13760,237993,25533,3721,253679,7118,31893,19208,68174,6453,37701,18834,33531,27078,152685,1972
87,"Russell, VA",51569,1887,4093,3468,56522,3505,2847,3621,71937,5485,2949,75442,8574,6609,12311,25585,2169,8332,5827,8063,5894,37410,1972
88,"Scott, VA",23399,828,1099,972,52805,5253,5018,1314,63788,5074,2749,69041,30720,6607,9629,25113,2038,10092,1585,4422,2384,11722,1972
89,"Shenandoah, VA",64476,2317,3223,4200,69650,4640,3131,4417,87397,9168,3785,92037,9591,13245,9142,24316,2538,12299,5323,11398,8860,46854,1972
90,"Smyth, VA",76346,2787,4111,5152,71149,3569,2569,5363,91800,9265,2953,95369,166,11260,12960,32292,2340,11834,6687,13315,10975,57825,1972
91,"Southampton + Franklin, VA*",46466,1561,2419,2558,61832,7090,5406,2840,77708,5926,3359,84798,18206,13545,9421,25248,2320,11332,3698,9635,7315,31436,1972
92,"Spotsylvania + Fredericksburg, VA*",114403,4204,6497,7518,129961,1182,834,7963,173812,15294,5190,174994,23521,33321,11712,33715,2993,16128,10256,17922,14929,88019,1972
93,"Stafford, VA",27778,1024,1463,1324,114584,570,440,1686,152982,8633,5748,153552,88492,33210,5758,26713,756,9073,2125,3957,3201,16580,1972
94,"Suffolk (Independent City), VA",129255,4663,8375,8970,166682,4704,3461,9148,205180,8667,4385,209884,46575,25121,18081,47863,2540,12128,12860,21555,19015,104267,1972
95,"Surry, VA",26113,923,950,1872,13658,1600,1163,1859,16439,1210,2758,18039,-10596,2312,2069,6541,637,2373,1886,2670,2033,21854,1972
96,"Sussex, VA",20116,705,1024,1166,26859,2280,1605,1288,34022,3840,3152,36302,8031,5838,3605,11517,1219,5445,1607,4142,2923,13064,1972
97,"Tazewell, VA",98817,3645,7342,6370,115486,2418,1739,6830,153186,12260,3637,155604,23499,15838,24280,42779,2199,13999,10527,14135,11936,74291,1972
98,Virginia,18247954,563642,1799085,1205550,18084584,251166,180377,1166417,23513006,1378541,4922,23764172,1003047,4057724,1621864,4828131,280300,1558918,2401860,2263423,1983123,14287176,1972
99,"Virginia Beach (Independent City), VA",522640,15170,71161,39732,840753,6152,5067,35036,1113743,42298,5940,1119895,353149,241442,37700,188539,9753,47365,91027,70429,60676,384248,1972
100,"Warren, VA",49454,1830,3181,3214,56772,971,598,3437,73324,6275,4374,74295,10755,10966,6557,16985,1234,6873,4788,7513,6279,37793,1972
101,"Washington + Bristol, VA*",159445,5655,9777,10234,150030,9007,7573,10772,189538,16923,3352,198545,1357,24560,23955,59232,5113,24496,14894,26147,21034,120055,1972
102,"Westmoreland, VA",19491,690,1038,958,29874,2110,1400,1169,42136,4618,3437,44246,11552,8696,5676,12872,1044,6018,1517,4097,3053,11956,1972
103,"Wise + Norton, VA*",111920,4187,8940,7220,104874,392,277,7797,142955,17255,3379,143347,751,12812,25661,42421,1719,17532,12550,13670,11951,81838,1972
104,"Wythe, VA",46320,1661,2720,2812,51846,3749,2834,3067,66928,6209,3135,70677,8593,9490,9341,22542,2081,9043,4126,9007,6926,33151,1972
105,"York + Poquoson, VA*",95940,1612,15617,3806,145852,629,233,3515,191050,7401,5379,191679,53427,38664,7163,35632,1074,7634,17520,9802,8728,70786,1972
0,"Accomack, VA",81614,2837,6605,4712,77233,6346,3518,5193,105810,13311,3795,112156,812,19268,15655,29553,2904,16829,8961,13424,10520,55824,1973
1,"Albemarle + Charlottesville, VA*",375682,14829,25235,27844,305617,6123,4109,28751,422792,29191,5006,428915,-41314,90899,32399,85678,5450,33300,39157,49116,43666,303225,1973
2,"Alexandria (Independent City), VA",623193,21456,58706,45116,673706,0,0,44014,934198,27686,8508,934198,94527,220652,39840,109798,10281,27686,81264,67615,57334,514243,1973
3,"Alleghany + Covington, VA*",103211,4678,6211,10048,79280,440,403,9702,106936,7018,3749,107376,-14229,11512,16584,28643,1205,7421,11235,12283,11078,84555,1973
4,"Amelia, VA",15565,524,629,814,23243,3762,3202,931,26685,2749,3805,30447,8609,3990,3214,8002,924,5951,1036,2913,1989,8578,1973
5,"Amherst, VA",53364,2226,3355,3696,72424,1568,1277,4074,91753,6300,3402,93321,23134,11378,9519,27431,1291,7577,5203,8079,6788,40584,1973
6,"Appomattox, VA",22462,880,1023,1540,31409,2561,2230,1650,38211,3851,3945,40772,10597,4760,4603,10336,1044,6081,1793,3811,2767,14588,1973
7,"Arlington, VA",2062076,49898,315037,124574,1162692,0,0,112185,1648408,63232,10026,1648408,-787199,424470,61246,164416,10241,63232,377324,147256,137015,1621520,1973
8,"Augusta, Staunton + Waynesboro, VA*",344321,14052,19427,26516,305069,13105,11023,27310,379892,29817,4461,392997,-11942,54404,33524,88087,5717,40840,32685,43253,37536,270796,1973
9,"Bath, VA",15274,655,660,1182,14955,828,562,1246,20130,1315,3983,20958,927,3163,2840,5262,427,1877,1251,2599,2172,12146,1973
10,"Bedford, VA*",69976,2915,3982,5180,109758,4816,3885,5505,140312,8990,4179,145128,45287,20424,14946,34727,2956,12875,6572,11898,8942,50529,1973
11,"Bland, VA",12658,535,566,980,14643,799,590,1025,18412,1444,3431,19211,3010,2052,2516,5600,582,2034,1056,2040,1458,9568,1973
12,"Botetourt, VA",34694,1495,1805,2738,65517,2112,1263,2864,82667,6739,4279,84779,33687,10473,8789,19813,1446,8002,3174,5386,3940,23518,1973
13,"Brunswick, VA",38052,1377,1641,2406,45135,6490,5602,2580,51667,5549,3617,58157,9663,6793,6229,16081,1720,11151,2844,6474,4754,24057,1973
14,"Buchanan, VA",114581,4552,10496,8470,85511,358,343,8787,117876,18024,3402,118234,-20283,12173,20550,34757,1311,18367,14731,10949,9638,81483,1973
15,"Buckingham, VA",18216,719,907,1188,25265,2106,1868,1313,32330,3267,3186,34436,8362,4605,4566,10807,984,5135,1501,3173,2189,11580,1973
16,"Campbell + Lynchburg, VA*",511797,21538,30474,41918,345241,4316,3531,42497,453616,38468,4404,457932,-124059,66752,45939,103989,5826,41999,51433,62449,56623,418365,1973
17,"Caroline, VA",31080,1066,2525,1850,52345,2379,1932,1991,64590,4937,4405,66969,23256,9086,5538,15204,1002,6869,3450,4201,3199,20761,1973
18,"Carroll + Galax, VA*",81815,3470,4202,6262,73937,3270,2698,6601,98062,10326,3271,101332,-1277,13053,14342,30983,2857,13024,7333,14732,11875,61458,1973
19,"Charles City, VA",5000,183,250,260,17944,1127,808,313,22463,836,3562,23590,13257,3378,2268,6623,221,1644,380,939,718,2976,1973
20,"Charlotte, VA",25467,879,1073,1436,31737,6134,5445,1597,36014,4208,3439,42148,7867,5518,4893,12256,2067,9653,1791,4965,2898,14023,1973
21,"Chesapeake (Independent City), VA",182779,7564,11983,14192,401666,3059,1567,14660,490257,22619,5030,493316,233547,58002,33648,98076,4256,24186,19079,25095,20839,139514,1973
22,"Chesterfield, VA",314285,11557,25388,21906,458576,1340,813,22510,552086,29949,6100,553426,166801,69558,25292,90731,2411,30762,36341,31058,28647,247182,1973
23,"Clarke, VA",26553,863,1583,1512,30418,3864,2330,1619,40064,4473,5004,43928,5484,9955,3555,8779,1052,6803,2339,4510,3458,17411,1973
24,"Craig, VA",3996,173,258,270,8996,277,229,308,12276,741,3487,12553,5308,1875,1682,3600,365,970,393,932,567,2633,1973
25,"Culpeper, VA",54614,2201,3276,3808,63395,2828,1311,4105,84890,7662,4462,87718,12886,15928,8395,19661,1845,8973,5180,8824,6979,40461,1973
26,"Cumberland, VA",8931,292,280,322,16737,2366,1869,453,20519,3028,3340,22885,8259,3121,3027,6852,613,4897,441,1511,898,3593,1973
27,"Dickenson, VA",46679,1882,3989,3180,41992,182,164,3472,61691,9585,3518,61873,-1215,5315,14566,17586,613,9749,5579,4461,3848,31351,1973
28,"Dinwiddie, Colonial Heights + Petersburg, VA*",243641,9974,17565,19430,246211,4735,3965,19689,327756,20379,4004,332491,22259,50836,35444,83033,4464,24344,27280,34698,30234,192017,1973
29,"Essex, VA",22043,852,1264,1466,20954,2101,1764,1585,27575,3317,3799,29676,496,5182,3540,7812,821,5081,1997,3688,2867,14965,1973
30,"Fairfax, Fairfax City + Falls Church, VA*",2073321,68369,198426,143450,3421081,1649,1022,140094,4292046,146121,7973,4293695,1487854,755143,117471,538557,27867,147143,270151,202703,174836,1656027,1973
31,"Fauquier, VA",96483,3015,9840,5946,127728,8610,5733,5988,173916,13038,6436,182526,37233,44911,9887,28362,2985,18771,12813,13636,10651,64899,1973
32,"Floyd, VA",14801,621,591,826,27729,1411,1166,1034,35527,4763,3636,36938,13962,4774,4435,10159,1307,5929,1004,2907,1600,7868,1973
33,"Fluvanna, VA",16425,643,767,1052,24681,1957,1474,1169,31334,3118,3951,33291,9425,5156,3454,8425,624,4592,1293,2666,2042,10540,1973
34,"Franklin, VA",70051,2852,3559,5238,92693,3976,2557,5471,114415,10875,3879,118391,28113,14331,11367,30518,2971,13432,6178,11888,8917,50441,1973
35,"Frederick + Winchester, VA*",189549,7906,10427,15062,167204,4726,2312,15437,211225,18952,4631,215951,-6908,30398,18349,46634,3856,21264,17958,26154,22298,150327,1973
36,"Giles, VA",49613,2132,3235,4046,47201,652,504,4155,62354,4835,3740,63006,1743,6999,8806,16845,939,5339,5258,6459,5520,39016,1973
37,"Gloucester, VA",28240,1192,1480,1642,60924,788,696,2013,83013,7077,5115,83801,34697,16050,6827,16384,1441,7773,2301,4522,3081,18166,1973
38,"Goochland, VA",18631,729,923,1052,36827,1313,934,1255,47319,4369,4690,48632,19451,7888,3917,10370,753,5303,1449,2850,2097,11879,1973
39,"Grayson, VA",31669,1298,1350,2440,41484,3403,2998,2518,51232,3628,3353,54635,12333,5766,7385,16292,1431,6626,2570,5995,4564,22473,1973
40,"Greene, VA",6705,268,263,268,15880,583,475,402,20302,2784,3708,20885,9577,3016,1989,5633,463,3259,397,1065,602,3049,1973
41,"Greensville + Emporia, VA*",46350,1855,2537,3436,41717,2908,2516,3573,52595,5398,3688,55503,-1060,6380,7406,15048,1206,7914,4255,7259,6053,34181,1973
42,"Halifax, VA",104313,3839,4733,7240,109848,16705,15035,7459,124815,10504,3810,141520,12994,15713,15959,37145,4838,25539,8353,16911,12073,70421,1973
43,"Hampton (Independent City), VA",552993,14550,85431,36478,495355,0,0,32789,654316,17168,5105,654316,-24849,115034,43927,128180,3538,17168,103670,54024,50486,432155,1973
44,"Hanover, VA",104002,4343,4740,7672,179087,3832,2735,8179,219763,16875,5148,223595,83264,30750,13758,43433,2970,19610,8576,14199,11229,75816,1973
45,"Henrico, VA",444754,18800,24733,35242,811839,1779,779,36421,977883,48847,6010,979662,403506,118735,49088,162995,1875,49626,42354,48561,46686,352774,1973
46,"Henry + Martinsville, VA*",318674,13563,17455,27216,248718,1744,1445,27171,312927,20034,4276,314671,-42785,39886,26067,73590,3641,21479,31063,42347,38706,266132,1973
47,"Highland, VA",5352,181,193,250,5548,1601,1432,306,7016,1058,3494,8617,502,1768,1301,2466,613,2490,318,1148,535,2544,1973
48,"Isle of Wight, VA",80630,3156,4859,6430,71376,6027,5209,6371,84826,4654,4581,90853,-2883,12469,7008,19831,1475,9863,8074,9885,8410,62693,1973
49,"James City + Williamsburg, VA*",134126,5322,8711,10196,116977,506,356,10420,150273,9486,5225,150779,-6729,25991,7811,28858,1371,9842,13809,17818,16447,110475,1973
50,"King George, VA",72943,650,14065,2110,42615,1331,1108,1705,56956,2223,6741,58287,-28623,13125,2547,8647,1271,3331,15120,6061,4790,54492,1973
51,"King William, VA",27600,1104,1474,2070,28888,2042,1556,2139,35935,2816,4838,37977,3427,5946,3143,7849,717,4372,2509,3504,2787,20719,1973
52,"King and Queen, VA",8757,307,339,380,18332,1929,1623,497,22060,2196,4198,23989,10072,3189,2468,5715,590,3819,529,1624,1034,4409,1973
53,"Lancaster, VA",24306,1055,1177,1630,22458,947,770,1870,38342,4952,4176,39289,22,11032,5799,9408,1115,5722,1992,4261,3146,16592,1973
54,"Lee, VA",34978,1421,2108,2206,41048,4496,4060,2524,63144,5099,3015,67640,8594,7525,19067,22434,2334,9159,3211,6462,4128,22608,1973
55,"Loudoun, VA",158677,5154,12819,9692,220388,7272,4975,10000,300010,16169,7021,307282,71711,73770,13124,43768,3361,21144,17665,18656,15295,119868,1973
56,"Louisa, VA",60704,2576,2249,5030,60769,1445,1095,5091,74868,6220,4798,76313,5156,8841,6703,15904,1278,7315,4764,7093,5815,48625,1973
57,"Lunenburg, VA",30347,1126,1422,2078,32114,4801,4126,2165,37383,3914,3543,42184,3932,5077,4993,11905,1442,8040,2461,5359,3917,19846,1973
58,"Madison, VA",16348,589,688,846,24800,2700,1687,1012,32010,4741,3596,34710,9464,5934,3976,9653,1124,6428,1111,3276,2152,8809,1973
59,"Mathews, VA",11266,513,483,570,21319,614,395,798,33206,4262,4295,33820,10851,7293,5208,7874,808,4657,768,2178,1370,5841,1973
60,"Mecklenburg, VA",99097,3801,5187,7444,85415,10045,8671,7523,101059,9184,3662,111104,-6159,14615,11074,30342,3573,17855,8909,16695,13122,72333,1973
61,"Middlesex, VA",14713,594,692,828,18461,1398,802,1008,26807,4143,4289,28205,4756,5600,4144,6576,833,4945,1106,2691,1858,8662,1973
62,"Montgomery + Radford, VA*",246360,9910,17842,18860,188008,2066,1372,19340,240412,14146,3698,242478,-39012,32065,22405,65568,2847,15518,27272,31994,29147,203570,1973
63,"Nelson, VA",14943,693,772,1026,24000,959,500,1206,34211,3657,2992,35170,10263,5472,5698,11753,869,4157,1285,2708,1839,9501,1973
64,"New Kent, VA",9608,383,436,544,24551,1006,921,655,30615,2338,4845,31621,15598,4658,2412,6526,491,3259,708,1638,1147,5641,1973
65,"Newport News (Independent City), VA",754044,28116,75206,59482,543164,0,0,57857,700763,24732,5017,700763,-153023,106793,50806,139689,4387,24732,104947,82060,77673,624365,1973
66,"Norfolk (Independent City), VA",2027909,63635,287538,158768,1213151,0,0,143019,1682363,64576,5845,1682363,-671739,333787,135425,287805,9261,64576,366922,212095,202834,1596411,1973
67,"Northampton, VA",38027,1426,2178,2604,33608,5330,3410,2728,44930,5173,3326,50260,-1691,8529,8123,15110,1128,8583,3480,6864,5736,25964,1973
68,"Northumberland, VA",19610,795,946,1170,24152,2162,1932,1380,36757,4160,4147,38919,5922,8989,5778,9384,955,6092,1531,3338,2383,11987,1973
69,"Nottoway, VA",51377,1920,3869,4302,45659,3264,2299,4071,58387,4191,4260,61651,-1647,8995,6997,14473,1385,6490,6020,7544,6159,38867,1973
70,"Orange, VA",46856,1904,2079,3330,51656,3505,2471,3569,71956,7409,4863,75461,8369,16646,7159,15516,1549,9880,3744,7374,5825,33232,1973
71,"Page, VA",44770,1897,2215,3632,54104,2279,1953,3713,69377,5877,4023,71656,13047,9375,8177,17811,1376,7830,4031,7085,5709,32909,1973
72,"Patrick, VA",30442,1231,1386,2098,48918,3053,2524,2280,57803,5584,3702,60856,20756,5368,6570,16437,1778,8108,2435,5508,3730,19899,1973
73,"Pittsylvania + Danville, VA*",358249,14736,18635,29100,342657,19218,17012,29286,418651,30517,4011,437869,13694,50577,44635,109167,9091,47529,33185,52129,43038,277535,1973
74,"Portsmouth (Independent City), VA",463979,12011,65408,27766,363507,0,0,25894,509323,16247,4607,509323,-74578,90280,55536,110564,3562,16247,79291,50430,46868,368441,1973
75,"Powhatan, VA",16966,670,981,964,30859,975,501,1152,38258,3556,4138,39233,15045,5421,2953,9482,664,4057,1463,2578,1914,11446,1973
76,"Prince Edward, VA",48678,1934,2765,3506,38734,3420,2901,3687,50144,4212,3452,53564,-6257,8849,5981,15518,1407,7113,4518,8215,6808,37047,1973
77,"Prince George + Hopewell, VA*",230831,6457,33410,15664,139505,1014,653,14289,188259,8488,4256,189273,-77037,35890,13878,44472,1517,9141,41242,23237,21720,180448,1973
78,"Prince William, Manassas + Manassas Park, VA*",457023,15534,54581,35760,608963,1869,1333,33414,805146,35599,5945,807015,185354,172013,26039,135736,5590,36932,72461,46379,40789,347630,1973
79,"Pulaski, VA",84221,3590,4526,6894,93998,1760,995,7037,119327,7860,3776,121087,16814,13416,13673,32065,1446,8855,7973,12848,11402,67393,1973
80,"Rappahannock, VA",10331,377,346,584,15900,1830,1161,669,20913,2771,4364,22743,6238,4503,2340,5211,722,3932,638,2144,1422,5761,1973
81,"Richmond (Independent City), VA",1904931,77861,123970,156610,928629,0,0,156166,1324262,80065,5492,1324262,-820136,236498,159135,241138,21045,80065,202275,226691,205646,1622591,1973
82,"Richmond, VA",21290,838,1312,1434,18751,1667,1404,1555,24840,2699,4176,26507,-984,4489,3267,6347,881,4103,2029,3642,2761,15158,1973
83,"Roanoke (Independent City), VA",559790,24615,30622,51746,352866,0,0,50488,493771,39207,5327,493771,-156436,75292,65613,92698,8352,39207,56495,71476,63124,464088,1973
84,"Roanoke + Salem, VA*",341837,13718,22003,27572,369410,2223,1487,27504,455099,30254,4506,457322,55077,56900,31012,101502,3013,31741,35789,38424,35411,274307,1973
85,"Rockbridge, Buena Vista + Lexington, VA*",87120,3651,5227,6882,82549,2182,1583,7092,110994,7377,3653,113176,2521,17737,12890,30984,1960,8960,8668,12900,10940,69492,1973
86,"Rockingham + Harrisonburg, VA*",245221,9318,13613,17728,233374,22802,18653,18182,271597,27273,4248,294399,6335,38404,22621,69311,6874,45926,22477,35796,28922,176818,1973
87,"Russell, VA",57819,2367,4164,4656,63170,3789,3116,4695,84401,6097,3332,88190,10046,8148,16872,26465,2086,9213,6492,8159,6073,42114,1973
88,"Scott, VA",25572,1004,1255,1324,57351,5299,5066,1666,71415,4867,3086,76714,33445,7772,11591,24855,1967,9933,1917,4604,2637,13722,1973
89,"Shenandoah, VA",74871,2952,3600,5382,81545,7765,6099,5643,100201,9654,4409,107966,12317,15461,10960,24486,2700,15753,6291,11828,9128,52827,1973
90,"Smyth, VA",84211,3485,4453,6426,78754,4073,3090,6698,103214,10136,3282,107287,1241,12972,15561,32687,2562,13226,7666,14104,11542,63319,1973
91,"Southampton + Franklin, VA*",54964,1975,2734,3364,68899,10067,8320,3657,85617,6251,3779,95684,17592,15787,10998,25322,2243,14571,4416,9729,7486,35977,1973
92,"Spotsylvania + Fredericksburg, VA*",130448,5469,7020,9898,149688,1587,1232,10418,196675,15848,5593,198262,29658,34522,14052,35451,3365,17080,11969,19289,15924,101399,1973
93,"Stafford, VA",33155,1352,1544,1852,133346,739,604,2278,178468,10316,6377,179207,102469,39053,6808,28100,885,10920,2470,4378,3493,19765,1973
94,"Suffolk (Independent City), VA",144785,5890,8824,11448,182369,7058,5677,11614,225495,9488,4823,232553,49198,29099,21085,48218,2594,15165,14548,22029,19435,115072,1973
95,"Surry, VA",10734,345,526,578,14526,2964,2511,634,16887,1212,3420,19851,4426,2924,2401,5804,603,3723,815,1748,1145,6196,1973
96,"Sussex, VA",24759,870,1136,1470,32132,4897,4202,1605,38446,4251,3774,43343,8978,6840,4371,11485,1150,8453,1871,4037,2887,14435,1973
97,"Tazewell, VA",106262,4479,7430,8080,122334,2208,1475,8519,171409,12544,3997,173617,24591,18538,32745,43433,2103,14019,11470,14024,11921,80773,1973
98,Virginia,20494163,727458,1922725,1512050,20091628,350917,275053,1483483,26261793,1446729,5424,26612710,1080948,4583524,1937558,4906648,301375,1721782,2678750,2384496,2083121,16093631,1973
99,"Virginia Beach (Independent City), VA",602239,20219,77493,47418,973833,7230,6203,43928,1289647,46025,6532,1296877,415522,276995,46049,198554,12230,52228,101202,78060,65830,448809,1973
100,"Warren, VA",55774,2348,3416,4248,64663,1183,807,4472,83838,6852,4842,85021,13361,12749,7609,17559,1380,7659,5540,8034,6654,42575,1973
101,"Washington + Bristol, VA*",179464,7258,10663,13448,165766,9562,8015,13982,212857,17512,3707,222419,284,27984,28669,60001,5246,25527,17387,27332,22086,136550,1973
102,"Westmoreland, VA",22769,882,1124,1292,34377,3117,2367,1528,48448,4936,3890,51565,13136,10445,6743,13257,1089,7303,1770,4291,3202,13696,1973
103,"Wise + Norton, VA*",127842,5347,9777,9696,115998,438,330,10195,166258,19296,3858,166696,-1649,16485,34213,43206,1763,19626,14625,14610,12847,93591,1973
104,"Wythe, VA",52690,2170,3164,3816,58335,3039,2011,4078,78281,6394,3514,81320,9723,11502,11483,23143,2085,8405,5072,9438,7353,39213,1973
105,"York + Poquoson, VA*",101355,2180,15185,4746,161759,736,316,4553,213263,8568,5882,213999,64957,43622,8618,36379,1668,8884,17558,10516,8848,74913,1973
0,"Accomack, VA",90036,3364,7470,5592,83634,5736,2571,6160,119125,14370,4087,124861,-242,22485,18742,30551,2921,16941,10266,13912,10991,62829,1974
1,"Albemarle + Charlottesville, VA*",415657,16918,29405,32422,334738,6888,4592,33129,471331,29479,5414,478219,-47790,104431,39050,88330,5770,34071,45616,51059,45289,335970,1974
2,"Alexandria (Independent City), VA",689984,23618,70146,49740,715302,0,0,48488,1009646,29773,9299,1009646,73806,243215,51129,108576,11210,29773,95016,70423,59213,565195,1974
3,"Alleghany + Covington, VA*",108744,4798,6858,11500,82600,349,319,10548,114553,7008,4192,114902,-15596,13066,19236,27411,1226,7327,12608,12214,10988,88809,1974
4,"Amelia, VA",15338,586,712,892,24308,2857,2240,1032,29591,2921,3968,32448,10002,4350,3790,8178,1015,5161,1158,2968,1953,9019,1974
5,"Amherst, VA",62051,2686,3913,4682,80554,1613,1309,5027,104212,7008,3885,105825,23530,13411,11860,27242,1342,8317,6254,8506,7164,47480,1974
6,"Appomattox, VA",25657,1060,1275,1950,34927,2239,1860,2035,43695,4073,4309,45934,11305,5472,5535,10660,1065,5933,2250,4053,2988,17474,1974
7,"Arlington, VA",2144352,55576,320033,136878,1200277,0,0,124015,1738215,65117,11079,1738215,-820060,463484,74454,156886,10816,65117,388472,144590,133774,1690763,1974
8,"Augusta, Staunton + Waynesboro, VA*",379246,16309,22934,30796,332565,9679,7360,31707,425260,31383,4890,434939,-14974,62467,39907,88941,6109,38743,38332,45156,39047,302171,1974
9,"Bath, VA",16287,726,763,1276,16443,847,564,1364,22464,1336,4767,23311,1520,3534,3334,4890,417,1900,1401,2536,2119,12986,1974
10,"Bedford, VA*",76064,3292,4577,5780,122377,5477,4486,6182,158737,9584,4600,164214,52495,24249,17588,35696,3292,14070,7467,12311,9019,54527,1974
11,"Bland, VA",18533,831,850,1594,18198,530,296,1628,22997,1510,4186,23527,1293,2333,2996,5620,573,1806,1647,2362,1789,15080,1974
12,"Botetourt, VA",37117,1592,2068,3290,73377,2122,1185,3237,94277,7159,4736,96399,39497,12550,10472,20356,1526,8344,3713,5479,3953,25060,1974
13,"Brunswick, VA",39252,1486,1842,2600,47396,6443,5461,2786,56522,5856,3929,62965,10930,7811,7758,16027,1709,11317,3142,6314,4605,24793,1974
14,"Buchanan, VA",151334,6162,13028,11140,112303,369,356,11732,151043,30759,4331,151412,-27299,16312,22797,34957,1322,31115,18598,11866,10544,101621,1974
15,"Buckingham, VA",19467,813,1092,1374,27856,1859,1612,1500,36777,3437,3520,38636,9889,5097,5683,10976,983,5049,1779,3244,2261,12639,1974
16,"Campbell + Lynchburg, VA*",564593,24624,35405,48214,377159,4515,3678,48731,502519,40612,4845,507034,-138703,76100,53775,104659,5354,44290,59512,63585,58231,460791,1974
17,"Caroline, VA",33561,1220,2884,2142,58228,2101,1605,2291,73229,5144,4749,75330,26958,10411,6691,15863,1027,6749,3955,4405,3378,22857,1974
18,"Carroll + Galax, VA*",88775,3981,4950,7152,79787,2646,1999,7557,110345,10828,3561,112991,-1431,15013,18191,31733,2855,12827,8526,15036,12181,67422,1974
19,"Charles City, VA",5715,230,309,356,20558,1056,703,408,25910,880,4025,26966,15251,3791,2617,6700,228,1583,487,986,758,3645,1974
20,"Charlotte, VA",26828,970,1196,1572,34144,6620,5868,1756,39403,4281,3736,46023,9072,6006,5873,12320,1998,10149,1982,4858,2860,14697,1974
21,"Chesapeake (Independent City), VA",202981,8731,14084,16526,451449,2684,1072,16994,556782,23275,5459,559466,265462,68647,39370,102487,4253,24347,22347,25863,21610,156287,1974
22,"Chesterfield, VA",372696,14184,31351,27534,545124,906,345,27951,661265,32310,6904,662171,200379,87893,29154,95906,4099,32655,45118,35406,31307,294923,1974
23,"Clarke, VA",29246,1012,1824,1838,34450,3871,2167,1931,45934,4561,5517,49805,7135,11124,4231,9027,1050,6728,2743,4613,3563,19775,1974
24,"Craig, VA",4235,193,292,314,9937,265,211,350,13869,740,3926,14134,6052,2111,2086,3600,376,951,449,968,592,2835,1974
25,"Culpeper, VA",62596,2683,3957,4728,71454,2363,704,5047,97653,7899,4883,100016,13905,18467,10095,20482,1850,8603,6321,9250,7400,47672,1974
26,"Cumberland, VA",8926,342,326,366,18091,1684,1129,525,23651,3418,3555,25335,9690,3552,3692,7126,626,4547,509,1510,884,3870,1974
27,"Dickenson, VA",66146,2726,4578,3960,60457,128,119,4706,83501,22613,4707,83629,-983,7109,16063,17767,632,22732,6558,4730,4098,36856,1974
28,"Dinwiddie, Colonial Heights + Petersburg, VA*",269130,11412,20362,22168,272995,5883,5017,22496,368530,21129,4520,374413,26361,57152,44266,82833,4599,26146,31446,35204,30605,211538,1974
29,"Essex, VA",25792,1051,1434,1822,24434,2468,2082,1962,32243,3513,4198,34711,604,5967,4310,8268,812,5595,2345,3890,3078,17852,1974
30,"Fairfax, Fairfax City + Falls Church, VA*",2282946,78906,217982,161462,3707098,1357,686,159637,4706941,160970,8627,4708298,1583789,856180,145020,545753,31656,161656,298713,212657,181001,1822577,1974
31,"Fauquier, VA",109130,3666,11554,7310,146197,8524,5277,7321,199989,13749,6955,208513,44388,50466,11850,29979,3005,19026,15209,13994,10989,74895,1974
32,"Floyd, VA",16894,743,724,1004,31429,1580,1309,1245,40651,5272,4054,42231,15780,5422,5380,10418,1278,6581,1226,3019,1741,9087,1974
33,"Fluvanna, VA",16875,710,839,1188,26046,1617,1038,1304,34713,3173,4296,36330,10475,5916,4368,8456,633,4211,1433,2705,2072,11231,1974
34,"Franklin, VA",77214,3204,3978,5904,101544,6454,4822,6156,125367,10803,4209,131821,30486,16575,13702,31320,2926,15625,6930,11753,8827,54659,1974
35,"Frederick + Winchester, VA*",216581,9372,12587,17902,186227,5440,2724,18323,238407,20208,5014,243847,-12031,35912,21708,48632,3893,22932,21538,27138,23245,172111,1974
36,"Giles, VA",51843,2306,3543,4470,49536,560,398,4541,67180,4730,4008,67740,2234,7997,10207,16901,1010,5128,5778,6453,5443,40937,1974
37,"Gloucester, VA",31320,1413,1759,1934,65425,556,476,2380,91170,7383,5329,91726,36485,18204,8097,17213,1424,7859,2726,4746,3322,20735,1974
38,"Goochland, VA",20179,834,1080,1216,41113,1390,987,1442,52970,4602,5014,54360,22376,8583,4664,10841,763,5589,1688,2875,2112,12902,1974
39,"Grayson, VA",30373,1376,1479,2514,42098,1857,1431,2633,55660,3762,3601,57517,14358,6624,8795,15972,1419,5193,2736,5809,4390,22444,1974
40,"Greene, VA",6852,320,323,320,17610,91,-36,480,23613,2893,4051,23704,11238,3516,2578,5852,487,2857,483,1154,667,3512,1974
41,"Greensville + Emporia, VA*",47388,2015,2757,3678,42917,2584,2163,3854,56305,5073,3877,58889,-617,7104,8868,15188,1227,7236,4596,7093,5866,35556,1974
42,"Halifax, VA",114310,4397,5590,8322,120214,18025,16286,8558,139439,10833,4207,157464,14462,17827,19423,37430,4704,27119,9751,17108,12404,77440,1974
43,"Hampton (Independent City), VA",600710,16729,92121,41734,522857,0,0,37596,702686,17313,5452,702686,-40257,128002,51827,128895,3629,17313,112988,55244,51615,470409,1974
44,"Hanover, VA",124656,5447,6041,9536,198540,3705,2443,10215,247707,17717,5720,251412,84099,36646,16226,43951,3147,20160,10809,15774,12627,93687,1974
45,"Henrico, VA",534651,23378,30447,44306,900486,1827,702,45531,1115226,51235,6580,1117053,411366,156798,59769,169770,2133,51937,52600,54093,51960,430114,1974
46,"Henry + Martinsville, VA*",338982,14975,19778,30338,262822,1512,1190,30144,338077,20387,4563,339589,-46016,45379,31388,74426,3647,21577,34947,41851,38204,282458,1974
47,"Highland, VA",4747,207,230,294,4970,675,478,354,7874,1090,3540,8549,577,2015,1564,2415,586,1568,377,1149,563,2802,1974
48,"Isle of Wight, VA",87341,3673,5736,7420,76978,3328,2414,7383,96069,4782,4961,99397,-2980,14016,8403,20036,1466,7196,9446,10199,8733,70699,1974
49,"James City + Williamsburg, VA*",148984,6158,10264,11704,124322,115,-45,12010,162290,9843,5486,162405,-12652,28344,9739,29605,1531,9798,16116,18405,16874,123070,1974
50,"King George, VA",77307,748,15046,2536,45909,1121,846,2016,62185,2303,7130,63306,-29382,14285,3112,8879,1482,3149,16314,6262,4780,57844,1974
51,"King William, VA",31666,1322,1789,2410,33049,2290,1757,2527,41506,2943,5363,43796,3910,6959,3788,8166,703,4700,2994,3617,2914,23972,1974
52,"King and Queen, VA",7879,335,373,392,18787,909,548,531,24768,2337,4419,25677,11439,3872,3018,5811,590,2885,569,1584,994,4425,1974
53,"Lancaster, VA",27264,1240,1402,1898,25069,1160,971,2189,43773,5222,4728,44933,-6,13088,6776,9503,1137,6193,2351,4445,3308,18720,1974
54,"Lee, VA",39635,1721,2580,2694,48216,4038,3590,3068,74724,5905,3417,78762,11649,9407,21139,23050,2283,9495,3927,6567,4284,26213,1974
55,"Loudoun, VA",168925,5738,14518,10752,248054,6716,4180,11114,336561,17095,7235,343277,90243,79301,15922,47449,3901,21275,19894,19537,15636,127756,1974
56,"Louisa, VA",53426,2366,2269,4346,57259,1513,1141,4539,74135,6397,4562,75648,8372,10367,8022,16583,1277,7538,4442,6121,4844,41446,1974
57,"Lunenburg, VA",33492,1253,1652,2332,35638,6079,5313,2419,41395,4075,3926,47474,4565,5825,6011,12091,1441,9388,2818,5459,4018,21286,1974
58,"Madison, VA",16766,684,762,956,26551,1763,588,1162,36254,5548,3851,38017,10947,6637,4829,9873,1162,6136,1240,3268,2106,9390,1974
59,"Mathews, VA",11906,583,541,656,22882,365,124,911,36920,4729,4659,37285,11887,8278,6125,8003,866,4853,869,2201,1335,6184,1974
60,"Mecklenburg, VA",107853,4279,5830,8360,93379,11630,10154,8459,112292,9632,4109,123922,-6015,16981,13562,30160,3373,19786,10010,16368,12995,78057,1974
61,"Middlesex, VA",15067,690,823,996,19531,496,-214,1188,30457,4189,4608,30953,5652,6596,4826,6717,851,3975,1321,2799,1948,9771,1974
62,"Montgomery + Radford, VA*",267337,11185,20613,21490,206144,985,250,21930,268976,14708,3926,269961,-39263,37298,26519,68756,3013,14958,31358,32837,29824,221021,1974
63,"Nelson, VA",16567,782,884,1240,27513,1097,630,1402,39720,3800,3441,40817,12348,6346,6958,11862,883,4430,1504,2750,1867,10633,1974
64,"New Kent, VA",10044,440,508,634,28354,660,567,757,36023,2376,5214,36683,19067,5327,3002,7036,510,2943,825,1638,1128,6276,1974
65,"Newport News (Independent City), VA",804836,30975,84053,66046,582981,0,0,63998,766819,25611,5443,766819,-157857,123751,60087,140892,5184,25611,117076,82095,76911,662149,1974
66,"Norfolk (Independent City), VA",2271367,74391,330317,185750,1323681,0,0,167266,1864636,64664,6462,1864636,-780420,381339,159616,288557,10032,64664,423192,220857,210825,1783511,1974
67,"Northampton, VA",43140,1671,2551,3120,37529,5899,3796,3231,50954,5681,3829,56853,-2380,9668,9656,14849,1187,9477,4111,6966,5779,29552,1974
68,"Northumberland, VA",21877,928,1077,1320,27251,2562,2308,1588,42361,4742,4779,44923,6962,10894,6778,9400,980,7050,1737,3345,2365,13090,1974
69,"Nottoway, VA",53502,2008,4201,5160,47821,1718,520,4588,64606,4338,4604,66324,-1093,10084,8419,14407,1341,4858,6781,7616,6275,41863,1974
70,"Orange, VA",51500,2200,2474,3934,56071,3504,2317,4167,77973,7600,5075,81477,8738,16830,8576,16056,1630,9917,4441,7654,6024,37142,1974
71,"Page, VA",46356,2084,2557,4154,56677,304,-70,4161,77270,6054,4217,77574,14482,11017,9880,18395,1404,5984,4634,7192,5788,35738,1974
72,"Patrick, VA",33047,1399,1610,2356,53327,3479,2882,2577,63810,5868,4026,67289,22857,6147,7815,16713,1808,8750,2788,5595,3787,21509,1974
73,"Pittsylvania + Danville, VA*",403197,16920,21972,33620,386239,27993,25646,33730,469115,31148,4544,497108,16772,58538,52331,109393,8852,56794,38782,52939,44087,307621,1974
74,"Portsmouth (Independent City), VA",514772,13654,75127,32412,393841,0,0,29860,561334,16583,5170,561334,-91071,103511,63982,108583,3846,16583,91333,51245,47399,406856,1974
75,"Powhatan, VA",18811,787,1185,1152,35921,962,438,1363,44948,3616,4594,45910,18473,6506,3483,9993,665,4054,1761,2674,2009,12996,1974
76,"Prince Edward, VA",55241,2284,3269,4124,43496,3963,3407,4346,56943,4268,3785,60906,-7399,10018,7392,16091,1481,7675,5331,8569,7088,42235,1974
77,"Prince George + Hopewell, VA*",251625,7173,37534,17474,151659,1153,756,15910,207467,8884,4821,208620,-84056,40481,16480,43274,1562,9640,46271,23723,22161,195714,1974
78,"Prince William, Manassas + Manassas Park, VA*",502044,18202,59018,40780,688632,1695,1086,38592,904580,38895,6344,906275,225180,185788,31855,142850,6521,39981,79408,48425,41904,382655,1974
79,"Pulaski, VA",91144,4095,5318,8002,100289,429,-465,8096,133095,8293,4010,133524,17241,15974,17261,33299,1516,7828,9319,13280,11764,73997,1974
80,"Rappahannock, VA",10847,437,392,666,16984,1606,855,770,23301,2977,4653,24907,6907,5104,2819,5353,700,3832,725,2099,1399,6290,1974
81,"Richmond (Independent City), VA",2071265,87610,138008,175304,1000343,0,0,175262,1429908,85747,6108,1429908,-895660,250495,179070,234090,23189,85747,225660,230290,207101,1759858,1974
82,"Richmond, VA",23092,943,1484,1616,20756,1996,1683,1751,27094,2796,4602,29090,-585,4562,3772,6321,909,4479,2292,3590,2681,16321,1974
83,"Roanoke (Independent City), VA",602606,26160,34257,59878,383639,0,0,56099,545089,39306,5878,545089,-162868,85442,76008,92731,8951,39306,64196,71987,63036,499104,1974
84,"Roanoke + Salem, VA*",383415,15728,26161,32210,400778,957,101,31833,506767,31871,4915,507724,49196,69189,37757,103311,3526,31972,42266,40932,37406,309177,1974
85,"Rockbridge, Buena Vista + Lexington, VA*",86922,3810,5564,7242,82773,1509,867,7431,116542,7685,3769,118051,3282,19795,15483,31325,2036,8552,9185,12515,10479,69185,1974
86,"Rockingham + Harrisonburg, VA*",243825,10336,15023,19492,230714,7501,2630,20082,296266,27986,4237,303767,6971,45086,27967,71687,6826,30616,24769,35967,29141,188440,1974
87,"Russell, VA",62227,2626,4744,5474,71176,2616,1891,5363,97065,6884,3770,99681,14312,9644,18861,26442,2103,8775,7481,8259,6156,45971,1974
88,"Scott, VA",27444,1202,1500,1620,62332,4082,3852,2012,81544,5513,3436,85626,36900,8972,14322,24918,1940,9365,2310,4668,2728,15769,1974
89,"Shenandoah, VA",80639,3426,4256,6254,89001,6041,4158,6553,113638,10163,4833,119679,14915,17736,12942,24762,2662,14321,7383,12062,9400,58935,1974
90,"Smyth, VA",90968,3954,5105,7286,86010,4064,3038,7597,115060,10037,3598,119124,2639,14818,18296,33110,2510,13075,8748,14313,11803,69145,1974
91,"Southampton + Franklin, VA*",57766,2360,3375,4100,70945,5834,3941,4410,96703,6240,4050,102537,17589,17911,13681,25318,2184,10181,5425,10051,7867,42160,1974
92,"Spotsylvania + Fredericksburg, VA*",146379,6389,8189,11556,169987,1839,1453,12167,221433,17023,5896,223272,35775,36353,16932,37868,3585,18476,13967,20049,16464,113936,1974
93,"Stafford, VA",35760,1600,1638,2172,151305,637,486,2686,203545,10640,6857,204182,118231,44775,8102,29776,836,11126,2724,4537,3701,21910,1974
94,"Suffolk (Independent City), VA",156143,6669,10192,12724,197081,4720,3164,13031,251855,9944,5253,256575,53969,33798,25696,48841,2613,13108,16554,22124,19511,126481,1974
95,"Surry, VA",14178,507,690,910,15953,3170,2710,962,19375,1311,3906,22545,2737,3399,3193,5772,637,4021,1145,1892,1255,9012,1974
96,"Sussex, VA",26261,968,1273,1650,34553,5218,4462,1793,42606,4159,4227,47824,10085,7805,5466,11314,1137,8621,2098,3998,2861,15542,1974
97,"Tazewell, VA",121690,5337,8756,9494,139636,1603,781,10084,196997,15801,4452,198600,28030,23584,35380,44614,2201,16582,13503,14709,12508,91605,1974
98,Virginia,22487701,833712,2146836,1733834,21976124,311379,227244,1700629,29178211,1562463,5924,29489590,1189052,5211967,2301499,4978155,318289,1789707,3013753,2450799,2132510,17684241,1974
99,"Virginia Beach (Independent City), VA",675695,24019,87768,55820,1115265,4145,3137,51929,1489096,48852,7095,1493241,491499,321520,56456,210472,13348,51989,115678,82213,68865,508028,1974
100,"Warren, VA",61197,2694,3922,4898,71411,914,530,5143,94812,7308,5149,95726,15357,14838,9477,18591,1393,7838,6371,8059,6666,46988,1974
101,"Washington + Bristol, VA*",200242,8587,12715,15870,183408,7095,5350,16522,242323,18791,4131,249418,-312,31889,34121,60376,5292,24141,20650,28487,23195,155451,1974
102,"Westmoreland, VA",24740,1069,1365,1584,37683,2239,1407,1861,55834,5121,4383,58073,14804,12276,8114,13251,1106,6528,2157,4482,3376,16055,1974
103,"Wise + Norton, VA*",168286,7117,12116,12526,149693,345,234,13380,208145,34787,4743,208490,-5213,20833,37964,43960,1829,35021,18379,15858,14029,114886,1974
104,"Wythe, VA",57139,2493,3673,4404,63294,2746,1616,4695,87976,6476,3810,90722,10850,13447,13981,23812,2129,8092,5875,9582,7453,43172,1974
105,"York + Poquoson, VA*",99067,2529,14087,5234,176103,624,179,5146,234024,9747,6459,234648,82182,48447,10098,36328,1547,9926,16704,9932,8385,72437,1974
0,"Accomack, VA",100136,3637,9140,6260,91703,7318,4348,6767,132353,14410,4521,139671,-1666,24730,23238,30893,2980,18758,12270,14020,11040,69108,1975
1,"Albemarle + Charlottesville, VA*",446035,18023,36199,34302,363414,3532,1635,35174,523018,32324,5714,526550,-47447,111058,52078,92146,5893,33959,53350,50408,44515,358726,1975
2,"Alexandria (Independent City), VA",819515,26755,98242,61974,804615,0,0,57742,1145513,33801,10588,1145513,42842,275824,65074,108191,11865,33801,129229,75222,63357,656485,1975
3,"Alleghany + Covington, VA*",110401,4812,8423,10990,82449,199,148,10307,120642,7425,4408,120841,-17645,14354,24038,27414,1238,7573,13918,11469,10231,88910,1975
4,"Amelia, VA",15960,595,853,902,25751,3148,2518,1046,32485,2917,4245,35633,10837,5074,4808,8394,1039,5435,1304,2889,1850,9221,1975
5,"Amherst, VA",67122,2885,4901,5158,87328,1086,825,5464,117814,7256,4311,118900,25670,15206,16366,27579,1409,8081,7480,8536,7127,51561,1975
6,"Appomattox, VA",25905,1096,1597,2000,35229,1255,916,2096,47993,4325,4391,49248,11420,6255,7764,11216,1050,5241,2597,3941,2891,18067,1975
7,"Arlington, VA",2272402,57760,351386,155872,1336363,0,0,135696,1918994,73547,12229,1918994,-800343,494461,88170,156925,11370,73547,429322,142917,131547,1769533,1975
8,"Augusta, Staunton + Waynesboro, VA*",387343,16402,28140,30288,342916,9143,6891,31546,459511,34755,5200,468654,-12881,69658,56080,90122,6397,41646,43284,42447,36050,302413,1975
9,"Bath, VA",16770,752,954,1366,17095,575,307,1435,24640,1358,4708,25215,1760,3752,4368,5356,420,1665,1637,2533,2113,13468,1975
10,"Bedford, VA*",77713,3443,5396,5886,124075,2975,2067,6386,171722,10889,4840,174697,52748,27152,23470,36096,3660,12956,8339,12202,8542,56418,1975
11,"Bland, VA",17370,753,1103,1388,19554,811,579,1447,25912,1522,4735,26723,3631,2810,4359,5644,609,2101,1797,2187,1578,13472,1975
12,"Botetourt, VA",39497,1664,2514,3312,80529,2267,1383,3320,104561,8141,5055,106828,44352,13376,12923,21133,1664,9524,4170,5406,3742,25803,1975
13,"Brunswick, VA",36914,1437,2117,2494,46246,5034,4078,2684,61825,5390,4162,66859,12016,9305,11308,16065,1618,9468,3364,5937,4319,24082,1975
14,"Buchanan, VA",204535,8013,22990,13454,149753,287,266,14740,194873,40627,5431,195160,-40042,18580,26827,35936,1317,40893,29717,13175,11858,133925,1975
15,"Buckingham, VA",19215,816,1265,1338,29262,1460,1216,1485,41299,3231,3808,42759,11532,5834,7663,11230,957,4447,1934,3143,2186,12834,1975
16,"Campbell + Lynchburg, VA*",582725,25023,44596,48044,401262,2330,1523,49045,549728,43814,5047,552058,-132418,80137,70659,109384,5467,45337,68618,60757,55290,468770,1975
17,"Caroline, VA",34243,1250,3251,2234,63168,2012,1564,2367,82273,4789,5081,84285,31292,11660,9457,16587,1012,6353,4368,4248,3236,23522,1975
18,"Carroll + Galax, VA*",91384,4027,6008,7144,79617,2839,2172,7599,118834,11780,3734,121673,-4168,16076,25980,32586,2894,13952,9580,14717,11823,67852,1975
19,"Charles City, VA",5556,238,357,384,22302,669,318,430,28978,834,4559,29647,17176,3766,3579,6503,206,1152,549,948,742,3855,1975
20,"Charlotte, VA",24720,951,1283,1514,32650,4912,4110,1708,42219,4215,3738,47131,9638,6794,7687,12608,1817,8325,2040,4429,2612,14355,1975
21,"Chesapeake (Independent City), VA",217930,9217,17286,17472,485832,3741,2263,17953,611742,22939,5855,615483,285855,78175,51476,105119,4087,25202,26022,25155,21068,166706,1975
22,"Chesterfield, VA",402009,15109,37620,29564,647150,1300,748,29891,785295,37239,7713,786595,275032,99362,40083,101986,4606,37987,52402,35256,30650,311620,1975
23,"Clarke, VA",31932,1110,2300,2060,39716,3421,1493,2140,54738,5310,6403,58159,9924,12806,5637,9083,1005,6803,3330,4451,3446,21799,1975
24,"Craig, VA",4566,201,362,336,10388,297,247,369,15317,760,4297,15614,6191,2536,2690,3634,416,1007,530,976,560,3029,1975
25,"Culpeper, VA",68034,2830,4789,4934,78659,3607,2177,5297,107980,8285,5315,111587,15922,20092,12836,20994,1846,10462,7256,9373,7527,50316,1975
26,"Cumberland, VA",9651,379,373,420,19234,1386,851,589,26788,3889,3837,28174,10172,4074,4866,7343,640,4740,583,1589,949,4328,1975
27,"Dickenson, VA",83266,3320,7860,4808,76442,94,82,5724,102838,24830,5748,102932,-1100,8461,18029,17907,668,24912,10264,5201,4533,48090,1975
28,"Dinwiddie, Colonial Heights + Petersburg, VA*",292011,12264,25808,23768,269668,3385,2514,24148,387097,23258,4660,390482,1805,64153,56661,83796,4475,25772,37692,34753,30278,228547,1975
29,"Essex, VA",27069,1147,1922,2024,25700,1114,668,2159,36784,3671,4447,37898,790,6901,5297,8522,763,4339,2934,3900,3137,19796,1975
30,"Fairfax, Fairfax City + Falls Church, VA*",2549818,87092,258207,183646,4042047,1626,928,178915,5168316,186393,9316,5169942,1671144,949514,178381,554946,33993,187321,350030,219896,185903,2012467,1975
31,"Fauquier, VA",94034,3401,8725,6332,151603,5141,2300,6567,210980,14683,7104,216121,64136,49117,15401,30421,2961,16983,11891,12625,9664,65160,1975
32,"Floyd, VA",16000,738,891,1016,31692,684,353,1246,44307,4794,4220,44991,16938,6314,6985,10661,1339,5147,1399,3080,1741,9454,1975
33,"Fluvanna, VA",16549,723,1004,1178,27281,880,406,1312,38855,3379,4456,39735,12044,6650,5804,8918,651,3785,1593,2561,1910,11171,1975
34,"Franklin, VA",75218,3226,4491,5798,100145,3467,1927,6125,134921,11228,4263,138388,31052,18464,19779,32462,2877,13155,7390,11383,8506,54673,1975
35,"Frederick + Winchester, VA*",225019,9589,15785,17848,186947,4696,2177,18513,251480,22508,5157,256176,-19559,39452,29777,49679,3872,24685,24709,26309,22437,175625,1975
36,"Giles, VA",55639,2446,4612,4708,52756,35,-138,4800,75462,5056,4372,75497,1917,8988,13753,17268,1107,4918,6966,6434,5327,43755,1975
37,"Gloucester, VA",34839,1558,2264,2206,71522,288,178,2661,101469,7876,5815,101757,39344,20352,9883,17498,1419,8054,3367,4881,3462,23418,1975
38,"Goochland, VA",21495,874,1304,1300,45538,1438,1043,1524,59193,4936,5436,60631,25567,9060,6033,11154,795,5979,1954,2872,2077,13562,1975
39,"Grayson, VA",27322,1267,1604,2226,40932,1076,592,2380,58979,3897,3792,60055,15990,7252,11871,15837,1486,4489,2717,5234,3748,20116,1975
40,"Greene, VA",7926,328,389,348,19855,818,690,502,26538,3092,4339,27356,12431,4085,3416,6304,506,3782,563,1197,691,3581,1975
41,"Greensville + Emporia, VA*",48791,2075,3324,3740,43410,2068,1627,3945,60453,5060,4015,62521,-1436,7872,11239,15570,1167,6687,5194,6810,5643,36910,1975
42,"Halifax, VA",111720,4400,6879,8208,116202,14037,12216,8504,146654,10911,4272,160691,12986,19419,25070,37618,4348,23127,10983,16240,11892,77610,1975
43,"Hampton (Independent City), VA",611343,17297,93866,46514,538078,0,0,40554,739237,18787,5730,739237,-32711,134577,66582,129001,3606,18787,117123,53063,49457,475433,1975
44,"Hanover, VA",137195,5948,7753,10500,225319,2985,1818,11198,285177,19010,6220,288162,99322,41752,21091,46332,3254,20828,13003,16521,13267,103364,1975
45,"Henrico, VA",596774,25554,41443,48134,966331,1571,592,49621,1216476,57419,7006,1218047,419178,172363,79353,173847,2320,58011,65510,55083,52763,473253,1975
46,"Henry + Martinsville, VA*",331583,14443,23854,29002,258249,830,527,28944,350494,20959,4699,351324,-44390,44891,48184,74771,3610,21486,38355,39418,35808,271742,1975
47,"Highland, VA",4858,202,263,282,5137,849,661,343,8603,1111,3883,9452,622,2256,2059,2434,573,1772,404,1095,522,2682,1975
48,"Isle of Wight, VA",95274,3939,7577,7840,92508,3411,2458,7859,115401,4976,5841,118812,5093,15499,10805,20342,1361,7434,11497,9967,8606,76343,1975
49,"James City + Williamsburg, VA*",172820,7065,13248,13830,133808,314,122,13980,177560,11091,6057,177874,-25032,31565,12501,29369,1516,11213,20163,20259,18743,141444,1975
50,"King George, VA",81813,814,16037,3204,52287,1194,918,2416,70236,2509,7807,71430,-27110,15096,4047,9149,1606,3427,17639,6266,4660,60747,1975
51,"King William, VA",34593,1450,2373,2642,35847,1813,1292,2771,46519,2912,5846,48332,4025,7534,4951,8267,653,4204,3694,3560,2907,26695,1975
52,"King and Queen, VA",7910,320,403,378,20954,1190,868,509,27707,2235,4882,28897,13553,4093,3850,5919,535,3103,592,1416,881,4215,1975
53,"Lancaster, VA",29142,1325,1856,2024,26833,717,514,2337,48956,5662,5092,49673,28,14116,8724,9755,1091,6176,2868,4408,3317,20098,1975
54,"Lee, VA",45562,2019,3896,3152,57637,2025,1553,3595,92050,7056,3916,94075,15670,11849,24589,24023,2310,8609,5472,6805,4495,31481,1975
55,"Loudoun, VA",187134,5984,18926,11688,282810,6018,3558,11828,384569,18504,7765,390587,107504,87748,20029,50298,4386,22062,24770,19954,15568,140302,1975
56,"Louisa, VA",58503,2599,3363,4744,59480,459,80,4971,81822,6317,4905,82281,5948,12041,10760,16775,1281,6397,5735,6116,4835,46371,1975
57,"Lunenburg, VA",32855,1288,2016,2398,35089,4262,3392,2487,45735,4077,4092,49997,4721,7131,7777,12217,1357,7469,3215,5259,3902,22171,1975
58,"Madison, VA",17676,669,878,952,27660,2783,1645,1145,38781,5558,4144,41564,11129,7763,6141,10031,1150,7203,1354,3036,1886,9119,1975
59,"Mathews, VA",13052,618,665,708,24864,574,366,972,41070,4913,5144,41644,12784,9490,7290,8095,931,5279,1019,2289,1358,6754,1975
60,"Mecklenburg, VA",106397,4255,6742,8168,94172,9379,7789,8339,121493,10093,4379,130872,-3886,18847,17853,29889,3066,17882,10826,15136,12070,77689,1975
61,"Middlesex, VA",17407,738,1066,1090,22836,1569,983,1283,34696,4118,5184,36265,6712,7342,6087,6996,864,5101,1611,2877,2013,10695,1975
62,"Montgomery + Radford, VA*",280682,11595,25335,22314,218834,-211,-895,22752,297929,15830,4220,297718,-39096,42465,36419,70547,3158,14935,36492,32369,29211,229255,1975
63,"Nelson, VA",17172,843,1145,1336,29730,159,-277,1511,45737,3919,3782,45896,14069,7317,8849,12136,966,3642,1813,2880,1914,11717,1975
64,"New Kent, VA",10293,453,602,632,32863,575,470,769,42354,2499,5914,42929,23339,6028,4038,7259,515,2969,918,1637,1122,6406,1975
65,"Newport News (Independent City), VA",867150,32677,102273,71346,637812,0,0,68350,845826,28291,5937,845826,-160988,133064,74950,142476,5739,28291,137946,80365,74626,700913,1975
66,"Norfolk (Independent City), VA",2365806,77138,348976,207378,1336160,0,0,180827,1920719,71487,6737,1920719,-848819,393396,191163,285104,10461,71487,452665,214631,204170,1841654,1975
67,"Northampton, VA",42923,1770,3011,3226,36525,3158,1345,3383,57137,6074,4007,60295,-3015,11157,12613,15047,1188,7419,4624,6790,5602,30880,1975
68,"Northumberland, VA",20965,965,1403,1386,27273,534,258,1658,46531,4788,4856,47065,7966,11503,8289,9692,939,5046,2096,3299,2360,13823,1975
69,"Nottoway, VA",56835,2058,4924,5074,52400,3044,1942,4595,71574,4381,5142,74618,160,11147,11071,14512,1223,6323,7461,7480,6257,43051,1975
70,"Orange, VA",46533,2047,2785,3514,54837,1515,479,3804,82421,7773,5159,83936,12108,17860,11239,16269,1681,8252,4542,6922,5241,33739,1975
71,"Page, VA",47900,2051,3012,3968,60725,2007,1596,4035,84857,6488,4656,86864,16860,12368,13771,18658,1442,8084,4996,6820,5378,34820,1975
72,"Patrick, VA",31934,1397,1920,2346,52686,2150,1557,2570,68638,5515,4178,70788,23322,6841,11261,16945,1864,7072,3093,5503,3639,21769,1975
73,"Pittsylvania + Danville, VA*",394846,16559,25965,32128,377417,22825,20368,32623,490736,31897,4628,513561,15194,63652,72492,110959,8244,52265,42029,49837,41593,300552,1975
74,"Portsmouth (Independent City), VA",545717,14268,82060,36170,419093,0,0,32353,605229,18449,5662,605229,-94271,109313,76823,106890,3707,18449,100145,49863,46156,427123,1975
75,"Powhatan, VA",19886,846,1441,1262,40082,428,-7,1477,51581,3887,5035,52009,21673,7469,4458,10330,650,3880,2072,2676,2026,13934,1975
76,"Prince Edward, VA",54786,2317,3973,4176,42514,2026,1438,4405,61830,4527,3942,63856,-7867,10913,10429,16198,1440,5965,6061,8204,6764,42760,1975
77,"Prince George + Hopewell, VA*",270198,7594,42142,20144,162924,633,235,17666,229067,9854,5226,229700,-89608,45231,21545,43950,1519,10089,52214,23426,21907,207895,1975
78,"Prince William, Manassas + Manassas Park, VA*",578212,20821,70959,49772,796750,1504,847,45707,1042284,43573,7021,1043788,264245,203865,43173,148665,7199,44420,95845,51178,43979,437947,1975
79,"Pulaski, VA",95463,4151,6827,8016,106767,1832,1039,8159,145993,8592,4336,147825,19463,18065,22993,34093,1571,9631,10835,12781,11210,74997,1975
80,"Rappahannock, VA",10980,456,473,692,17105,1192,562,802,25452,3082,4798,26644,6927,5792,3747,5553,669,3644,819,2018,1349,6517,1975
81,"Richmond (Independent City), VA",2232182,92783,174508,183664,1111666,0,0,184615,1595861,100550,6970,1595861,-935901,265113,219082,228959,24909,100550,266340,226239,201330,1865292,1975
82,"Richmond, VA",23050,974,1794,1656,21109,910,548,1802,30031,2736,4719,30941,-139,5010,4822,6556,877,3284,2622,3474,2597,17144,1975
83,"Roanoke (Independent City), VA",637754,27198,43702,59956,460710,0,0,57176,647419,43635,6114,647419,-119868,90326,96383,105896,9381,43635,73680,70331,60950,520439,1975
84,"Roanoke + Salem, VA*",410749,16535,32712,33454,387796,1001,235,33262,513972,36425,5703,514973,10309,77574,49603,90298,3980,36660,49439,40239,36259,324650,1975
85,"Rockbridge, Buena Vista + Lexington, VA*",91061,3909,6673,7340,86128,2135,1444,7579,126103,8030,4055,128238,2646,21578,20532,31628,2121,9474,10343,12275,10154,71244,1975
86,"Rockingham + Harrisonburg, VA*",261352,10757,18733,19934,243158,11099,6168,20724,322657,30041,4543,333756,2530,49898,40700,73459,6591,36209,28700,35112,28521,196443,1975
87,"Russell, VA",71538,2956,7370,5850,89555,1878,1211,5881,121520,7649,4531,123398,23898,11641,22202,27236,2214,8860,10295,8395,6181,52383,1975
88,"Scott, VA",28533,1302,1831,1776,65243,2630,2341,2190,92008,6140,3807,94638,38900,11192,18203,24859,2249,8481,2719,5013,2764,17333,1975
89,"Shenandoah, VA",83402,3565,5397,6442,95216,4072,2423,6786,128221,11161,5098,132293,18600,20501,16576,25948,2639,13584,8618,11727,9088,61200,1975
90,"Smyth, VA",92399,4068,6074,7406,90999,1672,682,7771,129655,10678,3989,131327,6371,16346,23982,32920,2484,11360,9777,13618,11134,71262,1975
91,"Southampton + Franklin, VA*",62221,2508,4144,4346,67060,6222,4378,4681,97144,6471,4074,103366,9520,18798,17508,25372,2050,10849,6317,9784,7734,45055,1975
92,"Spotsylvania + Fredericksburg, VA*",156615,6782,10484,12240,176801,685,289,12902,240192,17772,6030,240877,33088,40938,23138,39945,3673,18061,16604,20019,16346,121950,1975
93,"Stafford, VA",42010,1865,2261,2716,174842,225,116,3223,235614,11082,7590,235839,136055,49793,11204,31072,830,11198,3619,5156,4326,27193,1975
94,"Suffolk (Independent City), VA",158393,6729,12044,12484,203201,4118,2664,12971,270403,11326,5604,274521,57779,37422,33898,48985,2504,13990,18286,20290,17786,126117,1975
95,"Surry, VA",20952,709,1194,1350,20898,5027,4598,1384,23954,1206,4618,28981,1330,3859,4224,6275,615,5804,1869,2027,1412,13279,1975
96,"Sussex, VA",26222,991,1534,1662,36112,4566,3884,1822,48036,3664,4607,52602,11712,8839,7651,11417,1056,7548,2365,3836,2780,16309,1975
97,"Tazewell, VA",151837,6459,14209,11448,174918,1225,494,12183,242441,17130,5312,243666,35264,28238,40510,45867,2347,17624,19933,15992,13645,114280,1975
98,Virginia,24107514,882150,2518612,1878736,23742910,260566,179761,1821518,32119209,1706765,6404,32379775,1456914,5689243,2947622,5056385,327025,1886526,3457980,2425437,2098412,18763008,1975
99,"Virginia Beach (Independent City), VA",735225,25525,96826,64202,1221812,12427,11505,57626,1632064,54701,7545,1644491,544213,350220,72459,217967,13714,66206,128927,82656,68942,540092,1975
100,"Warren, VA",58959,2574,4525,4580,75293,344,-43,4864,105331,7809,5499,105675,21198,16701,13681,19216,1395,7766,6815,7725,6330,44378,1975
101,"Washington + Bristol, VA*",218229,9322,16336,17036,193618,4573,2855,17840,268754,20083,4441,273327,-6771,37337,42372,61549,5305,22938,24854,28147,22842,170437,1975
102,"Westmoreland, VA",26000,1132,1760,1688,40109,1793,994,1976,62583,5067,4800,64376,16085,14158,10109,13411,1065,6061,2604,4457,3392,17335,1975
103,"Wise + Norton, VA*",197162,8129,19803,14666,170074,111,25,15462,238860,27129,5272,238971,-11626,24480,44417,45329,1961,27154,27136,17021,15060,142872,1975
104,"Wythe, VA",58402,2563,4548,4420,65684,1435,451,4773,97975,6747,4140,99410,12055,15402,18324,24012,2134,7198,6758,9280,7146,44446,1975
105,"York + Poquoson, VA*",106796,2656,16185,6046,190512,653,200,5679,254561,9976,6956,255214,89395,51519,13183,36688,1377,10176,19208,9710,8333,77412,1975
0,"Accomack, VA",112669,4132,10368,7530,101741,5549,1945,7897,148670,17800,4994,154219,-3031,26770,25708,30878,2860,19745,14133,14709,11849,78791,1976
1,"Albemarle + Charlottesville, VA*",493072,19802,40283,39354,405110,2601,547,39479,583188,40052,6321,585789,-48483,123749,56930,92680,6225,40599,59960,52209,45984,392513,1976
2,"Alexandria (Independent City), VA",887992,29183,101203,68608,864863,0,0,63487,1234064,41310,11500,1234064,40358,297187,72014,107314,12015,41310,135507,76009,63994,711175,1976
3,"Alleghany + Covington, VA*",123005,5325,9388,12628,91774,184,106,11639,133368,8587,4748,133552,-19592,15550,26228,28126,1299,8693,15702,11732,10433,98610,1976
4,"Amelia, VA",17002,658,945,1068,27763,2575,1745,1192,36112,3517,4572,38687,11953,5442,5482,8462,1011,5262,1479,2936,1925,10261,1976
5,"Amherst, VA",74258,3184,5547,5922,96039,766,462,6145,129497,8557,4689,130263,27926,16802,17422,27780,1494,9019,8508,8824,7330,56731,1976
6,"Appomattox, VA",31577,1318,2011,2616,41267,1311,875,2626,54973,4934,4941,56284,12316,6852,8165,11392,1031,5809,3319,4362,3331,22449,1976
7,"Arlington, VA",2488398,62574,386878,178086,1417144,0,0,151617,2043208,89626,12855,2043208,-919637,530275,95789,158937,11865,89626,475921,144529,132664,1922851,1976
8,"Augusta, Staunton + Waynesboro, VA*",434842,18401,31598,35786,383728,6948,4161,36294,512405,41094,5750,519353,-14820,76531,59094,90316,6556,45255,49491,44035,37479,340096,1976
9,"Bath, VA",18431,827,1092,1558,18477,366,52,1606,26948,1635,5239,27314,1652,4159,4678,5214,413,1687,1871,2522,2109,14873,1976
10,"Bedford, VA*",90588,3973,6256,7130,146702,2582,1508,7538,200546,14344,5541,203128,63652,30488,25938,36657,3796,15852,9821,12923,9127,64915,1976
11,"Bland, VA",12880,561,855,992,19217,799,501,1057,25776,1732,4639,26575,7394,2983,4375,5729,654,2233,1351,1924,1270,9296,1976
12,"Botetourt, VA",46365,1941,2997,4162,90697,1819,753,4022,117959,9701,5539,119778,48354,14785,14296,21623,1706,10454,5078,5728,4022,30833,1976
13,"Brunswick, VA",45576,1683,2615,3156,55455,7564,6340,3261,70250,6219,4862,77814,13140,10140,12219,16006,1542,12559,4193,6401,4859,28824,1976
14,"Buchanan, VA",223477,8844,26964,16524,155574,435,397,17106,204940,28208,5442,205375,-50797,20391,29410,37741,1298,28605,35226,14333,13035,159646,1976
15,"Buckingham, VA",20867,914,1422,1538,32771,827,518,1683,46950,3737,4264,47777,13587,6407,8599,11204,966,4255,2191,3246,2280,14421,1976
16,"Campbell + Lynchburg, VA*",656409,28023,50828,56604,450523,1197,204,56325,613916,51124,5610,615113,-149561,87404,77186,109641,5663,51328,79130,62973,57310,525951,1976
17,"Caroline, VA",37516,1400,3694,2578,68843,1429,899,2689,90749,5748,5435,92178,34016,12697,10638,16959,994,6647,4983,4465,3471,25886,1976
18,"Carroll + Galax, VA*",108365,4753,7322,9170,95099,2231,1371,9338,137263,13640,4256,139494,-3928,17659,26736,32775,3001,15011,11907,15697,12696,81447,1976
19,"Charles City, VA",6138,263,385,432,25058,760,325,479,32444,973,5113,33204,19399,4150,3996,6494,203,1298,601,980,777,4239,1976
20,"Charlotte, VA",27518,1103,1563,1936,36157,3888,2804,2071,48255,4974,4182,52143,10710,7377,8609,12468,1764,7778,2531,4763,2999,17209,1976
21,"Chesapeake (Independent City), VA",252310,10629,19789,21096,544229,2928,1157,21177,686012,30469,6333,688940,313096,86569,58142,108794,4213,31626,30337,26532,22319,190347,1976
22,"Chesterfield, VA",449810,16979,40866,34058,742764,1135,453,34008,897413,45667,8322,898548,326962,110815,44969,107978,5099,46120,57895,37615,32516,345795,1976
23,"Clarke, VA",34413,1229,2618,2456,44143,2191,-491,2457,62134,6455,6937,64325,12187,14123,6059,9273,963,5964,3846,4546,3583,24603,1976
24,"Craig, VA",4969,219,408,394,11386,194,130,416,16788,898,4616,16982,6833,2724,2872,3679,412,1028,605,1001,589,3336,1976
25,"Culpeper, VA",75524,3202,5357,5906,87045,1853,80,6155,121818,9692,5749,123671,17676,22095,14531,21512,1782,9772,8310,9645,7863,57442,1976
26,"Cumberland, VA",9693,417,427,508,20489,478,-186,671,29774,4145,4143,30252,11467,4393,5370,7302,608,3959,681,1583,975,5053,1976
27,"Dickenson, VA",84631,3428,9285,5712,77134,97,79,6284,106528,16550,5632,106625,-1213,9424,20067,18932,662,16629,12141,5461,4799,55861,1976
28,"Dinwiddie, Colonial Heights + Petersburg, VA*",318616,13332,27272,26814,303123,4354,3213,26739,431520,27346,5218,435874,11246,69940,62811,83536,4474,30559,40679,35442,30968,247378,1976
29,"Essex, VA",30535,1283,2174,2368,29254,1182,575,2467,41972,4297,4953,43154,1186,7787,6113,8712,809,4872,3358,4119,3310,22305,1976
30,"Fairfax, Fairfax City + Falls Church, VA*",2897905,100123,282504,219216,4558904,1458,566,209731,5796265,235248,10148,5797723,1870730,1039734,199085,571297,36543,235814,392112,235375,198832,2269979,1976
31,"Fauquier, VA",111546,4014,10665,7932,176875,4809,1547,7980,244277,18962,7915,249086,73309,55114,17097,31470,3159,20509,14631,13699,10540,76406,1976
32,"Floyd, VA",18822,821,1041,1230,36147,1256,797,1436,49480,5470,4711,50736,18761,6884,7705,10769,1432,6267,1656,3269,1837,10899,1976
33,"Fluvanna, VA",18550,809,1178,1384,32352,599,85,1501,45992,4053,4826,46591,15303,7610,6629,9654,720,4138,1870,2722,2002,12542,1976
34,"Franklin, VA",86960,3699,5291,7108,118366,3268,1372,7253,156489,13526,4817,159757,38659,20655,20736,33163,2881,14898,8845,11885,9004,63217,1976
35,"Frederick + Winchester, VA*",260844,11035,18717,21816,213314,3792,765,21943,284838,27406,5717,288630,-25587,43599,31717,50482,4014,28171,29625,27672,23658,203048,1976
36,"Giles, VA",63653,2754,5197,5408,59947,670,441,5458,84119,6239,4813,84789,1752,9982,14860,17618,1130,6680,7901,6727,5597,49072,1976
37,"Gloucester, VA",41435,1817,2648,2712,81677,182,15,3173,114680,9776,6493,114862,43415,21953,11232,17689,1500,9791,4004,5213,3713,27640,1976
38,"Goochland, VA",24357,1000,1473,1532,51827,851,355,1766,68204,6422,6035,69055,29236,10386,6842,11443,791,6777,2239,3003,2212,15341,1976
39,"Grayson, VA",31895,1427,1849,2688,48842,1792,1127,2771,66817,4656,4325,68609,19718,7572,12195,15865,1552,5783,3193,5417,3865,22919,1976
40,"Greene, VA",9159,380,467,444,22087,697,526,602,29816,3549,4559,30513,13530,4586,3840,6693,527,4075,689,1317,790,4395,1976
41,"Greensville + Emporia, VA*",55680,2384,3788,4520,49475,1681,1099,4644,68706,5755,4572,70387,-1561,8636,12276,15395,1062,6854,6048,7036,5974,42778,1976
42,"Halifax, VA",128501,4961,7761,9978,133977,17336,14950,9950,164946,12497,4838,182282,15426,21083,27222,37678,4090,27447,12750,16507,12417,88304,1976
43,"Hampton (Independent City), VA",685459,19564,106198,54924,587477,0,0,47026,809921,23820,6373,809921,-50956,148810,73634,127095,3749,23820,133660,55252,51503,527979,1976
44,"Hanover, VA",155529,6692,8929,12722,253542,2269,906,13053,321705,23361,6809,323974,111066,45905,24527,47580,3412,24267,15290,17370,13958,115972,1976
45,"Henrico, VA",680054,28852,46795,57134,1052934,1494,416,57419,1331859,70578,7508,1333353,430299,190563,89856,177584,2785,70994,75362,58798,56013,533698,1976
46,"Henry + Martinsville, VA*",396071,17121,28332,36786,305790,1049,681,35514,401745,25068,5382,402794,-54767,50805,46199,74844,3669,25749,46725,41814,38145,323597,1976
47,"Highland, VA",5190,218,315,310,5588,622,399,373,9502,1397,4349,10124,771,2482,2054,2328,604,1796,470,1179,575,2924,1976
48,"Isle of Wight, VA",113244,4743,9095,10048,102389,1879,636,9767,129636,6059,6307,131515,-1088,16816,12310,20853,1309,6695,14119,10664,9355,92430,1976
49,"James City + Williamsburg, VA*",198229,8086,14847,16544,150688,483,217,16358,199582,13098,6259,200065,-31183,35119,14258,31966,1653,13315,23119,21950,20297,161795,1976
50,"King George, VA",86579,907,17007,3692,56133,837,492,2753,75927,3256,8096,76764,-27693,16279,4352,9482,1578,3748,18853,6197,4619,63978,1976
51,"King William, VA",39867,1661,2755,3224,40689,1997,1342,3273,52577,3317,6552,54574,4095,8177,5708,8329,657,4659,4367,3673,3016,30841,1976
52,"King and Queen, VA",10447,431,545,616,23648,1036,656,739,31396,2545,5298,32432,13940,4444,4340,6121,473,3201,853,1467,994,6393,1976
53,"Lancaster, VA",33686,1498,2172,2384,30996,650,390,2690,56536,7496,5808,57186,0,16172,10018,9846,1086,7886,3364,4552,3466,22436,1976
54,"Lee, VA",51846,2260,4419,3726,67098,3191,2555,4123,104086,7385,4261,107277,19375,12967,27212,25178,2498,9940,6282,7197,4699,35624,1976
55,"Loudoun, VA",208664,6759,20787,13812,327241,5419,2355,13665,440134,22996,8519,445553,132242,95899,22413,52299,4605,25351,27693,21254,16649,155620,1976
56,"Louisa, VA",103935,4604,5890,9346,80824,-726,-1213,9277,106909,7410,6103,106183,-13834,13326,12033,17399,1271,6197,10563,7827,6556,87175,1976
57,"Lunenburg, VA",38011,1485,2394,3014,39886,4520,3305,2992,51580,4599,4557,56100,4867,7603,8611,12310,1254,7904,3901,5507,4253,26206,1976
58,"Madison, VA",19255,743,1039,1124,30553,2159,753,1305,43657,6556,4594,45816,12603,8636,6627,9974,1124,7309,1601,3171,2047,10345,1976
59,"Mathews, VA",14966,685,763,810,28310,429,202,1090,46103,6076,5674,46532,14434,10201,8021,8201,940,6278,1168,2346,1406,7520,1976
60,"Mecklenburg, VA",121415,4739,7529,9796,107831,12783,10631,9637,135383,11290,4974,148166,-3947,20787,19548,29791,2935,21921,12427,15288,12353,87067,1976
61,"Middlesex, VA",19998,843,1237,1324,26335,1213,576,1505,40330,5226,5970,41543,7842,8275,6933,6959,893,5802,1899,3072,2179,12297,1976
62,"Montgomery + Radford, VA*",305373,12585,26881,24884,243787,517,-282,25027,331209,18779,4643,331726,-36559,47621,40318,71447,3136,18497,39323,32471,29335,247553,1976
63,"Nelson, VA",19109,920,1266,1518,33982,90,-440,1679,51596,4656,4227,51686,16552,7979,9725,12227,1006,4216,2025,3014,2008,12868,1976
64,"New Kent, VA",11705,515,693,746,38244,488,345,888,49143,3039,6595,49631,27427,6826,4561,7526,551,3384,1066,1756,1205,7255,1976
65,"Newport News (Independent City), VA",953340,35638,115443,83034,705267,0,0,77155,934730,34279,6409,934730,-170918,146122,83341,145842,5478,34279,156960,82104,76626,762101,1976
66,"Norfolk (Independent City), VA",2499335,82366,364838,228038,1369096,0,0,196385,1988152,81996,7045,1988152,-933854,409950,209106,282200,10808,81996,478857,213050,202242,1938482,1976
67,"Northampton, VA",47354,1955,3359,3670,39990,2844,765,3790,63650,7137,4357,66494,-3574,12292,14212,15262,1114,7902,5194,6891,5777,34258,1976
68,"Northumberland, VA",23679,1067,1567,1578,30885,470,100,1856,53027,6091,5471,53497,9062,13206,9406,9778,1013,6191,2356,3421,2408,15132,1976
69,"Nottoway, VA",61543,2213,5424,5800,57285,3107,1755,5113,78608,5107,5620,81715,855,12138,12292,14539,1237,6862,8324,7579,6342,46357,1976
70,"Orange, VA",53618,2343,3311,4268,64358,1303,105,4477,95782,9271,5687,97085,15217,20270,12457,17072,1739,9376,5445,7323,5584,38797,1976
71,"Page, VA",54566,2332,3571,4736,69219,1691,1149,4700,95403,7572,5114,97094,19353,13654,14221,18985,1486,8721,5939,7225,5739,39906,1976
72,"Patrick, VA",37202,1630,2363,2980,62393,1934,1183,3120,79295,6012,4795,81229,28311,7543,11293,16942,1940,7195,3853,5951,4011,26154,1976
73,"Pittsylvania + Danville, VA*",445441,18608,28960,38422,430181,23790,20519,37819,554999,37973,5229,578789,22559,70094,78514,110679,7903,58492,48171,50737,42834,338778,1976
74,"Portsmouth (Independent City), VA",596522,15515,90370,41140,450735,0,0,36085,653295,21515,6112,653295,-109702,118330,84230,106884,4249,21515,110940,50789,46540,464067,1976
75,"Powhatan, VA",23102,959,1595,1478,48151,739,261,1698,60973,4812,5665,61712,26747,8311,5250,10894,761,5073,2334,2872,2111,15695,1976
76,"Prince Edward, VA",61745,2637,4633,5054,47800,1031,234,5164,70195,5481,4298,71226,-8781,11933,11493,16572,1395,5715,7160,8577,7182,48870,1976
77,"Prince George + Hopewell, VA*",309418,8884,47992,24338,182142,-236,-747,21053,255673,11197,5425,255437,-106223,49790,23505,47089,1510,10450,60161,24265,22755,238807,1976
78,"Prince William, Manassas + Manassas Park, VA*",560185,20131,66496,48550,880367,1682,811,44406,1142456,48892,7645,1144138,364588,219897,43874,149650,6310,49703,90771,47015,40705,419711,1976
79,"Pulaski, VA",114088,4918,8543,10110,120426,1876,971,9973,163096,10004,4774,164972,16311,19459,25087,34554,1505,10975,13598,13599,12094,89515,1976
80,"Rappahannock, VA",11781,496,533,756,18912,941,260,874,28612,3604,5292,29553,8005,6420,4221,5584,660,3864,911,2068,1408,7006,1976
81,"Richmond (Independent City), VA",2425948,100221,192976,211452,1188555,0,0,205947,1708725,111726,7518,1708725,-1031446,283078,237092,227284,25220,111726,298702,227622,202402,2015520,1976
82,"Richmond, VA",24932,1066,1949,1932,23057,515,8,2032,33498,3042,5130,34013,157,5476,5480,6630,845,3050,2915,3522,2677,18967,1976
83,"Roanoke (Independent City), VA",703580,29673,49173,70044,503045,0,0,64695,708068,48855,6720,708068,-135840,98659,106364,105365,9626,48855,84195,71535,61909,570530,1976
84,"Roanoke + Salem, VA*",461783,18448,36460,39784,440088,679,-193,38340,576777,45707,6293,577456,16645,82852,54516,91757,4059,45514,56352,41310,37251,359917,1976
85,"Rockbridge, Buena Vista + Lexington, VA*",105432,4479,7916,8912,99350,2080,1195,8935,142192,9632,4618,144272,2853,23708,21214,31239,2231,10827,12372,12903,10672,82233,1976
86,"Rockingham + Harrisonburg, VA*",297331,12231,21664,23990,275188,9614,3354,24226,363013,35679,5023,372627,2083,55956,41483,74179,6524,39033,33659,36872,30348,224639,1976
87,"Russell, VA",83883,3490,8569,7152,105795,1929,1127,7066,142424,8697,5000,144353,28978,13365,25193,28873,2293,9824,12145,8946,6653,61914,1976
88,"Scott, VA",32776,1478,2024,2152,72273,3046,2639,2554,101743,7083,4177,104789,42051,12291,20225,25089,2511,9722,3100,5453,2942,19954,1976
89,"Shenandoah, VA",91479,3935,6279,7496,106427,2430,572,7683,144408,13097,5673,146838,22631,22310,18101,25885,2668,13669,10027,12290,9622,67783,1976
90,"Smyth, VA",105495,4623,7086,8878,104540,1510,274,9062,147068,12583,4467,148578,8107,18005,26033,33260,2611,12857,11525,14442,11831,81113,1976
91,"Southampton + Franklin, VA*",67550,2808,4630,5192,73160,4351,1985,5404,107904,7586,4395,112255,11014,19664,19431,25542,1888,9571,7226,9990,8102,50753,1976
92,"Spotsylvania + Fredericksburg, VA*",179864,7699,12154,14596,211282,382,-135,14997,282412,22188,6794,282794,46415,45740,25772,41624,3907,22053,19452,21008,17101,138359,1976
93,"Stafford, VA",51697,2204,3094,3504,193142,-223,-329,3956,257373,13234,7819,257150,145401,51639,12369,32888,884,12905,4846,5796,4912,33946,1976
94,"Suffolk (Independent City), VA",173765,7416,13386,14676,222022,2828,1085,14754,297383,13352,6252,300211,63011,40901,37288,48016,2470,14437,20724,20362,17892,138604,1976
95,"Surry, VA",14427,601,1317,1150,17366,734,185,1176,25215,1340,4151,25949,4115,4052,4531,6251,577,1525,1892,1940,1363,11010,1976
96,"Sussex, VA",27857,1123,1787,2014,39119,2938,2115,2130,54129,4191,5017,57067,13392,9617,8331,11374,981,6306,2794,3903,2922,18757,1976
97,"Tazewell, VA",175899,7505,16626,13954,203088,967,112,14482,279779,19330,5846,280746,41671,32889,44769,48024,2411,19442,23603,16946,14535,132854,1976
98,Virginia,26730974,980230,2764054,2182292,26343703,230528,130326,2071376,35540296,2018237,6969,35770824,1684105,6198193,3228928,5132693,334694,2148563,3855200,2501192,2166498,20727211,1976
99,"Virginia Beach (Independent City), VA",800262,28397,100898,71896,1342282,8300,7200,64345,1797523,72046,8045,1805823,606365,380690,82851,224471,14340,79246,136846,85512,71172,584170,1976
100,"Warren, VA",69177,2994,5194,5538,86393,138,-343,5763,118724,9327,6024,118862,22979,18319,14150,19731,1324,8984,7963,7904,6580,52230,1976
101,"Washington + Bristol, VA*",255074,10814,19294,21028,226458,4255,2064,21328,309840,24190,5051,314095,-7288,41037,46600,62182,5497,26254,29808,30048,24551,199012,1976
102,"Westmoreland, VA",29367,1265,1987,1964,45389,1661,661,2247,70666,6537,5382,72327,18269,15316,11622,13438,1169,7198,2969,4702,3533,19200,1976
103,"Wise + Norton, VA*",228837,9399,22842,17468,193952,119,26,18133,270629,33066,5669,270748,-16752,27431,49365,47758,2032,33092,31576,17926,15894,164169,1976
104,"Wythe, VA",69738,3026,5454,5486,77860,1380,144,5769,112837,8227,4681,114217,13891,16864,19493,24401,2006,8371,8197,9819,7813,53170,1976
105,"York + Poquoson, VA*",116517,2928,17420,6940,215341,690,124,6398,289435,11982,7588,290125,105222,59771,15013,38237,1545,12106,20890,10070,8525,83521,1976
0,"Accomack, VA",122509,4507,12156,8472,108302,4641,1565,8743,161791,17103,5387,166432,-5464,30311,27819,30893,2897,18668,16392,14867,11970,87449,1977
1,"Albemarle + Charlottesville, VA*",542477,21921,46618,44086,440823,1881,309,43964,637389,41132,6831,639270,-57690,138262,60185,93577,6391,41441,68661,53956,47565,432375,1977
2,"Alexandria (Independent City), VA",1024678,32350,121905,76364,932471,0,0,70532,1346466,47269,12683,1346466,-21675,334390,79605,106160,12482,47269,160087,78225,65743,817322,1977
3,"Alleghany + Covington, VA*",138950,5967,11500,14524,103980,151,61,13229,148527,8208,5310,148678,-21741,17271,27427,27997,1306,8269,18762,12276,10970,111919,1977
4,"Amelia, VA",16760,704,1132,1186,29034,1185,443,1297,39807,3500,4833,40992,13571,6129,5829,8482,1001,3943,1725,2918,1917,11092,1977
5,"Amherst, VA",81771,3528,6616,6734,104680,286,49,6895,141756,8547,5133,142042,29804,18931,18431,27675,1500,8596,9983,9203,7703,63192,1977
6,"Appomattox, VA",35282,1498,2614,3124,45765,591,187,3060,61627,4826,5376,62218,13543,7829,8624,11574,1009,5013,4176,4637,3628,26093,1977
7,"Arlington, VA",2722385,69408,420714,190638,1487481,0,0,164727,2174133,101696,13885,2174133,-1070177,585912,100740,156584,12511,101696,516033,149833,137322,2104656,1977
8,"Augusta, Staunton + Waynesboro, VA*",476612,20305,37504,40356,420087,1071,-1372,40483,570034,44077,6308,571105,-16042,85705,65313,90541,6631,42705,57682,45245,38614,376225,1977
9,"Bath, VA",29902,1317,1903,2660,20752,414,143,2647,30149,1617,5968,30563,-6503,4804,5007,5121,412,1760,3233,3033,2621,24909,1977
10,"Bedford, VA*",97881,4319,7291,7878,166956,1388,477,8258,230319,15458,6206,231707,77333,35320,29431,37336,3528,15935,11230,12504,8976,70716,1977
11,"Bland, VA",11601,546,842,970,20124,66,-197,1031,27619,1632,4566,27685,9554,3343,4218,6063,677,1435,1327,1834,1157,8839,1977
12,"Botetourt, VA",51072,2136,3612,4914,101339,1571,655,4593,132468,9698,6069,134039,54860,16741,15959,22085,1843,10353,6069,5851,4008,34650,1977
13,"Brunswick, VA",43414,1698,2927,3218,54833,4936,3882,3307,74103,6323,4973,79039,14726,11326,12880,15894,1489,10205,4536,6099,4610,28673,1977
14,"Buchanan, VA",278136,10653,32067,18762,196056,329,291,20034,250372,57683,6506,250701,-62046,22751,31894,38535,1461,57974,41448,15426,13965,178714,1977
15,"Buckingham, VA",23092,1006,1740,1750,36876,953,671,1881,52599,3653,4767,53552,15665,7242,9434,11234,938,4324,2615,3301,2363,16153,1977
16,"Campbell + Lynchburg, VA*",734143,30990,61837,63956,503288,961,105,62968,684458,53330,6223,685419,-167887,97825,84306,110138,5608,53435,93815,64954,59346,586893,1977
17,"Caroline, VA",38590,1494,4356,2788,74385,-414,-853,2888,100841,5894,5700,100427,38683,14431,11611,17618,964,5041,5750,4504,3540,27799,1977
18,"Carroll + Galax, VA*",119631,5232,9081,10482,107078,1543,769,10473,152883,13723,4667,154426,-2080,19978,27370,33090,3104,14492,14322,16442,13338,90817,1977
19,"Charles City, VA",5416,283,442,484,26702,-388,-781,525,35900,978,5404,35512,21811,4630,4180,6571,195,197,684,953,758,4535,1977
20,"Charlotte, VA",29582,1204,1869,2224,39731,3472,2485,2316,54143,5081,4628,57615,12465,8401,9483,12449,1772,7566,2981,4781,3009,19035,1977
21,"Chesapeake (Independent City), VA",281440,11808,23975,24224,615856,1669,180,23920,773613,33270,6918,775282,358336,98105,61321,112072,4562,33450,36087,27717,23155,211903,1977
22,"Chesterfield, VA",508848,19155,48659,39134,853004,495,-115,38722,1026602,48113,8456,1027097,382878,125009,49084,121469,5420,47998,68226,39936,34516,392624,1977
23,"Clarke, VA",40765,1362,3625,2872,51744,2774,259,2798,71453,7039,7791,74227,13777,16023,6460,9527,999,7298,5061,4655,3656,28406,1977
24,"Craig, VA",4811,232,481,428,12421,-275,-329,446,18821,880,5000,18546,8056,3018,3107,3709,400,551,695,972,572,3565,1977
25,"Culpeper, VA",82984,3530,6560,6678,95354,1180,-376,6869,134863,9759,6206,136043,19239,25032,15657,21920,1911,9383,9899,10145,8234,63702,1977
26,"Cumberland, VA",10661,424,494,580,22631,1349,780,714,31967,3593,4447,33316,12684,4956,5729,7492,613,4373,784,1584,971,5504,1977
27,"Dickenson, VA",118588,4499,10745,6332,110339,174,157,7665,142382,43892,7291,142556,-584,10669,21548,19553,698,44049,13911,5652,4954,60628,1977
28,"Dinwiddie, Colonial Heights + Petersburg, VA*",341236,14278,31824,29114,335455,2852,1832,28835,481095,27785,5889,483947,23054,78268,70224,82176,4497,29617,46381,35475,30978,265238,1977
29,"Essex, VA",30413,1358,2533,2596,30086,-813,-1401,2656,46849,4103,5148,46036,2329,9022,6928,8942,798,2702,3831,4151,3353,23880,1977
30,"Fairfax, Fairfax City + Falls Church, VA*",3242557,112905,316790,245438,5117759,1176,358,235624,6490943,276496,11251,6492119,2110826,1159749,214611,577030,39696,276854,439509,249354,209658,2526194,1977
31,"Fauquier, VA",117069,4346,11318,8414,196214,2874,221,8553,273601,19206,8455,276475,87698,61863,18398,32701,3226,19427,15525,13667,10441,82117,1977
32,"Floyd, VA",21191,920,1297,1486,41021,1280,815,1663,56009,5530,5155,57289,21493,7898,8370,11114,1518,6345,2040,3484,1966,12806,1977
33,"Fluvanna, VA",19916,869,1408,1546,35097,460,70,1642,50790,3989,5293,51250,16823,8905,7248,9683,753,4059,2181,2705,1952,13676,1977
34,"Franklin, VA",95852,4045,6579,7994,134874,3142,1508,8042,177632,14357,5263,180774,47064,23922,21978,34347,3082,15865,10576,12379,9297,69411,1977
35,"Frederick + Winchester, VA*",294119,12363,22824,25182,237195,3204,672,24954,317488,28814,6187,320692,-31970,49734,33763,51837,4226,29486,35415,28781,24555,229218,1977
36,"Giles, VA",71970,3098,6546,6258,67658,158,-60,6227,93832,6390,5323,93990,1915,11342,14990,17656,1184,6330,9675,7000,5816,55965,1977
37,"Gloucester, VA",44843,1979,3146,3124,90490,-112,-285,3541,127432,9508,6986,127320,49188,24431,12399,18224,1619,9223,4708,5567,3948,30912,1977
38,"Goochland, VA",25945,1104,1762,1758,57899,-200,-639,1983,77690,6778,6618,77490,33937,12034,7557,11709,817,6139,2641,3070,2253,17165,1977
39,"Grayson, VA",32300,1423,2102,2696,51993,2189,1543,2771,70825,4679,4506,73014,22464,8284,12737,16204,1657,6222,3450,5346,3689,22628,1977
40,"Greene, VA",8726,390,557,492,24384,53,-96,636,33794,3258,4973,33847,16294,5256,4207,6806,547,3162,803,1370,823,4761,1977
41,"Greensville + Emporia, VA*",58860,2541,4409,4922,52814,899,359,5002,74826,6051,4904,75725,-1044,9751,13160,15441,1058,6410,6870,7131,6073,45580,1977
42,"Halifax, VA",131365,5355,9028,11148,138810,10659,8449,10929,180266,12135,5042,190925,18374,23678,28437,37869,4263,20584,14602,16740,12477,96179,1977
43,"Hampton (Independent City), VA",724310,21095,112607,56974,627780,0,0,49582,867994,25524,6825,867994,-46948,162431,77783,127180,3891,25524,141094,56398,52507,557692,1977
44,"Hanover, VA",171868,7392,10932,14464,284907,1388,221,14624,361912,23499,7397,363300,127663,51317,27076,49117,3560,23720,18164,18287,14727,129984,1977
45,"Henrico, VA",782079,32965,57475,67164,1152184,1066,191,66547,1462641,73441,8303,1463707,436652,215699,95824,176282,3116,73632,91057,64032,60916,617390,1977
46,"Henry + Martinsville, VA*",441320,18872,35472,41582,339049,1118,795,39663,444104,25130,5932,445222,-62608,57908,48265,75051,3808,25925,56263,43107,39299,359132,1977
47,"Highland, VA",5110,246,392,382,6348,-102,-291,437,11594,1360,4843,11492,1675,2879,2265,2373,604,1069,583,1181,577,3458,1977
48,"Isle of Wight, VA",127839,5308,11077,11432,113700,2153,1000,11024,143937,6032,6973,146090,-3115,18903,13487,20950,1284,7032,16793,11009,9725,104014,1977
49,"James City + Williamsburg, VA*",208010,8524,16653,17632,155851,10,-258,17340,212098,13215,6709,212108,-34819,39760,16497,31616,1760,12957,25469,21479,19719,169584,1977
50,"King George, VA",94564,1039,18667,4038,59904,321,10,3058,82700,3185,8569,83021,-31602,18420,4697,9688,1652,3195,20686,6344,4692,70683,1977
51,"King William, VA",44555,1940,3483,3840,43545,-67,-647,3860,59134,3319,6903,59067,2850,9135,6387,8557,644,2672,5403,3873,3229,36480,1977
52,"King and Queen, VA",7672,375,531,494,22343,-415,-722,622,32513,2379,5217,32098,15293,5003,4752,6153,437,1657,778,1279,842,5237,1977
53,"Lancaster, VA",36685,1647,2622,2778,33477,-14,-265,3036,63205,7446,6373,63191,-172,18938,10776,9916,1117,7181,4011,4660,3543,25493,1977
54,"Lee, VA",56634,2455,4983,4070,75721,2945,2373,4490,115831,9196,4656,118776,23577,14465,28590,25510,2546,11569,7018,7235,4689,38047,1977
55,"Loudoun, VA",226678,7429,23426,15510,370683,3284,581,15184,498603,24249,9299,501887,159189,106819,24385,53974,4978,24830,31181,21865,16887,170667,1977
56,"Louisa, VA",103907,4549,6913,9364,82252,-540,-984,9231,111793,7125,6202,111253,-12424,14989,14012,17939,1378,6141,11595,7829,6451,86171,1977
57,"Lunenburg, VA",39770,1562,2865,3284,43892,4154,3009,3204,57490,4433,5093,61644,7326,8447,9305,12103,1202,7442,4507,5355,4153,27821,1977
58,"Madison, VA",19388,787,1212,1262,32143,1115,-116,1418,48016,6444,4913,49131,14173,9973,7015,10000,1141,6328,1843,3084,1943,11217,1977
59,"Mathews, VA",15236,705,858,880,30870,264,84,1145,50456,5812,6204,50720,16779,11448,8402,8176,979,5896,1298,2350,1371,8042,1977
60,"Mecklenburg, VA",127202,5104,9201,10808,112535,8659,6692,10508,149719,11486,5280,158378,-4159,23949,21894,29998,2849,18178,14605,15376,12527,94419,1977
61,"Middlesex, VA",21184,917,1487,1520,28951,654,165,1677,45826,5285,6319,46480,9444,9674,7855,7356,891,5450,2247,3075,2184,13487,1977
62,"Montgomery + Radford, VA*",338908,13920,32210,27866,274068,234,-460,27853,370869,19737,5056,371103,-36987,53996,43039,73393,3368,19277,46143,33391,30023,273488,1977
63,"Nelson, VA",21969,1018,1486,1770,39957,759,301,1903,58694,4546,4877,59453,19891,8947,10549,12191,1064,4847,2371,3095,2031,14751,1977
64,"New Kent, VA",11994,577,836,874,42322,-515,-653,1014,55605,2984,7130,55090,31342,7872,4896,7727,560,2331,1273,1920,1360,8390,1977
65,"Newport News (Independent City), VA",1070144,39598,136250,103168,784623,0,0,91182,1034403,37080,6998,1034403,-194339,161525,88255,147812,5658,37080,187834,85427,79769,845230,1977
66,"Norfolk (Independent City), VA",2777841,92675,415115,249618,1477603,0,0,217484,2157316,88474,7669,2157316,-1082754,460560,219153,281302,11020,88474,539924,221059,210039,2149443,1977
67,"Northampton, VA",48697,2045,3745,3914,40568,2316,664,4002,67288,6715,4578,69604,-4127,14066,14970,15204,1108,7379,5702,6618,5510,35616,1977
68,"Northumberland, VA",24632,1141,1867,1806,32662,-361,-711,2044,58900,5821,5919,58539,10074,15678,10199,9890,1021,5110,2770,3396,2375,16752,1977
69,"Nottoway, VA",64697,2297,6234,6322,60746,2364,1247,5458,86063,5185,5886,88427,1507,13867,13814,15024,1166,6432,9395,7225,6059,48870,1977
70,"Orange, VA",58379,2573,4099,4886,69795,287,-681,5016,106637,9409,6067,106924,16432,23666,13463,17624,1792,8728,6542,7640,5848,43109,1977
71,"Page, VA",59511,2520,4342,5284,77112,1486,951,5162,106968,7623,5648,108454,22763,15616,15726,19201,1481,8574,6984,7347,5866,43953,1977
72,"Patrick, VA",40051,1728,2787,3286,70106,2472,1806,3371,88277,5759,5220,90749,33426,8605,12038,17384,1971,7565,4430,5985,4014,28056,1977
73,"Pittsylvania + Danville, VA*",491291,20755,35536,44160,478807,16582,13599,42835,625369,39475,5787,641951,30351,79486,83658,110926,7751,53074,57616,51692,43941,380601,1977
74,"Portsmouth (Independent City), VA",651796,16788,101228,44218,492935,0,0,38897,713808,21804,6711,713808,-119964,131959,88914,106360,4367,21804,123337,52006,47639,506655,1977
75,"Powhatan, VA",25813,1071,1990,1712,55488,743,377,1927,69753,4860,5958,70496,31602,9380,5628,11832,848,5237,2846,2961,2113,17730,1977
76,"Prince Edward, VA",65746,2786,5377,5408,51564,1234,509,5490,76324,5658,4634,77558,-8692,13433,12561,16737,1344,6167,8081,8544,7200,51498,1977
77,"Prince George + Hopewell, VA*",356822,10262,57426,27662,206370,-230,-684,24093,290094,11039,5879,289864,-126359,57969,25525,49307,1559,10355,71257,25691,24132,275210,1977
78,"Prince William, Manassas + Manassas Park, VA*",570803,21073,65381,48598,990946,1196,399,45372,1271578,47567,8238,1272774,465515,234581,47247,154504,6788,47966,89680,46978,40190,433157,1977
79,"Pulaski, VA",136017,5821,11625,12292,137677,1301,548,11967,184887,10072,5327,186188,13627,21536,26975,34953,1568,10620,17771,14580,13012,107626,1977
80,"Rappahannock, VA",12725,535,652,854,20789,881,355,962,31828,3620,5645,32709,9026,7387,4533,5794,735,3975,1079,2105,1370,7671,1977
81,"Richmond (Independent City), VA",2669259,109312,224421,230414,1321819,0,0,224519,1877937,159073,8358,1877937,-1122921,307638,248480,224694,26651,159073,339628,231076,204425,2170558,1977
82,"Richmond, VA",26331,1155,2281,2150,24418,-215,-695,2230,36704,2933,5373,36489,317,6220,5851,6791,766,2238,3356,3467,2701,20737,1977
83,"Roanoke (Independent City), VA",763926,31906,57568,78356,535786,0,0,71084,755475,49248,7434,755475,-157056,105811,113878,101621,10073,49248,96746,73300,63227,617932,1977
84,"Roanoke + Salem, VA*",516662,20489,42824,45820,497798,979,268,43399,646005,47813,6678,646984,24535,90372,58814,96882,4353,48081,65734,42991,38638,402847,1977
85,"Rockbridge, Buena Vista + Lexington, VA*",114994,4888,9391,10000,110350,1593,749,9888,158143,9880,5031,159736,5244,26691,22695,31748,2309,10629,14391,13176,10867,89974,1977
86,"Rockingham + Harrisonburg, VA*",330996,13453,26452,27074,304550,11548,5858,26990,401455,36141,5498,413003,544,64616,43837,75123,6558,41999,39989,37960,31402,249008,1977
87,"Russell, VA",95875,3925,10069,8284,121445,2557,1879,8067,162061,10261,5557,164618,33637,15676,27497,29623,2406,12140,14211,9352,6946,69524,1977
88,"Scott, VA",36273,1585,2366,2380,81115,4151,3744,2775,112026,7505,4613,116177,47617,13979,21083,25184,2737,11249,3556,5568,2831,21468,1977
89,"Shenandoah, VA",98599,4232,7504,8262,117457,1879,369,8363,161146,13350,6148,163025,27221,25388,20180,26517,2761,13719,11635,12443,9682,73245,1977
90,"Smyth, VA",114932,4984,8523,9744,115708,1774,693,9856,161085,13125,4849,162859,10632,20241,26910,33583,2737,13818,13395,14426,11689,87719,1977
91,"Southampton + Franklin, VA*",78494,3149,5623,6010,84237,7397,5339,6154,119716,7403,4944,127113,11897,21324,21552,25713,1868,12742,8628,10130,8262,57124,1977
92,"Spotsylvania + Fredericksburg, VA*",201734,8659,14478,16748,243830,-128,-601,17033,325266,23884,7248,325138,59129,52715,28593,44857,4282,23283,22852,22387,18105,155599,1977
93,"Stafford, VA",57888,2451,3949,4122,212757,-649,-716,4512,282389,13168,8052,281740,159381,55563,13420,34992,1022,12452,6010,6271,5249,39426,1977
94,"Suffolk (Independent City), VA",183880,7901,15246,15908,240000,1558,67,15855,325715,13628,6723,327273,71975,46256,41017,48680,2423,13695,23200,20042,17619,146985,1977
95,"Surry, VA",16069,604,1505,1154,20183,2214,1738,1181,27259,1423,4836,29473,5295,4427,4863,6095,546,3161,2082,1841,1295,10826,1977
96,"Sussex, VA",30052,1201,2092,2184,43101,3303,2620,2293,59963,4309,5616,63266,15342,10903,9262,11265,905,6929,3184,3739,2834,19939,1977
97,"Tazewell, VA",197900,8329,18823,15544,229087,621,-76,16101,312125,26592,6311,312746,47288,36216,47443,49554,2686,26516,26595,17595,14909,144789,1977
98,Virginia,29632785,1087342,3168446,2430040,29237747,162442,74921,2302362,39468758,2288335,7613,39631200,1907324,6931001,3462452,5205706,349101,2363256,4383466,2584568,2235467,22886063,1977
99,"Virginia Beach (Independent City), VA",898673,32544,115013,79810,1529502,1313,398,72449,2058193,80046,8723,2059506,703278,438278,91726,236094,15596,80444,154918,91913,76317,663311,1977
100,"Warren, VA",81846,3461,7024,6648,99223,137,-294,6785,135208,9310,6648,135345,24162,20842,15280,20358,1388,9016,10348,8490,7102,62482,1977
101,"Washington + Bristol, VA*",281449,11933,23165,23768,252043,2373,449,23817,344963,25817,5492,347336,-5589,46117,49176,63241,5730,26266,35049,30954,25224,220134,1977
102,"Westmoreland, VA",30648,1332,2297,2122,50755,1398,528,2393,79485,6478,5921,80883,22500,17374,12754,13661,1180,7006,3358,4613,3433,20284,1977
103,"Wise + Norton, VA*",300985,11785,26070,19690,257025,174,108,21630,341532,83671,7077,341706,-22330,31252,53429,48283,2129,83779,35915,18410,16281,181291,1977
104,"Wythe, VA",87917,3764,7774,7220,96112,1322,240,7374,134610,8254,5547,135932,15569,19144,20676,24504,2094,8494,11384,10922,8828,68039,1977
105,"York + Poquoson, VA*",127213,3156,19558,7466,235332,577,60,6889,315913,11982,7826,316490,115008,65191,15967,40441,1632,12042,23291,10301,8669,91880,1977
0,"Accomack, VA",147215,5275,13955,10072,128969,9008,4648,10311,185387,21192,6219,194395,-7935,34704,30722,31259,2963,25840,18991,15864,12901,102384,1978
1,"Albemarle + Charlottesville, VA*",629221,25669,54262,52004,503651,5061,3056,51671,722210,51294,7747,727271,-73899,159007,64613,93879,6526,54350,80264,57170,50644,494607,1978
2,"Alexandria (Independent City), VA",1143520,37156,134797,86518,1068339,0,0,80415,1543742,57774,14625,1543742,5234,389263,86140,105553,12843,57774,178056,81835,68992,907690,1978
3,"Alleghany + Covington, VA*",153754,6656,12511,16230,116869,275,144,14771,164827,9792,5763,165102,-22114,19122,29111,28651,1327,9936,20626,12470,11143,123192,1978
4,"Amelia, VA",20079,830,1417,1450,35182,1339,217,1555,47571,4464,5842,48910,16658,7308,6420,8372,986,4681,2142,3028,2042,13256,1978
5,"Amherst, VA",96853,4213,7944,8250,117582,447,107,8338,159380,10146,5651,159827,29067,21921,20324,28284,1498,10253,12069,9909,8411,74531,1978
6,"Appomattox, VA",43053,1812,3232,3920,53429,1159,574,3772,70664,5603,6091,71823,14148,8994,9400,11791,989,6177,5192,4975,3986,31684,1978
7,"Arlington, VA",2920508,76501,441654,198790,1671296,0,0,175896,2443222,122625,15800,2443222,-1073316,664348,107578,154634,13041,122625,541049,149448,136407,2256834,1978
8,"Augusta, Staunton + Waynesboro, VA*",523920,22550,41387,46038,462740,865,-2649,45569,629061,50391,6949,629926,-15611,96678,70508,90646,6700,47742,64406,46008,39308,411772,1978
9,"Bath, VA",57542,2553,3886,5564,27932,-186,-559,5335,39365,1838,7193,39179,-24275,5852,5395,5447,419,1279,6668,4337,3918,49595,1978
10,"Bedford, VA*",112335,4946,8396,9174,195854,1284,20,9533,267421,19721,6880,268705,93052,40785,32066,39054,3265,19741,12983,12482,9217,79611,1978
11,"Bland, VA",12363,572,963,1018,22303,270,-120,1081,30768,1916,4943,31038,11021,3906,4829,6279,691,1796,1472,1856,1165,9095,1978
12,"Botetourt, VA",56178,2337,4046,5324,116198,1855,557,4999,151551,10996,6805,153406,65019,19514,17694,22543,1963,11553,6708,6002,4039,37917,1978
13,"Brunswick, VA",53049,2017,3610,3934,65319,6848,5255,3984,84907,8120,5729,91755,16254,12440,13996,16017,1440,13375,5577,6355,4915,34097,1978
14,"Buchanan, VA",302327,11334,37175,21080,211642,358,294,21874,274937,69877,7157,275295,-68811,26372,37281,38466,1513,70171,47715,15044,13531,184441,1978
15,"Buckingham, VA",26406,1133,2081,2002,42851,1440,1046,2134,60114,4204,5335,61554,18579,8184,10519,11537,914,5250,3082,3320,2406,18074,1978
16,"Campbell + Lynchburg, VA*",835947,35616,68624,75572,571212,1757,511,73402,773658,66097,6918,775415,-191333,108866,95337,112082,6306,66608,106410,68143,61837,662929,1978
17,"Caroline, VA",48062,1734,4816,3246,88519,3382,2763,3357,114670,7347,6552,118052,43814,16697,12836,18019,945,10110,6439,4633,3688,31513,1978
18,"Carroll + Galax, VA*",140047,6075,10639,12610,126979,3140,1980,12380,177592,16579,5396,180732,-688,22916,30837,33492,3204,18559,16944,17172,13968,104544,1978
19,"Charles City, VA",8607,318,537,548,33214,1995,1434,592,41051,1165,6349,43046,25199,5366,4466,6780,190,2599,811,975,785,5197,1978
20,"Charlotte, VA",34885,1372,2188,2592,46758,4708,3190,2668,61793,6434,5255,66501,14541,9452,10291,12656,1787,9624,3484,4864,3077,21777,1978
21,"Chesapeake (Independent City), VA",338863,14236,28130,29644,712675,5240,3139,29058,892570,38917,7883,897810,402870,116373,68762,113891,4890,42056,42952,30512,25622,253855,1978
22,"Chesterfield, VA",606606,23331,55855,48594,1012835,1385,510,47628,1214004,57350,9554,1215389,453857,147183,55371,127211,6014,57860,80152,44639,38625,468594,1978
23,"Clarke, VA",52940,1532,4523,3304,65851,8054,4080,3184,82616,8863,9236,90670,16095,17813,7006,9817,1019,12943,6175,4805,3786,33822,1978
24,"Craig, VA",5537,249,521,474,14609,75,-7,486,21592,973,5682,21667,9558,3498,3560,3813,389,966,758,954,565,3813,1978
25,"Culpeper, VA",101167,4180,8028,8102,114169,4556,2314,8231,156242,11732,7094,160798,21233,29401,17228,22666,2033,14046,12079,10808,8775,75042,1978
26,"Cumberland, VA",12849,504,617,748,26276,1670,824,878,36801,4007,5042,38471,14305,5792,6403,7630,613,4831,991,1679,1066,7027,1978
27,"Dickenson, VA",125300,4588,11590,6626,120992,144,116,7901,156368,52160,7949,156512,3593,11464,24056,19690,719,52276,14903,5285,4566,58121,1978
28,"Dinwiddie, Colonial Heights + Petersburg, VA*",379601,15928,37084,33124,381357,3938,2410,32490,543459,33371,6632,547397,34246,88837,77203,82537,4520,35781,53646,35937,31417,290174,1978
29,"Essex, VA",40846,1523,2720,2970,41555,6127,5235,3008,53644,4923,6568,59771,3717,10527,7689,9101,794,10158,4205,4224,3430,26483,1978
30,"Fairfax, Fairfax City + Falls Church, VA*",3744840,132208,361208,287272,5772904,1408,199,275844,7366234,332455,12393,7367642,2303908,1354690,240048,594490,42470,332654,504844,269448,226978,2907342,1978
31,"Fauquier, VA",141739,5071,13273,9860,233019,6857,3285,10001,317546,22912,9470,324403,101281,70747,20637,34257,3286,26197,18203,14440,11154,97339,1978
32,"Floyd, VA",24791,1053,1535,1784,47528,1771,1074,1945,64521,6381,5766,66292,24682,9421,9343,11497,1586,7455,2427,3658,2072,14909,1978
33,"Fluvanna, VA",22759,981,1578,1788,38368,785,294,1875,55637,4586,5626,56422,17484,10066,7988,10028,768,4880,2472,2780,2012,15407,1978
34,"Franklin, VA",113069,4759,7794,9500,161189,3195,847,9509,210671,19511,6112,213866,57629,27226,25451,34993,3282,20358,12544,13033,9751,80167,1978
35,"Frederick + Winchester, VA*",346550,14364,26472,29936,276747,10159,6495,29332,358929,35328,6902,369088,-40471,55992,36349,53474,4425,41823,41440,30539,26114,263287,1978
36,"Giles, VA",79341,3439,6938,7120,75146,511,196,6999,104738,7244,5844,105249,2804,13477,16626,18009,1233,7440,10498,7100,5867,61403,1978
37,"Gloucester, VA",55070,2313,3808,3750,105264,2103,1837,4188,146699,11650,7819,148802,54382,29642,13896,19030,1755,13487,5683,6123,4368,35900,1978
38,"Goochland, VA",31306,1295,2132,2092,67767,429,-207,2341,90257,8235,7976,90686,38802,14779,8140,11370,837,8028,3178,3232,2395,20100,1978
39,"Grayson, VA",33134,1457,2149,2786,56201,2664,1694,2850,77653,5352,4911,80317,25917,9614,14502,16356,1743,7046,3542,5049,3306,22546,1978
40,"Greene, VA",10669,459,661,626,28981,222,-6,772,39667,3959,5549,39889,19084,6257,4651,7188,565,3953,974,1489,924,5742,1978
41,"Greensville + Emporia, VA*",70401,3019,5295,5962,63488,1633,825,6000,87559,7698,5749,89192,-913,11191,14513,15514,1057,8523,8276,7482,6425,53602,1978
42,"Halifax, VA",151460,5994,10114,12740,160812,17031,13749,12364,201233,14743,5756,218264,21716,26289,31163,37919,4460,28492,16484,17364,12904,106484,1978
43,"Hampton (Independent City), VA",795893,23579,123312,60734,678003,0,0,53946,948395,30850,7532,948395,-63944,185927,84465,125917,4018,30850,153679,58993,54975,611364,1978
44,"Hanover, VA",213677,8998,13708,17954,329618,5801,4210,17975,414852,30087,8289,420653,133916,60625,30410,50751,3697,34297,22685,19498,15801,156695,1978
45,"Henrico, VA",923744,39267,67794,81108,1301031,769,-364,79821,1657285,90849,9270,1658054,457108,248084,108939,178861,3410,90485,108348,70813,67403,724911,1978
46,"Henry + Martinsville, VA*",498862,21563,39435,48612,382365,1330,879,45869,501314,31930,6599,502644,-70628,66250,54029,76168,3938,32809,63741,45053,41115,402312,1978
47,"Highland, VA",6588,296,481,492,9853,188,-80,542,15350,1589,6120,15538,3807,3273,2412,2539,593,1509,727,1256,663,4352,1978
48,"Isle of Wight, VA",138045,5797,11706,12640,125972,2718,1026,12117,160381,7303,7537,163099,44,22102,15025,21641,1278,8329,18026,10778,9500,111690,1978
49,"James City + Williamsburg, VA*",244112,10095,20408,21166,179594,1184,786,20678,244105,16020,7679,245289,-43840,45964,19731,31944,1852,16806,30991,22781,20929,196315,1978
50,"King George, VA",103533,1221,19393,4250,66106,2345,1895,3346,89874,3828,9315,92219,-34081,20856,5257,9900,1675,5723,21518,6250,4575,76292,1978
51,"King William, VA",49923,2036,3645,4052,52202,3593,2746,4062,66694,3989,7932,70287,6341,11073,7012,8861,632,6735,5671,3778,3146,37517,1978
52,"King and Queen, VA",12920,429,666,594,28730,3500,3067,726,36201,2730,6501,39701,16536,5548,5423,6107,409,5797,963,1313,904,6160,1978
53,"Lancaster, VA",46255,1962,3237,3468,42025,2163,1811,3696,73747,8829,7331,75910,-534,21677,12208,10355,1132,10640,4971,5076,3944,30644,1978
54,"Lee, VA",59625,2569,5228,4464,85217,4129,3232,4801,128800,9261,5187,132929,30393,16215,31497,25629,2558,12493,7460,7199,4641,39672,1978
55,"Loudoun, VA",262705,8969,26618,18768,421774,411,-3469,18353,572319,30332,10291,572730,177422,124163,26793,55652,5301,26863,36002,23653,18352,199840,1978
56,"Louisa, VA",85477,3751,6014,7660,80673,195,-448,7581,112201,8570,6166,112396,2777,16839,14884,18229,1477,8122,9844,6914,5437,67511,1978
57,"Lunenburg, VA",45451,1760,3251,3792,49835,5472,3700,3656,64291,5334,5747,69763,8040,9588,10340,12139,1163,9034,5147,5441,4278,31270,1978
58,"Madison, VA",22949,819,1265,1336,38050,3751,1981,1487,52960,7047,5492,56711,16588,10958,7703,10326,1159,9028,1933,3108,1949,11988,1978
59,"Mathews, VA",17674,794,1036,988,35661,367,138,1288,57965,6926,7069,58332,19275,13262,9409,8252,1018,7064,1530,2409,1391,9080,1978
60,"Mecklenburg, VA",143915,5736,10340,12376,128589,11476,8422,11924,168391,14514,5939,179867,-3402,27131,24147,30286,2779,22936,16528,15428,12649,104451,1978
61,"Middlesex, VA",26190,1084,1787,1834,35188,1409,801,2001,53447,6818,7474,54856,10999,11048,8620,7340,899,7619,2704,3266,2367,15867,1978
62,"Montgomery + Radford, VA*",384736,16071,36166,32742,316190,834,-99,32442,424739,23323,5698,425573,-36104,62100,47283,74688,3559,23224,52537,35463,31904,308975,1978
63,"Nelson, VA",28474,1216,1920,2172,50268,2583,1936,2302,69415,5392,5821,71998,24096,10392,11338,12368,1126,7328,3006,3373,2247,18140,1978
64,"New Kent, VA",16751,699,1031,1140,50960,1381,1175,1269,64070,3560,7940,65451,35478,8961,5530,8243,570,4735,1601,2036,1466,10415,1978
65,"Newport News (Independent City), VA",1145847,42975,141185,111230,849468,0,0,98590,1133630,45503,7596,1133630,-197789,185380,98782,149249,5814,45503,196800,85692,79878,903544,1978
66,"Norfolk (Independent City), VA",3085519,105174,460539,270168,1605962,0,0,240258,2374386,100859,8567,2374386,-1239299,534308,234116,277161,11577,100859,595623,228730,217153,2389037,1978
67,"Northampton, VA",59202,2364,4478,4552,48607,5570,3307,4640,75076,7938,5243,80646,-5955,15872,16167,15382,1113,11245,6754,6921,5808,41203,1978
68,"Northumberland, VA",31852,1291,2099,2086,41564,3296,2777,2334,67185,7082,7144,70481,12046,17308,11609,9866,1045,9859,3142,3486,2441,18851,1978
69,"Nottoway, VA",73193,2590,6830,7082,69402,4169,2539,6131,95875,6154,6781,100044,2340,15468,15174,14753,1094,8693,10371,7392,6298,54129,1978
70,"Orange, VA",70365,3035,4914,5974,82392,1406,79,6022,122149,11720,7020,123555,18049,26290,14873,17600,1838,11799,7901,8171,6333,50665,1978
71,"Page, VA",66808,2864,5071,6066,87074,944,191,5897,121132,9107,6264,122076,26163,17811,17191,19487,1471,9298,8104,7598,6127,49406,1978
72,"Patrick, VA",46122,1947,3226,3820,81746,3673,2694,3857,101843,6865,6014,105516,39481,10171,13599,17544,1990,9559,5136,6124,4134,31427,1978
73,"Pittsylvania + Danville, VA*",551217,23302,40383,50632,543962,20923,16378,48618,704177,49560,6497,725100,41363,87488,93650,111605,7631,65938,65699,52516,44885,419580,1978
74,"Portsmouth (Independent City), VA",734695,18869,114376,48382,542673,0,0,43060,789325,26223,7437,789325,-148962,150744,95908,106128,4761,26223,138567,54297,49536,569905,1978
75,"Powhatan, VA",31079,1296,2490,2164,65342,690,212,2378,81989,5882,6519,82679,36641,11143,6194,12683,927,6094,3572,3295,2368,21413,1978
76,"Prince Edward, VA",70583,3026,5908,6040,56243,1096,-10,6046,83973,6603,5171,85069,-8294,14706,14120,16451,1291,6593,8928,8567,7276,55062,1978
77,"Prince George + Hopewell, VA*",385077,11369,61127,29284,224394,848,167,26011,318836,13104,6476,319684,-134672,67888,27402,49361,1599,13271,75769,26225,24626,296037,1978
78,"Prince William, Manassas + Manassas Park, VA*",650901,24422,75921,55500,1177351,-798,-2018,52172,1508681,57921,9349,1507883,578622,277320,53212,161284,7251,55903,103671,51118,43867,491327,1978
79,"Pulaski, VA",162359,6979,14011,15200,157069,1856,858,14579,209868,11916,5918,211724,9289,24634,30021,35779,1619,12774,21611,15516,13897,127974,1978
80,"Rappahannock, VA",13190,590,723,954,22567,47,-628,1067,36402,4199,6157,36449,10444,8937,4945,5920,793,3571,1200,2159,1366,8419,1978
81,"Richmond (Independent City), VA",2973751,122896,261424,263568,1448064,0,0,254680,2061391,181563,9344,2061391,-1271007,345334,267993,220614,27430,181563,393208,236373,208943,2398980,1978
82,"Richmond, VA",33398,1288,2589,2440,31562,3733,2985,2508,41444,3771,6586,45177,672,7082,6533,6860,694,6756,3809,3458,2764,22833,1978
83,"Roanoke (Independent City), VA",855324,35954,65591,88238,603253,0,0,80073,842914,58966,8177,842914,-171998,114277,125384,103081,10457,58966,109710,75643,65186,686648,1978
84,"Roanoke + Salem, VA*",587846,23425,48999,53168,568475,2274,1293,50009,736336,57372,7727,738610,30638,103900,66235,95591,4608,58665,75583,44885,40277,453598,1978
85,"Rockbridge, Buena Vista + Lexington, VA*",128206,5561,10623,11794,125872,95,-1118,11458,180729,12180,5650,180824,9124,30356,24596,32005,2376,11062,16520,13558,11182,100624,1978
86,"Rockingham + Harrisonburg, VA*",373714,15243,29718,31292,341151,13969,5738,30889,448457,43465,6038,462426,-1674,72758,48517,76581,6599,49203,45364,38530,31931,279147,1978
87,"Russell, VA",107791,4387,11749,9698,135002,3586,2624,9236,181609,11461,6035,185195,36447,18365,31828,30688,2482,14085,16598,9497,7015,77108,1978
88,"Scott, VA",47214,1995,3407,3262,91211,5411,4787,3626,125177,8894,5197,130588,47623,16014,23363,25129,2914,13681,5038,6364,3450,28495,1978
89,"Shenandoah, VA",116927,5007,8968,10098,138317,2008,0,10056,188072,16524,7026,190080,31446,29620,22143,27054,2838,16524,14017,13179,10341,86386,1978
90,"Smyth, VA",139258,6003,10502,12200,138748,2773,1204,12103,189147,16252,5672,191920,11593,23464,29708,33837,2845,17456,16602,15778,12933,105200,1978
91,"Southampton + Franklin, VA*",83585,3594,6590,7008,88278,2738,-334,7098,133862,8878,5170,136600,11791,24943,23379,26424,1846,8544,10094,10293,8447,64947,1978
92,"Spotsylvania + Fredericksburg, VA*",224023,9617,15987,18840,278974,991,288,19037,372457,29237,7856,373448,73988,60843,33631,47538,4648,29525,25407,23090,18442,169091,1978
93,"Stafford, VA",69325,2897,4814,5070,245859,-94,-167,5432,327953,15716,8706,327859,181966,66095,15905,37657,1171,15549,7349,6957,5786,46427,1978
94,"Suffolk (Independent City), VA",206446,8982,17122,18460,267974,1053,-1054,18212,364203,16508,7083,365256,79740,53385,43897,51571,2402,15454,26352,20494,18092,164640,1978
95,"Surry, VA",22750,976,2093,2006,20597,458,-245,1979,30935,1635,5153,31393,-174,5528,5268,6092,514,1390,3096,2082,1568,18264,1978
96,"Sussex, VA",30927,1333,2338,2382,45814,1077,108,2524,66769,5739,6119,67846,17411,12246,9786,11087,836,5847,3529,3528,2692,21551,1978
97,"Tazewell, VA",209656,8781,20825,17032,241083,2275,1308,17297,334686,28291,6680,336961,48724,40609,55269,50446,2800,29599,29341,17781,14981,150716,1978
98,Virginia,33472938,1241396,3552753,2764584,33161978,283406,157040,2623688,44706986,2730885,8514,44990392,2312728,8004785,3823629,5284122,362865,2887925,4935045,2697755,2334890,25649968,1978
99,"Virginia Beach (Independent City), VA",1065473,39201,136583,92310,1802065,2532,1248,85356,2431753,99310,9973,2434285,821948,528446,103774,244086,16764,100558,182738,100688,83924,782177,1978
100,"Warren, VA",91117,3852,7568,7528,111222,1069,445,7616,150928,11026,7219,151997,27721,23785,16990,21056,1457,11471,11332,8864,7407,68314,1978
101,"Washington + Bristol, VA*",319592,13603,26305,27802,289739,3558,698,27504,393229,31080,6166,396787,-2349,52812,54236,64353,5924,31778,40206,32172,26248,247608,1978
102,"Westmoreland, VA",39790,1530,2727,2500,62896,5910,4641,2780,91260,7716,7018,97170,25886,20009,14265,13845,1144,12357,3977,4778,3634,23456,1978
103,"Wise + Norton, VA*",337265,13157,33156,24222,279396,175,91,25268,375031,81286,7669,375206,-32601,36137,59673,48924,2146,81377,45267,19001,16855,210621,1978
104,"Wythe, VA",100669,4264,8953,8402,110953,3079,1521,8465,152974,9748,6181,156053,18749,22163,22937,25248,2181,11269,13154,11392,9211,76246,1978
105,"York + Poquoson, VA*",148674,3894,22255,9050,267182,455,-283,8419,361816,14625,8629,362271,126927,77136,17953,41984,1764,14342,26780,11214,9450,107552,1978
0,"Accomack, VA",153820,6223,15466,11678,131135,189,-4339,12062,205830,23423,6552,206019,-10623,40095,34789,31443,2931,19084,21305,15615,12684,113431,1979
1,"Albemarle + Charlottesville, VA*",721074,30899,64109,61742,553921,5210,2626,61770,790255,55402,8360,795465,-105383,167828,73716,95155,6745,58028,94980,60601,53856,568066,1979
2,"Alexandria (Independent City), VA",1224148,43056,140992,97736,1172420,0,0,91924,1685435,64075,16412,1685435,40196,416889,96126,102697,12883,64075,189860,83790,70907,970213,1979
3,"Alleghany + Covington, VA*",174641,7931,14717,18722,134838,557,422,17292,189699,10235,6584,190256,-22511,22226,33192,28898,1403,10657,24078,12636,11233,139906,1979
4,"Amelia, VA",20858,996,1623,1714,39056,-577,-1813,1853,55455,5105,6511,54878,20051,8577,7245,8428,936,3292,2480,2967,2031,15086,1979
5,"Amherst, VA",134428,6083,11059,12146,130914,1257,891,12156,179597,10702,6252,180854,8642,26967,22973,28927,1508,11593,17132,11712,10204,105703,1979
6,"Appomattox, VA",45058,2010,3560,4242,57352,1259,660,4131,77223,5017,6452,78482,16425,10365,10765,12164,964,5677,5681,4856,3892,33700,1979
7,"Arlington, VA",3173170,87677,476364,222838,1820143,0,0,199096,2674122,131918,17352,2674122,-1153931,731815,122164,154108,12925,131918,587783,150909,137984,2453469,1979
8,"Augusta, Staunton + Waynesboro, VA*",574948,25966,47663,51974,511329,2181,-1865,51953,696598,51320,7689,698779,-11666,105967,81483,90886,6689,49455,73650,46584,39895,451843,1979
9,"Bath, VA",99604,4615,6608,10102,32740,-86,-460,9666,46361,1930,8225,46275,-57198,7389,6146,5626,421,1470,11659,5833,5412,86475,1979
10,"Bedford, VA*",132069,6062,10310,11294,228904,2420,955,11709,309412,20126,7749,311832,108544,46914,36014,40243,3403,21081,15957,13384,9981,95031,1979
11,"Bland, VA",15472,691,1165,1226,26945,1281,862,1304,35472,2249,5749,36753,12777,4232,5576,6393,692,3111,1778,1914,1222,10583,1979
12,"Botetourt, VA",63303,2777,4726,6112,130907,2142,801,5833,171695,11632,7547,173837,73437,23381,19549,23035,1928,12433,7782,6133,4205,43088,1979
13,"Brunswick, VA",55830,2379,4161,4580,68717,3904,2159,4669,95034,8907,6166,98938,17556,14173,16048,16045,1372,11066,6451,6359,4987,38313,1979
14,"Buchanan, VA",356219,14210,45763,25184,243246,404,351,26802,317935,76352,8322,318339,-86171,31566,43527,38251,1477,76703,58355,15722,14245,221161,1979
15,"Buckingham, VA",30709,1409,2569,2510,49307,807,403,2664,70717,4575,6094,71524,21262,10125,12092,11737,890,4978,3824,3379,2489,21907,1979
16,"Campbell + Lynchburg, VA*",917718,41184,77966,85222,639200,845,-468,83795,871760,69966,7755,872605,-194723,123287,110118,112521,6405,69498,120577,69092,62687,727643,1979
17,"Caroline, VA",51110,2112,5535,3918,96071,-61,-753,4071,130077,8035,7071,130016,49032,19567,14378,18388,918,7282,7494,4838,3920,36334,1979
18,"Carroll + Galax, VA*",149707,6802,11884,13704,137104,4339,3098,13654,196016,16202,5955,200355,1051,26180,37071,33647,3212,19300,18736,17094,13882,111671,1979
19,"Charles City, VA",7820,373,659,654,35986,296,-263,700,46862,1233,6996,47158,28866,6088,5084,6741,197,970,986,976,779,5864,1979
20,"Charlotte, VA",38388,1677,2578,3138,51909,3076,1432,3246,71180,7244,5984,74256,16767,10710,11637,12410,1700,8676,4147,4845,3145,25565,1979
21,"Chesapeake (Independent City), VA",372040,16754,32365,34390,780734,-1994,-4177,33949,994600,42074,8670,992606,442643,132686,79186,114490,4834,37897,49560,31638,26804,284583,1979
22,"Chesterfield, VA",716587,29241,67214,60004,1191101,409,-399,59243,1433151,63448,10688,1433560,533757,179248,63211,134129,6215,63049,97216,48472,42257,556322,1979
23,"Clarke, VA",62413,1991,5563,4086,77417,7283,3455,4034,99032,10339,10611,106315,19038,20809,8089,10019,998,13794,7606,5061,4063,41013,1979
24,"Craig, VA",6138,272,560,518,16940,470,367,531,24617,941,6523,25087,11333,4241,3906,3846,377,1308,819,918,541,4011,1979
25,"Culpeper, VA",117809,5079,10035,9760,130976,5447,3002,9959,178957,12853,8057,184404,23126,33575,19853,22887,2038,15855,14915,11168,9130,87039,1979
26,"Cumberland, VA",12694,590,721,864,28758,389,-499,1022,42574,4220,5646,42963,17086,6675,7530,7609,592,3721,1153,1655,1063,7820,1979
27,"Dickenson, VA",147487,5792,14926,8138,141664,162,132,9861,183948,57099,9121,184110,4038,12958,29488,20186,733,57231,18995,5791,5058,71261,1979
28,"Dinwiddie, Colonial Heights + Petersburg, VA*",401619,17998,39685,37038,415103,-1681,-3178,36517,606680,35036,7429,604999,50001,100241,89655,81441,4331,31858,58204,35531,31200,311557,1979
29,"Essex, VA",38419,1706,3117,3236,40661,1406,448,3324,58906,5258,6653,60312,5566,10747,8904,9066,789,5706,4735,4261,3472,27978,1979
30,"Fairfax, Fairfax City + Falls Church, VA*",4364490,163209,419998,349994,6613580,1521,244,338206,8414747,368893,13830,8416268,2587296,1530368,272320,608559,43208,369137,594995,288040,244832,3400358,1979
31,"Fauquier, VA",156683,5761,15772,11246,264718,6340,2348,11384,364449,23744,10547,370789,119419,82372,23699,35157,3404,26092,21395,14689,11285,109196,1979
32,"Floyd, VA",27028,1171,1678,1886,52935,2659,1880,2114,72081,7020,6488,74740,28021,11124,10681,11519,1608,8900,2621,3635,2027,15507,1979
33,"Fluvanna, VA",24321,1113,1805,2014,42229,629,103,2120,62700,4728,6257,63329,20028,11905,9195,10122,784,4831,2812,2863,2079,16678,1979
34,"Franklin, VA",117347,5292,8507,10332,175290,2113,-548,10458,235080,19616,6618,237193,68401,32213,29690,35841,3250,19068,13673,12922,9672,84606,1979
35,"Frederick + Winchester, VA*",378730,16562,30543,33752,296186,10266,6408,33438,390332,35988,7361,400598,-49106,61930,42482,54422,4310,42396,47419,30816,26506,288915,1979
36,"Giles, VA",91182,4131,8477,8484,84497,848,510,8373,118341,7251,6605,119189,1688,15717,18975,18044,1213,7761,12719,7386,6173,70702,1979
37,"Gloucester, VA",59610,2748,4536,4492,113080,-108,-431,4994,164086,12166,8297,163978,58464,34871,16027,19764,1721,11735,6782,6571,4850,41093,1979
38,"Goochland, VA",34949,1583,2644,2586,76272,-810,-1472,2876,104304,8790,8807,103494,44199,17900,9322,11751,825,7318,3937,3403,2578,23694,1979
39,"Grayson, VA",38588,1749,2527,3332,64996,3682,2698,3415,89954,5532,5789,93636,29823,11887,16753,16174,1702,8230,4193,5118,3416,26165,1979
40,"Greene, VA",12104,552,793,792,33679,294,69,948,46388,3966,6296,46682,22523,7559,5444,7414,570,4035,1189,1498,928,6880,1979
41,"Greensville + Emporia, VA*",77039,3617,6265,6992,68482,-1688,-2549,7113,99667,9012,6279,97979,-1444,12247,17250,15604,1025,6463,9761,7648,6623,60815,1979
42,"Halifax, VA",155165,6903,11642,14268,165774,7869,4465,14037,225514,15258,6156,233383,24646,31692,35917,37911,4445,19723,18776,17656,13211,116666,1979
43,"Hampton (Independent City), VA",867057,27209,135394,69254,719148,0,0,61836,1020117,32812,8216,1020117,-86073,205169,95800,124169,4056,32812,170021,60354,56298,664224,1979
44,"Hanover, VA",255309,11447,17820,22704,372379,3991,2292,22799,474652,31928,9363,478643,139869,71199,35065,51122,3680,34220,29172,21473,17793,191917,1979
45,"Henrico, VA",1098237,49269,83083,100212,1463504,-289,-1302,99375,1883457,97306,10486,1883168,464642,293655,126009,179581,3237,96004,133189,77145,73908,869044,1979
46,"Henry + Martinsville, VA*",537864,24414,45331,53270,408459,1289,823,51049,543329,32630,7081,544618,-78356,73732,62427,76913,3889,33453,71966,44815,40926,432445,1979
47,"Highland, VA",7860,354,531,588,14817,622,331,648,20521,1665,7753,21143,7605,3561,2765,2727,585,1996,825,1264,679,5039,1979
48,"Isle of Wight, VA",153886,6937,14477,14788,138541,-966,-2745,14331,182637,8016,8295,181671,-1014,25404,17726,21902,1255,5271,21871,11591,10336,126744,1979
49,"James City + Williamsburg, VA*",289297,12643,24700,26262,206734,901,474,25774,279450,17246,8678,280351,-56789,49236,24381,32305,1950,17720,37831,24382,22432,233746,1979
50,"King George, VA",113338,1516,21254,5014,71189,950,506,4023,100505,4186,9933,101455,-38126,24227,6039,10214,1614,4692,23761,6296,4682,84885,1979
51,"King William, VA",51488,2320,4180,4470,56348,998,115,4555,76638,4451,8516,77636,9415,13162,8126,9117,623,4566,6415,3672,3049,40507,1979
52,"King and Queen, VA",10870,498,807,696,27985,491,22,846,39808,2882,6613,40299,17961,6278,6036,6094,386,2904,1155,1288,902,6811,1979
53,"Lancaster, VA",47728,2224,3556,3854,43062,531,198,4151,81141,9228,7883,81672,-515,24722,13888,10360,1122,9426,5483,5016,3894,32819,1979
54,"Lee, VA",61474,2859,5735,4924,94118,2685,1731,5321,148107,9393,5796,150792,37965,18647,38027,26018,2611,11124,8197,7276,4665,42153,1979
55,"Loudoun, VA",298113,10938,30611,22624,478713,-1771,-5714,22250,652019,32481,11525,650248,202850,140175,31360,56423,5152,26767,41923,24740,19588,229423,1979
56,"Louisa, VA",81076,3742,6034,7366,89518,409,-279,7425,125245,8984,6896,125654,15867,19183,16953,18220,1386,8705,9717,6349,4963,62654,1979
57,"Lunenburg, VA",44452,1922,3521,3944,49448,3066,1302,3894,69376,5541,5941,72442,8890,11221,11773,12193,1153,6843,5493,5254,4101,32116,1979
58,"Madison, VA",25250,939,1397,1498,43208,4598,2861,1688,59710,7293,6238,64308,19646,12179,8921,10309,1130,10154,2146,3050,1920,12950,1979
59,"Mathews, VA",18940,913,1244,1120,39004,-4,-247,1473,65283,7512,8055,65279,21537,15642,10633,8104,996,7265,1804,2392,1396,9871,1979
60,"Mecklenburg, VA",148194,6513,11417,13642,132625,5796,2556,13334,186117,15512,6369,191913,-2235,31543,27745,30133,2718,18068,18238,15480,12762,111888,1979
61,"Middlesex, VA",27873,1288,2067,2194,37926,-44,-873,2385,60705,7319,8140,60661,12438,13013,9722,7452,922,6446,3164,3374,2452,18263,1979
62,"Montgomery + Radford, VA*",426792,18631,42029,37442,353665,1909,858,37352,478819,23663,6338,480728,-35775,71986,55077,75847,3652,24521,60750,36843,33191,341521,1979
63,"Nelson, VA",31427,1410,2210,2558,60662,2699,1788,2689,83066,5605,6887,85765,31924,12374,12729,12453,1096,7393,3489,3638,2542,20545,1979
64,"New Kent, VA",16769,824,1211,1350,56582,-444,-651,1499,74105,3749,8807,73661,41312,10591,6488,8364,556,3098,1886,2077,1521,11785,1979
65,"Newport News (Independent City), VA",1194014,47112,145904,115574,935605,0,0,104899,1255833,48861,8497,1255833,-153510,206774,113454,147796,5810,48861,203691,81849,76039,941462,1979
66,"Norfolk (Independent City), VA",3324687,119269,498484,302324,1665487,0,0,270431,2508458,103253,9316,2508458,-1388769,581540,261431,269274,12047,103253,649646,229124,217077,2571788,1979
67,"Northampton, VA",60404,2705,5295,5164,47568,1497,-831,5287,83000,8792,5608,84497,-7549,18174,18755,15067,1120,7961,7877,7011,5891,44566,1979
68,"Northumberland, VA",31010,1479,2387,2368,41903,-28,-542,2663,74278,7483,7543,74250,13556,19254,13093,9844,1011,6941,3571,3450,2439,20498,1979
69,"Nottoway, VA",76400,2990,7406,7928,73486,1580,-7,6954,106514,6524,7360,108094,4040,17352,17256,14687,1120,6517,11370,7337,6217,58513,1979
70,"Orange, VA",76714,3499,5558,6756,91911,1166,-390,6877,137406,12889,7713,138572,22074,29440,17221,17965,1810,12499,8936,8188,6378,55279,1979
71,"Page, VA",68424,3191,5538,6578,93004,-1207,-2122,6480,134031,9592,6856,132824,31060,20670,19150,19374,1502,7470,8827,7603,6101,52127,1979
72,"Patrick, VA",50296,2288,3763,4334,91049,2472,1446,4455,116770,8012,6748,119242,45208,12229,15964,17670,1995,9458,5930,6237,4242,34908,1979
73,"Pittsylvania + Danville, VA*",605232,27421,46074,58176,600109,11754,6987,56509,791357,53494,7151,803111,51386,97038,105964,112314,7687,60481,75162,53187,45500,469589,1979
74,"Portsmouth (Independent City), VA",787924,21600,123662,54692,600400,0,0,48946,877861,27728,8369,877861,-138578,167876,109585,104893,4674,27728,151008,54860,50186,609188,1979
75,"Powhatan, VA",36051,1569,3177,2674,74834,679,-35,2906,94799,6369,7413,95478,41689,13538,7106,12880,866,6334,4514,3509,2643,25203,1979
76,"Prince Edward, VA",80752,3625,6775,7196,64010,1414,230,7223,95596,7270,5898,97010,-9519,16801,16199,16449,1262,7500,10373,8868,7606,62879,1979
77,"Prince George + Hopewell, VA*",428573,13300,69874,34186,246145,-1639,-2312,30393,356924,13738,7192,355285,-152035,77371,31769,49400,1586,11426,86967,27066,25480,330180,1979
78,"Prince William, Manassas + Manassas Park, VA*",727771,28829,84406,64496,1321028,-1124,-2332,61077,1689769,61328,10290,1688645,654334,306000,61617,164099,7493,58996,116654,53612,46119,552121,1979
79,"Pulaski, VA",178407,8037,16429,17034,167399,2360,1219,16554,229533,11120,6449,231893,5546,28647,35847,35958,1735,12339,24946,15796,14061,141122,1979
80,"Rappahannock, VA",15039,682,848,1082,25792,620,-207,1223,41562,4501,6932,42182,11976,10697,5693,6085,784,4294,1389,2209,1425,9356,1979
81,"Richmond (Independent City), VA",3241147,141028,294750,298290,1583429,0,0,290173,2279479,170956,10291,2279479,-1367545,392989,303061,221502,27444,170956,443895,236927,209483,2626296,1979
82,"Richmond, VA",33490,1495,2876,2782,31788,753,89,2886,46992,4124,6965,47745,1184,8578,7379,6855,690,4213,4267,3424,2734,25010,1979
83,"Roanoke (Independent City), VA",935600,41468,73793,99140,604242,0,0,91038,866505,61214,8497,866505,-240320,123186,139077,101981,10372,61214,123363,75509,65137,751023,1979
84,"Roanoke + Salem, VA*",647968,27297,56111,60588,649977,1151,232,57591,848438,57596,8744,849589,59600,125335,74277,97166,4659,57828,86405,46080,41421,503735,1979
85,"Rockbridge, Buena Vista + Lexington, VA*",144389,6502,12289,13526,147327,1537,247,13265,208349,12831,6523,209886,16203,34268,28291,32177,2351,13078,19052,13578,11227,112259,1979
86,"Rockingham + Harrisonburg, VA*",422362,18259,35565,36972,377762,11896,2778,36745,508411,46704,6769,520307,-7855,87727,54818,76866,6937,49482,54051,40432,33495,318829,1979
87,"Russell, VA",118230,5115,13940,10934,153576,2036,845,10582,211162,12241,6793,213198,45928,21936,37686,31384,2457,13086,19407,9796,7339,85737,1979
88,"Scott, VA",50339,2337,4159,3858,95293,3289,2626,4266,137592,9081,5569,140881,49220,18082,27506,25296,2942,11707,6088,6612,3670,32544,1979
89,"Shenandoah, VA",129645,5746,10262,11356,154645,4082,1705,11424,210540,17635,7841,214622,36424,34958,25019,27373,2921,19340,15940,13307,10386,94365,1979
90,"Smyth, VA",151634,6910,11837,13704,151060,2199,578,13762,210582,16952,6304,212781,13188,26894,34827,33752,2865,17530,18689,15372,12507,115415,1979
91,"Southampton + Franklin, VA*",84511,4102,7458,7868,86248,-3403,-6431,8036,144687,9169,5435,141284,9773,28005,27031,25995,1799,2738,11392,10089,8290,70381,1979
92,"Spotsylvania + Fredericksburg, VA*",245906,11208,18173,21588,313870,-289,-1081,22002,415609,30661,8427,415320,89966,62948,38502,49283,4483,29580,28967,23557,19074,187359,1979
93,"Stafford, VA",80170,3563,5728,6248,276523,-553,-691,6687,369155,17434,9386,368602,203040,73553,18526,39270,1161,16743,8852,7263,6102,54575,1979
94,"Suffolk (Independent City), VA",222606,10357,19275,20910,283963,-2892,-5215,20812,397442,17611,8006,394550,82169,60031,50556,49284,2450,12396,29730,20392,17942,180480,1979
95,"Surry, VA",62522,2950,4493,6404,22163,-1347,-2024,6152,36251,1807,5784,34904,-34207,6860,5881,6035,505,-217,7695,3463,2958,55044,1979
96,"Sussex, VA",30074,1461,2487,2546,47601,-953,-1985,2734,74711,5908,6711,73758,20261,14682,11475,10991,797,3923,3760,3378,2581,22391,1979
97,"Tazewell, VA",242168,10582,25379,20066,278035,4179,3208,20615,386504,28996,7698,390683,56482,46428,66220,50753,2947,32204,35412,18517,15570,174552,1979
98,Virginia,37101589,1460131,3994416,3186772,36782507,149065,13820,3053517,50032962,2889250,9425,50182027,2734435,9011907,4387613,5324533,364258,2903070,5587802,2767118,2402860,28610717,1979
99,"Virginia Beach (Independent City), VA",1201576,46842,154884,108934,2026765,-2364,-3716,101309,2741923,108245,10770,2739559,926498,590739,122055,254368,17000,104529,209351,105749,88749,887696,1979
100,"Warren, VA",100583,4454,8845,8620,122997,1276,652,8764,168337,11371,8045,169613,31178,27072,19544,21083,1424,12023,13155,8935,7511,75405,1979
101,"Washington + Bristol, VA*",347942,15790,30396,31638,316824,-1369,-4587,31609,442210,33355,6796,440841,491,60249,63768,64865,5784,28768,46215,32692,26908,272959,1979
102,"Westmoreland, VA",41304,1815,3318,2964,67937,2874,1379,3297,104449,8564,7714,107323,29930,22710,16676,13913,1155,9943,4800,4944,3789,26561,1979
103,"Wise + Norton, VA*",383870,15918,40760,28720,307307,197,111,30278,422703,81349,8707,422900,-46285,42877,72716,48568,2266,81460,55120,20343,18077,247290,1979
104,"Wythe, VA",110600,4884,9937,9400,122463,4212,2537,9584,171124,10561,6940,175336,21447,25878,26995,25263,2181,13098,14637,11240,9059,82865,1979
105,"York + Poquoson, VA*",165425,4696,24662,10740,296131,644,-162,10066,404466,15649,9413,405110,140772,88316,20663,43037,1826,15487,30032,11865,10039,119906,1979
0,"Accomack, VA",161756,6732,16868,12214,134224,191,-4304,12839,224719,24402,7188,224910,-14693,49348,41338,31288,2930,20098,22975,15484,12554,118683,1980
1,"Albemarle + Charlottesville, VA*",813211,35453,74543,71280,613591,2917,-154,71093,902664,59299,9427,905581,-128527,205433,86557,96067,6748,59145,110183,62992,56244,643883,1980
2,"Alexandria (Independent City), VA",1327487,48453,151767,106320,1324819,0,0,101613,1914996,67895,18481,1914996,98945,479009,111168,103620,12653,67895,204927,83531,70878,1054665,1980
3,"Alleghany + Covington, VA*",183384,8466,16176,19242,137875,464,331,18087,204935,10354,7248,205399,-27422,26384,41140,28337,1436,10685,25797,12398,10962,146902,1980
4,"Amelia, VA",21415,1088,1804,1812,42314,-1231,-2531,1994,62302,5075,7268,61071,22893,10046,8711,8403,872,2544,2710,2903,2031,16161,1980
5,"Amherst, VA",122425,5643,10626,11002,129365,1012,634,11144,189558,11414,6543,190570,18084,33064,28141,29128,1501,12048,16127,10384,8883,94250,1980
6,"Appomattox, VA",47679,2201,3976,4450,61844,587,2,4426,87289,5924,7327,87876,18591,12693,13339,11994,932,5926,6201,4671,3739,35552,1980
7,"Arlington, VA",3635406,103639,547689,258624,2020989,0,0,232951,2991213,141262,19504,2991213,-1381466,832879,137345,153363,12558,141262,677001,156375,143817,2817143,1980
8,"Augusta, Staunton + Waynesboro, VA*",638416,29446,55046,57774,553613,741,-3668,58333,774214,53365,8513,774955,-26470,124748,96594,91031,6546,49697,83933,47059,40513,504786,1980
9,"Bath, VA",64936,3053,4758,6380,32636,13,-342,6243,48737,1889,8426,48750,-26057,8100,8014,5786,424,1547,7948,4268,3844,55441,1980
10,"Bedford, VA*",144504,6874,12244,12318,259560,267,-1337,13033,361880,21327,8799,362147,128089,59576,43011,41157,3439,19990,18403,13529,10090,106111,1980
11,"Bland, VA",16292,742,1293,1324,29606,1358,930,1404,40191,2122,6505,41549,14718,5272,6671,6387,684,3052,1955,1884,1200,11285,1980
12,"Botetourt, VA",69540,3245,5538,7266,144504,-419,-1745,6878,197566,12113,8457,197147,81842,29533,23110,23311,1865,10368,9171,6193,4328,50001,1980
13,"Brunswick, VA",53924,2465,4456,4546,68567,1750,-79,4738,104148,8574,6793,105898,19381,17467,19864,15589,1307,8495,6729,6139,4832,38700,1980
14,"Buchanan, VA",367829,15224,55052,28500,234856,392,354,29474,321163,48064,8471,321555,-103499,37554,49145,37960,1437,48418,69302,15580,14143,250109,1980
15,"Buckingham, VA",27906,1369,2484,2190,51185,16,-377,2464,78162,4826,6657,78178,25743,12308,14685,11743,862,4449,3579,3127,2265,19878,1980
16,"Campbell + Lynchburg, VA*",995298,45536,87800,91338,675812,-1046,-2370,91205,967543,73696,8602,966497,-228281,154697,135988,112357,6422,71326,133469,68889,62467,790503,1980
17,"Caroline, VA",55638,2358,6185,4226,107342,177,-559,4471,148816,8482,8319,148993,56175,24126,17525,17909,899,7923,8298,4731,3832,39417,1980
18,"Carroll + Galax, VA*",154852,7250,12918,14114,146401,3400,2131,14307,220340,16505,6618,223740,5856,32429,44910,33806,3171,18636,19975,16492,13321,116241,1980
19,"Charles City, VA",7921,402,781,658,41356,-275,-806,731,54962,1215,8159,54687,34166,7236,6095,6703,210,409,1110,1068,858,6402,1980
20,"Charlotte, VA",35933,1726,2760,3100,51515,884,-818,3276,78277,6704,6461,79161,18858,13497,14149,12253,1603,5886,4310,4701,3098,25737,1980
21,"Chesapeake (Independent City), VA",413749,18977,36846,36950,885318,-469,-2639,37452,1143563,44039,9946,1143094,509021,159412,98364,114933,4629,41400,55321,32181,27552,317028,1980
22,"Chesterfield, VA",812767,33718,79677,67872,1378731,277,-422,67654,1680033,67057,11769,1680310,633618,223831,77748,142775,6075,66635,113613,50509,44434,632519,1980
23,"Clarke, VA",62806,2230,6398,4446,82352,2836,-664,4453,113672,9564,11650,116508,23999,24291,9865,10001,967,8900,8621,5197,4230,45285,1980
24,"Craig, VA",6762,304,640,538,18815,585,465,573,28245,1011,7288,28830,12626,5353,4662,3956,366,1476,909,924,558,4377,1980
25,"Culpeper, VA",126221,5681,12259,10738,141095,2371,-169,11050,203864,12750,9076,206235,25924,41008,24132,22722,1994,12581,17628,11209,9215,96012,1980
26,"Cumberland, VA",12803,657,860,920,30223,-413,-1305,1117,48206,4221,6075,47793,18537,8559,9011,7867,566,2916,1320,1757,1191,8567,1980
27,"Dickenson, VA",134231,5647,18049,9126,127055,49,21,10210,178223,31504,9000,178272,3034,17908,33309,19808,753,31525,22612,5887,5134,80094,1980
28,"Dinwiddie, Colonial Heights + Petersburg, VA*",428629,19616,43497,39584,459099,-2594,-3996,39408,692402,34430,8611,689808,69878,120816,109893,80105,4030,30434,63289,34453,30423,334906,1980
29,"Essex, VA",40955,1946,3724,3524,43461,-397,-1378,3708,68342,5702,7654,67945,6214,13700,10784,8877,772,4324,5486,4265,3493,31145,1980
30,"Fairfax, Fairfax City + Falls Church, VA*",5023909,193622,482064,400594,7690774,1110,-179,393919,9829150,400921,15566,9830260,3060784,1819311,320175,631502,42596,400742,682361,303107,260511,3940806,1980
31,"Fauquier, VA",164729,6349,17633,11914,294739,2748,-1496,12306,417330,25384,11646,420078,142316,96252,29087,36070,3384,23888,23590,14502,11118,117251,1980
32,"Floyd, VA",29282,1339,1938,2100,58020,2550,1721,2389,82714,6916,7353,85264,31127,14120,13124,11596,1627,8637,2988,3745,2118,17657,1980
33,"Fluvanna, VA",26505,1272,2136,2220,46169,269,-270,2382,72335,4708,7061,72604,22046,15249,11186,10283,783,4438,3246,2929,2146,18821,1980
34,"Franklin, VA",117306,5585,9213,10288,189957,-957,-3823,10729,267329,20940,7445,266372,83380,40090,36325,35777,3199,17117,14357,12714,9515,85832,1980
35,"Frederick + Winchester, VA*",399669,18188,34202,35640,309957,2638,-1243,36008,430745,39111,7948,433383,-53704,72654,50772,54530,4122,37868,52022,30369,26247,309779,1980
36,"Giles, VA",100386,4615,9766,9080,93203,1046,705,9155,134402,8120,7615,135448,1972,19637,22608,17787,1172,8825,14306,7332,6160,77255,1980
37,"Gloucester, VA",64181,3045,5016,4814,130499,-244,-614,5452,192300,13822,9478,192056,71770,41937,19620,20264,1692,13208,7423,6451,4759,43550,1980
38,"Goochland, VA",35117,1666,2553,2612,89790,-930,-1591,2972,123270,9495,10393,122340,57645,21136,11414,11771,798,7904,3859,3191,2393,23354,1980
39,"Grayson, VA",50284,2273,3351,4462,76334,5121,4167,4504,106166,5767,6701,111287,30554,15474,19479,16608,1640,9934,5582,5767,4127,34768,1980
40,"Greene, VA",13065,626,904,820,39931,334,125,1036,55978,4180,7315,56312,27902,9537,6844,7698,570,4305,1314,1527,957,7446,1980
41,"Greensville + Emporia, VA*",82333,3934,7099,7300,74238,-1418,-2296,7584,111930,9090,7023,110512,-511,15321,20953,15736,983,6794,10749,7645,6662,64790,1980
42,"Halifax, VA",162079,7610,13058,15282,174858,3163,-209,15251,254022,15464,6839,257185,28030,38765,43562,37603,4359,15255,20699,17283,12924,126125,1980
43,"Hampton (Independent City), VA",947969,30361,150495,75764,776597,0,0,68243,1126934,35686,9151,1126934,-103129,237808,112529,123148,4009,35686,188377,60882,56873,723906,1980
44,"Hanover, VA",285205,13161,21134,25312,425946,2284,554,25817,553980,33468,11002,556264,166558,88472,41846,50561,3584,34022,33790,22243,18659,217393,1980
45,"Henrico, VA",1233244,56293,98540,111190,1573238,-161,-1007,111888,2089671,98272,11540,2089510,451882,364470,151802,181068,3384,97265,154135,79281,75897,981844,1980
46,"Henry + Martinsville, VA*",577484,26636,50292,56468,438206,850,390,54870,605241,36936,7993,606091,-84408,91781,76104,75825,3819,37326,78526,44491,40672,461632,1980
47,"Highland, VA",7812,370,565,566,11506,516,218,653,18569,1787,6574,19085,4347,4052,3527,2903,566,2005,848,1238,672,4959,1980
48,"Isle of Wight, VA",173842,7941,16891,16428,156651,-599,-2388,16155,210245,7985,9697,209646,-1036,31451,21544,21619,1208,5597,25105,11869,10661,143140,1980
49,"James City + Williamsburg, VA*",316405,14053,27802,29142,228615,999,565,28624,317486,17769,9678,318485,-59166,60096,29774,32908,2043,18334,42373,24901,22858,255698,1980
50,"King George, VA",120968,1827,22437,5674,75577,-64,-484,4664,110239,4505,10444,110175,-40727,27179,7419,10549,1568,4021,25274,6315,4747,91673,1980
51,"King William, VA",55158,2604,4760,4792,63023,-357,-1236,5000,87901,4847,9333,87544,12865,14913,9608,9380,604,3611,7156,3686,3082,44391,1980
52,"King and Queen, VA",10013,551,889,712,28660,-906,-1388,907,45036,3014,7391,44130,19554,7905,7565,5971,364,1626,1245,1230,866,7142,1980
53,"Lancaster, VA",53478,2599,4168,4320,47646,-124,-420,4759,93774,9899,9228,93650,-1073,29454,16550,10149,1125,9479,6328,5139,4014,37671,1980
54,"Lee, VA",65337,3110,6794,5180,102204,2880,1908,5700,165723,8811,6484,168603,42567,22515,43884,26003,2616,10719,9384,7416,4800,45234,1980
55,"Loudoun, VA",356818,13214,38285,26730,562843,-2635,-6465,26579,766623,34947,13226,763988,232604,163214,37931,57765,4919,28482,51650,25747,20828,276686,1980
56,"Louisa, VA",74622,3511,6224,6632,91566,440,-266,6827,135721,9335,7611,136161,23771,23468,21127,17890,1298,9069,9540,5841,4543,56013,1980
57,"Lunenburg, VA",44271,2066,3892,4054,50039,765,-911,4093,76908,5683,6418,77673,9861,14105,13529,12103,1139,4772,5919,5261,4122,33580,1980
58,"Madison, VA",23864,1007,1563,1544,44009,2974,1350,1779,66200,6239,6751,69174,21924,14612,10553,10246,1081,7589,2335,3096,2015,13940,1980
59,"Mathews, VA",19934,1007,1370,1126,43668,-71,-316,1570,74757,8105,9317,74686,25304,18701,12317,8016,957,7789,1933,2304,1347,10212,1980
60,"Mecklenburg, VA",152538,7071,12809,14456,136318,1252,-2033,14299,207919,15101,7098,209171,-1921,39431,33422,29468,2620,13068,20037,15453,12833,119433,1980
61,"Middlesex, VA",30999,1459,2332,2358,42425,577,-441,2638,69624,7742,9090,70201,14064,15846,11930,7723,929,7301,3511,3546,2617,20187,1980
62,"Montgomery + Radford, VA*",474652,21019,48544,42582,391343,1636,509,42310,545569,23626,7090,547205,-40999,90448,65414,77176,3661,24135,69835,38345,34684,380682,1980
63,"Nelson, VA",32479,1584,2558,2792,64644,1241,99,2980,94367,5392,7802,95608,35145,15509,15455,12255,1088,5491,3954,3773,2685,23034,1980
64,"New Kent, VA",17994,921,1386,1438,66968,-827,-1027,1640,88812,4048,9991,87985,50614,13271,7746,8806,546,3021,2105,2064,1518,12868,1980
65,"Newport News (Independent City), VA",1350317,54175,175901,118448,1022938,0,0,113399,1403831,49904,9621,1403831,-213980,244961,135932,145917,5582,49904,235125,85271,79689,1065288,1980
66,"Norfolk (Independent City), VA",3661512,131495,566330,328136,1791702,0,0,295563,2762561,100194,10290,2762561,-1574247,662021,308838,268469,11569,100194,730398,230085,218516,2830920,1980
67,"Northampton, VA",62748,2874,5844,5270,48302,1554,-738,5509,91504,9089,6383,93058,-8937,22694,22062,14580,1117,8351,8479,6866,5749,45918,1980
68,"Northumberland, VA",32789,1651,2696,2484,44682,-734,-1219,2893,84409,8014,8507,83675,14786,23527,15466,9836,985,6795,3938,3392,2407,22056,1980
69,"Nottoway, VA",77585,3159,7786,8132,74665,701,-771,7225,115878,6454,7958,116579,4305,21408,20506,14649,1123,5683,11852,7083,5960,60050,1980
70,"Orange, VA",78670,3738,6130,7036,99033,261,-1460,7256,155686,12699,8617,155947,27619,35669,21245,18097,1742,11239,9648,7949,6207,57783,1980
71,"Page, VA",68584,3311,5813,6582,98548,-1502,-2544,6602,148422,9036,7569,146920,36566,25119,23253,19411,1485,6492,9104,7356,5871,52988,1980
72,"Patrick, VA",51428,2439,4046,4456,97449,1991,962,4667,130774,7757,7532,132765,50688,15756,19560,17627,2024,8719,6274,6076,4052,36435,1980
73,"Pittsylvania + Danville, VA*",638781,29749,51176,61596,641555,6759,1984,60547,882263,54043,7951,889022,63321,121296,126171,111813,7592,56027,81974,52573,44981,500780,1980
74,"Portsmouth (Independent City), VA",896554,23521,145205,59570,662037,0,0,53306,987362,31081,9430,987362,-181211,196207,129118,104709,4664,31081,174990,53927,49263,690483,1980
75,"Powhatan, VA",41575,1870,3926,3316,87386,156,-766,3528,112834,6341,8657,112990,49339,16920,8684,13052,785,5575,5584,3651,2866,30416,1980
76,"Prince Edward, VA",82507,3817,7382,7386,65193,496,-714,7510,104599,7247,6380,105095,-9804,20404,19498,16472,1233,6533,11075,8792,7559,64899,1980
77,"Prince George + Hopewell, VA*",512707,15530,84778,39762,282993,-1645,-2279,35411,415057,13788,8391,413412,-194303,92404,38015,49266,1532,11509,104659,28118,26586,396539,1980
78,"Prince William, Manassas + Manassas Park, VA*",825046,33411,96644,71986,1578036,-440,-1579,69404,2001561,66322,11873,2001121,822394,349900,73185,168538,7359,64743,132637,55358,47999,627666,1980
79,"Pulaski, VA",176588,8121,17208,16654,171465,1603,363,16448,247915,12479,7076,249518,11325,35175,42878,35263,1790,12842,25535,15065,13275,138211,1980
80,"Rappahannock, VA",14200,719,849,1066,26762,-228,-1173,1252,46259,4509,7562,46031,13814,12541,6728,6087,748,3336,1382,2158,1410,9482,1980
81,"Richmond (Independent City), VA",3498221,154576,329158,324712,1641360,0,0,316932,2461051,156503,11214,2461051,-1539929,464680,355011,219457,26628,156503,491514,233558,206930,2850204,1980
82,"Richmond, VA",34266,1601,3165,2948,33858,204,-344,3075,52816,3787,7610,53020,2667,9964,9198,6967,679,3443,4639,3341,2662,26184,1980
83,"Roanoke (Independent City), VA",1025601,46269,86746,106778,615864,0,0,99658,932448,51926,9286,932448,-310079,153735,162849,100412,10171,51926,140135,75405,65234,833540,1980
84,"Roanoke + Salem, VA*",682778,29303,60962,63104,707269,673,-139,60855,945413,56021,9749,946086,85346,153215,85602,97045,4578,55882,92514,45015,40437,534382,1980
85,"Rockbridge, Buena Vista + Lexington, VA*",152252,6950,13879,14228,149406,1516,204,14064,223363,13204,7057,224879,11218,41988,33485,31865,2317,13408,20993,13442,11125,117851,1980
86,"Rockingham + Harrisonburg, VA*",463612,20735,41380,40766,412861,6168,-3460,41118,583372,50749,7647,589540,-9633,111088,65591,77093,7113,47289,61763,41367,34254,354560,1980
87,"Russell, VA",126466,5569,16042,11680,168645,1971,600,11409,237950,11444,7559,239921,53588,28138,43138,31739,2423,12044,21882,9719,7296,92540,1980
88,"Scott, VA",50670,2451,4459,3768,100312,2991,2315,4335,152114,9005,6201,155105,53977,22835,31958,25011,2942,11320,6343,6407,3465,33007,1980
89,"Shenandoah, VA",129414,6024,10927,11558,160645,1464,-1183,11803,233575,16902,8502,235039,43034,43753,30641,27646,2967,15719,16706,13032,10065,96989,1980
90,"Smyth, VA",159834,7395,14456,13942,159729,1526,-73,14366,232827,18543,7022,234353,14261,33016,41608,33373,2821,18470,21427,15124,12303,119937,1980
91,"Southampton + Franklin, VA*",90653,4467,8357,8326,94931,-3000,-5850,8630,165240,9147,6238,162240,12908,34733,32576,26007,1720,3297,12520,10001,8281,74836,1980
92,"Spotsylvania + Fredericksburg, VA*",269261,12558,21179,23558,353894,-916,-1765,24337,479490,30852,9546,478574,108970,79003,45677,50136,4227,29087,32958,24109,19882,207216,1980
93,"Stafford, VA",91212,4229,6522,7096,319594,-940,-1144,7777,429060,18262,10516,428120,236159,85357,23169,40712,1107,17118,10070,7403,6296,64024,1980
94,"Suffolk (Independent City), VA",236767,11201,21161,21850,315980,-2586,-5026,22126,452040,18497,9442,449454,101339,73041,60433,47604,2426,13471,32086,19636,17210,191210,1980
95,"Surry, VA",59029,2802,4780,5876,25305,-1070,-1690,5740,41840,1992,6743,40770,-27984,8511,6954,6046,482,302,7718,3068,2586,51009,1980
96,"Sussex, VA",28711,1598,2830,2670,48891,-4491,-5545,2933,84912,6121,7405,80421,23113,17761,13769,10860,752,576,4165,3374,2622,23970,1980
97,"Tazewell, VA",257682,11554,28153,21572,301125,4400,3467,22340,428502,25848,8567,432902,65783,56425,75352,50534,3025,29315,38939,18403,15378,189428,1980
98,Virginia,40839542,1637369,4559061,3485870,40776228,61750,-76535,3380304,56664727,2892017,10567,56726477,3316990,10725935,5224314,5368334,357242,2815482,6301996,2796505,2439263,31722064,1980
99,"Virginia Beach (Independent City), VA",1386770,54938,182109,122952,2334168,-1973,-3333,116414,3180874,121807,12004,3178901,1063812,691512,153221,264821,16352,118474,243585,111295,94943,1024711,1980
100,"Warren, VA",115962,5273,10353,9886,137589,1034,437,10216,194452,12077,9197,195486,31843,33057,24840,21256,1367,12514,15296,9124,7757,88152,1980
101,"Washington + Bristol, VA*",362858,16730,33336,32624,338773,-1006,-4446,33042,491291,30997,7483,490285,8957,75371,76141,65522,5602,26551,49648,31701,26099,286659,1980
102,"Westmoreland, VA",39727,1914,3466,2850,70777,871,-793,3339,116087,8935,8320,116958,34389,26021,20160,14058,1168,8142,4891,5009,3841,26694,1980
103,"Wise + Norton, VA*",375480,16189,46430,30474,293655,62,-21,31426,428425,51307,8816,428487,-50399,52480,82352,48602,2373,51286,61667,20259,17886,262527,1980
104,"Wythe, VA",118572,5291,10972,9938,130523,5591,3870,10260,189159,10049,7624,194750,22211,31426,32801,25546,2137,13919,15941,10981,8844,88712,1980
105,"York + Poquoson, VA*",183547,5542,27148,12072,350044,746,-95,11578,478316,17185,10828,479062,178075,104362,24656,44243,1831,17090,33184,12549,10718,133273,1980
0,"Accomack, VA",178209,7522,18608,13732,149326,12408,8242,14388,243768,19954,8183,256176,-14495,59639,47211,31306,2953,28196,25474,15107,12154,124539,1981
1,"Albemarle + Charlottesville, VA*",883580,41894,85316,82832,668654,2,-3333,83310,1034267,58585,10624,1034269,-131616,265071,100544,97354,6947,55252,126732,63316,56369,701596,1981
2,"Alexandria (Independent City), VA",1509992,60323,177469,129900,1438134,0,0,125273,2128622,69379,20267,2128622,53415,564508,125980,105031,11279,69379,242419,83104,71825,1198194,1981
3,"Alleghany + Covington, VA*",187409,9483,16647,21118,140096,159,32,20042,217306,10070,7804,217465,-27271,31423,45946,27866,1434,10102,27206,11678,10244,150101,1981
4,"Amelia, VA",23953,1200,1917,1958,46851,1074,-200,2179,67963,4709,8238,69037,25077,11931,10255,8380,870,4509,2896,2783,1913,16548,1981
5,"Amherst, VA",129161,6490,12003,12442,136944,136,-279,12711,209313,11213,7198,209449,20494,40306,32199,29098,1562,10934,18224,10081,8519,100003,1981
6,"Appomattox, VA",52045,2608,4470,5230,66140,855,310,5223,95722,5596,8005,96577,19318,15261,15176,12064,928,5906,7085,4672,3744,39054,1981
7,"Arlington, VA",4111592,129271,624452,311590,2119713,0,0,285066,3241541,146573,20763,3241541,-1706813,964602,157226,156123,13498,146573,780247,157462,143964,3184772,1981
8,"Augusta, Staunton + Waynesboro, VA*",684237,34348,60956,66238,589170,-407,-4888,67467,859044,50932,9404,858637,-27600,155417,114050,91309,6646,46044,94075,47007,40361,544118,1981
9,"Bath, VA",46385,2408,3589,4686,30623,-300,-621,4751,49112,1828,8906,48812,-11011,9606,8583,5481,440,1207,5932,3235,2795,39246,1981
10,"Bedford, VA*",144983,7486,12686,13046,277064,1039,-607,14009,400008,20711,9540,401047,146090,73705,50278,42038,3556,20104,19209,13109,9553,105670,1981
11,"Bland, VA",18156,920,1614,1644,31237,830,421,1742,44644,2124,6963,45474,14823,6361,7876,6531,711,2545,2436,1950,1239,13175,1981
12,"Botetourt, VA",78759,3950,6155,9072,162464,71,-1159,8486,225184,13626,9615,225255,92191,36174,26617,23428,2015,12467,10691,6396,4381,55601,1981
13,"Brunswick, VA",62730,2736,4735,4948,77714,9656,7888,5210,111763,8152,7891,121419,20194,20831,22874,15387,1342,16040,7209,5889,4547,39481,1981
14,"Buchanan, VA",412258,18447,65231,35534,259195,405,383,36214,359706,46374,9534,360111,-116849,46286,54630,37773,1592,46757,82998,15883,14291,282503,1981
15,"Buckingham, VA",29810,1579,2778,2490,53109,295,-64,2824,84649,4585,7267,84944,26123,14950,16885,11689,845,4521,4023,3056,2211,21266,1981
16,"Campbell + Lynchburg, VA*",1078646,53529,99106,105966,721432,1669,427,106512,1073566,62456,9524,1075235,-250702,194439,159364,112902,6381,62883,152089,68809,62428,863674,1981
17,"Caroline, VA",58218,2670,6445,4752,110571,1127,389,5046,159050,7440,8948,160177,57399,28942,20664,17900,853,7829,8821,4583,3730,41568,1981
18,"Carroll + Galax, VA*",165570,8520,14905,16222,154232,1364,156,16631,245728,16496,7313,247092,5293,39184,53676,33788,3377,16652,23016,16520,13143,125902,1981
19,"Charles City, VA",8690,441,828,716,43907,438,-37,799,59139,1124,8841,59577,36016,8819,6851,6739,205,1087,1186,961,756,6417,1981
20,"Charlotte, VA",42819,1973,3132,3502,58020,5901,4272,3724,85003,6363,7462,90904,18925,16641,16243,12183,1582,10635,4883,4564,2982,27301,1981
21,"Chesapeake (Independent City), VA",462503,22952,41954,44610,985990,1979,-41,45257,1286105,38453,11056,1288084,568744,188564,113530,116501,4703,38412,64259,32876,28173,359832,1981
22,"Chesterfield, VA",926300,41748,93581,82548,1547817,174,-390,83022,1915608,69911,12935,1915782,704539,276342,91623,148114,6795,69521,134855,54530,47735,721924,1981
23,"Clarke, VA",65569,2641,6549,5032,88136,2852,-133,5157,125467,9534,12666,128319,27724,28958,11225,10131,1092,9401,9065,5325,4233,47103,1981
24,"Craig, VA",6901,364,726,662,19426,86,-69,695,31128,929,7833,31214,13220,6423,5365,3985,393,860,1057,946,553,4984,1981
25,"Culpeper, VA",136568,6569,13688,12244,155253,4266,1580,12691,227797,12685,10050,232063,31376,49242,27568,23091,2109,14265,19810,11090,8981,102493,1981
26,"Cumberland, VA",14450,728,999,998,32623,983,146,1227,52909,4067,6912,53892,19400,10550,10719,7797,602,4213,1498,1790,1188,8739,1981
27,"Dickenson, VA",141660,6426,21797,11018,131485,51,17,11935,193013,26598,9761,193064,1760,25004,36575,19780,872,26615,27306,6075,5203,87739,1981
28,"Dinwiddie, Colonial Heights + Petersburg, VA*",474692,23014,49864,45482,507103,6694,5481,45755,771518,34109,9764,778212,78166,143449,127660,79704,3978,39590,72605,34091,30113,362497,1981
29,"Essex, VA",44892,2189,3520,3914,46780,2612,1661,4146,74313,5184,8629,76925,6034,17269,12876,8915,809,6845,5477,4209,3400,32570,1981
30,"Fairfax, Fairfax City + Falls Church, VA*",5718303,242165,548134,487236,8533787,1990,751,485783,11092470,431581,16995,11094460,3301267,2174745,385928,652798,45592,432332,791752,317327,271735,4494219,1981
31,"Fauquier, VA",176560,7426,19393,13616,324019,2466,-1750,14234,471242,25616,12898,473708,161693,115984,33705,36728,3565,23866,26201,14853,11288,126493,1981
32,"Floyd, VA",29097,1519,2191,2364,59655,1201,368,2701,90030,6567,7792,91231,33259,16815,14761,11709,1681,6935,3373,3765,2084,18789,1981
33,"Fluvanna, VA",29191,1526,2438,2682,51596,185,-339,2867,83497,4517,8026,83682,25272,19149,12937,10426,790,4178,3779,2910,2120,21234,1981
34,"Franklin, VA",128386,6427,10425,11600,206501,3037,175,12227,292828,20430,8251,295865,90342,48199,41165,35859,3362,20605,16225,12763,9401,91556,1981
35,"Frederick + Winchester, VA*",435745,21377,38428,41060,340758,5643,2002,41907,484617,39436,8902,490260,-53080,90876,58626,55076,4177,41438,58958,30278,26101,335349,1981
36,"Giles, VA",107760,5419,11107,10536,97888,310,-18,10687,147715,7297,8379,148025,815,23610,26527,17666,1188,7279,16375,7177,5989,84106,1981
37,"Gloucester, VA",68108,3469,5617,5676,144598,1166,772,6307,217382,11271,10479,218548,82797,50680,23270,20855,1705,12043,8455,6430,4725,47610,1981
38,"Goochland, VA",38995,1989,2893,3100,97655,-563,-1184,3539,138202,9772,11671,137639,62199,26693,13291,11793,838,8588,4443,3250,2412,25964,1981
39,"Grayson, VA",51824,2586,3793,4938,78824,4298,3431,5055,116038,5631,7207,120336,32055,18982,22530,16696,1700,9062,6262,5794,4094,36500,1981
40,"Greene, VA",14230,724,1026,962,44864,645,467,1205,63686,4073,8063,64331,31839,11684,7783,7979,603,4540,1507,1540,937,8183,1981
41,"Greensville + Emporia, VA*",91025,4487,7888,8252,79910,3150,2312,8613,120328,7733,7876,123478,-2502,18844,24724,15677,974,10045,12014,7470,6496,68966,1981
42,"Halifax, VA",189217,8890,14896,17526,200631,17479,14354,17653,281415,14490,8039,298894,29067,47553,50710,37179,4363,28844,23659,17128,12765,136714,1981
43,"Hampton (Independent City), VA",1074693,37058,174394,90686,863074,0,0,82401,1265495,33979,10121,1265495,-129218,275031,127390,125035,3878,33979,219737,61838,57960,820977,1981
44,"Hanover, VA",308294,15409,23019,28900,456041,3786,2129,29859,609831,34907,12003,613617,177606,108249,49327,51120,3872,37036,37469,21983,18111,233789,1981
45,"Henrico, VA",1393348,69123,113077,133686,1741036,-8,-657,135966,2386151,100904,13107,2386143,483654,467781,177326,182050,3465,100247,179920,81701,78236,1113181,1981
46,"Henry + Martinsville, VA*",627976,31375,56607,65078,473306,1617,1182,63914,676317,36327,8947,677934,-90756,117507,87121,75769,4018,37509,89146,44675,40657,501321,1981
47,"Highland, VA",6415,379,568,556,8432,-435,-720,657,17261,1712,6094,16826,2674,4585,3809,2761,582,992,846,1203,621,4577,1981
48,"Isle of Wight, VA",194052,9130,18492,18286,176823,9296,7606,18273,230672,7916,11088,239968,1044,38268,24877,21642,1237,15522,27635,11537,10300,150895,1981
49,"James City + Williamsburg, VA*",353411,17069,32213,34522,260213,1188,764,34330,369532,17448,10920,370720,-58868,75271,35236,33950,2189,18212,49474,25090,22901,285725,1981
50,"King George, VA",135970,2370,24839,6868,82873,840,467,5804,121982,4034,11636,122822,-47293,31332,8617,10555,1590,4501,28273,6675,5085,103196,1981
51,"King William, VA",60726,2995,5377,5374,69583,1932,1107,5682,96091,4499,10263,98023,14539,17116,11324,9551,618,5606,8064,3659,3041,47056,1981
52,"King and Queen, VA",13115,618,1005,808,32350,1923,1463,1022,48931,2851,8515,50854,20257,9721,8783,5972,365,4314,1409,1194,829,7392,1981
53,"Lancaster, VA",56033,2941,4532,4872,48864,481,231,5377,104319,8682,10260,104800,-1792,36707,19229,10214,1211,8913,6968,5084,3873,40152,1981
54,"Lee, VA",71049,3546,7363,5908,110325,5295,4374,6500,180739,8540,7117,186034,45776,26671,49038,26140,2709,12914,10317,7363,4654,47818,1981
55,"Loudoun, VA",383372,15492,40976,30478,630151,-1672,-5177,30731,868257,35999,14686,866585,277510,192340,44094,59009,5150,30822,56215,26004,20854,296335,1981
56,"Louisa, VA",100143,5095,8381,9794,108820,472,-204,9992,161140,9471,8919,161612,18669,28581,24211,18119,1347,9267,13278,6544,5197,77598,1981
57,"Lunenburg, VA",52279,2353,4436,4472,58689,6340,4863,4589,85334,5837,7640,91674,10999,17126,15859,11999,1164,10700,6672,5208,4044,34907,1981
58,"Madison, VA",24105,1185,1777,1782,44664,1458,37,2076,73206,6278,7258,74664,22635,17718,12282,10287,1122,6315,2668,3145,2023,15122,1981
59,"Mathews, VA",19449,1055,1363,1182,46642,776,546,1646,82665,6541,10320,83441,28839,22498,14301,8085,1045,7087,1954,2407,1362,10408,1981
60,"Mecklenburg, VA",170495,8059,14353,16026,153761,11483,8384,16072,229591,14324,8170,241074,-662,47748,39565,29508,2672,22708,22366,15282,12610,125421,1981
61,"Middlesex, VA",32051,1618,2746,2710,44079,1223,96,2973,75824,6162,9966,77047,15001,19202,13766,7731,944,6258,4101,3551,2607,21692,1981
62,"Montgomery + Radford, VA*",511040,24550,54760,48974,420116,1170,32,49037,602677,23478,7666,603847,-41887,109046,74685,78771,3757,23510,79247,37222,33465,408283,1981
63,"Nelson, VA",35557,1852,2859,3254,68525,1872,592,3479,103234,5193,8450,105106,36447,18905,17676,12438,1078,5785,4486,3769,2691,25286,1981
64,"New Kent, VA",20259,1057,1587,1722,72651,285,103,1918,97615,3750,11010,97900,54310,16181,9068,8892,596,3853,2448,2073,1477,13958,1981
65,"Newport News (Independent City), VA",1513368,65699,205150,139320,1133483,0,0,135359,1578792,48547,10547,1578792,-244526,289254,156055,149695,5166,48547,274810,86422,81256,1190011,1981
66,"Norfolk (Independent City), VA",4155734,160373,661456,386570,1985570,0,0,353658,3095328,95691,11300,3095328,-1816506,765541,344217,273916,10613,95691,854741,229858,219245,3205302,1981
67,"Northampton, VA",70203,3260,6471,5944,58482,6646,4544,6232,103858,7664,7688,110504,-5489,27249,24773,14373,1152,12208,9443,6827,5675,48552,1981
68,"Northumberland, VA",33517,1785,3044,2724,45415,456,23,3147,91736,6308,9358,92192,15045,28803,17974,9852,991,6331,4406,3372,2381,22780,1981
69,"Nottoway, VA",85889,3814,8583,9570,80154,1758,502,8599,128220,6327,8931,129978,2864,25946,23878,14554,1159,6829,13368,7244,6085,65692,1981
70,"Orange, VA",83590,4366,6971,8170,103517,-711,-2476,8451,172778,12069,9455,172067,28378,44186,24364,18199,1819,9593,11056,8012,6193,62941,1981
71,"Page, VA",71571,3684,6154,7176,100445,112,-1000,7272,157441,8478,8115,157553,36146,29796,27312,19415,1511,7478,9742,7069,5558,54351,1981
72,"Patrick, VA",56648,2860,4793,5122,103903,2750,1785,5421,142936,7861,8317,145686,52676,19577,22206,17516,2148,9646,7354,6364,4216,39648,1981
73,"Pittsylvania + Danville, VA*",719032,35194,59101,71106,712604,28646,24176,70747,980473,53096,9035,1009119,64319,150713,145802,111693,7556,77272,94654,52197,44641,547106,1981
74,"Portsmouth (Independent City), VA",976210,28041,160048,68488,712145,0,0,62285,1083017,30584,10311,1083017,-201780,225029,145843,105037,4177,30584,194292,53492,49315,751334,1981
75,"Powhatan, VA",46400,2173,4584,3874,95348,1717,667,4110,124510,6208,9721,126227,53058,20409,10470,12985,816,6875,6521,3773,2957,33004,1981
76,"Prince Edward, VA",87215,4335,7923,8220,67772,1412,265,8445,113651,7005,6970,115063,-10998,24885,22406,16508,1272,7270,12033,8489,7217,67912,1981
77,"Prince George + Hopewell, VA*",543234,17273,92208,42862,309634,2437,1871,38704,456292,12992,9227,458729,-194896,104319,44776,49717,1474,14863,113639,26476,25002,414732,1981
78,"Prince William, Manassas + Manassas Park, VA*",876853,39259,94198,79736,1765809,472,-533,79127,2241314,68789,12759,2241786,968083,387623,88354,175704,7679,68256,134066,54877,47198,674531,1981
79,"Pulaski, VA",189255,9443,19151,18822,182621,1676,416,18854,273580,12384,7790,275256,12220,42330,50305,35335,1842,12800,28562,15083,13241,147893,1981
80,"Rappahannock, VA",13915,804,907,1170,27321,-979,-1977,1389,51071,4680,8278,50092,14795,15044,7727,6051,800,2703,1492,2151,1351,9720,1981
81,"Richmond (Independent City), VA",3799486,181718,373678,373836,1738006,0,0,368636,2716071,153068,12345,2716071,-1692844,573954,404111,220009,24635,153068,560596,227501,202866,3085822,1981
82,"Richmond, VA",38593,1879,3616,3388,36968,1569,1161,3573,57987,3855,8490,59556,1948,11992,10596,7015,783,5016,5310,3378,2595,28267,1981
83,"Roanoke (Independent City), VA",1096656,54012,94065,120980,636074,0,0,114502,1009654,51327,9997,1009654,-346080,188853,184727,100991,9290,51327,154555,73662,64372,890774,1981
84,"Roanoke + Salem, VA*",740470,34696,66877,73060,767881,-4,-672,71226,1056727,56923,10846,1056723,98637,191334,97508,97430,4701,56251,103407,44644,39943,580812,1981
85,"Rockbridge, Buena Vista + Lexington, VA*",164113,8158,15756,16444,155795,831,-440,16380,244055,12777,7754,244886,8062,50919,38172,31583,2283,12337,23978,13186,10903,127798,1981
86,"Rockingham + Harrisonburg, VA*",497998,24062,46237,46194,438736,9117,-423,47159,643875,50289,8320,652992,-12103,135909,78347,78483,7325,49866,69334,40603,33278,378798,1981
87,"Russell, VA",137058,6420,18469,13452,183223,4002,2553,13146,261634,11350,8409,265636,59311,35081,47332,31591,2511,13903,25195,9677,7166,97960,1981
88,"Scott, VA",60028,2919,5532,4570,113800,7109,6464,5204,171167,8178,7207,178276,58976,27943,36533,24737,2988,14642,7817,6677,3689,37569,1981
89,"Shenandoah, VA",137974,6895,12301,12916,167118,2966,224,13353,253148,16330,9165,256114,42497,53087,35909,27944,3028,16554,18759,13049,10021,102661,1981
90,"Smyth, VA",169187,8446,16546,15684,166559,2235,761,16288,252369,16914,7618,254604,13660,40214,47831,33423,2879,17675,24388,15078,12199,127124,1981
91,"Southampton + Franklin, VA*",111053,5148,9332,9370,118485,11384,8900,9833,188325,9117,7731,199709,17265,43569,37655,25831,1728,18017,14017,9782,8054,79019,1981
92,"Spotsylvania + Fredericksburg, VA*",287957,14517,23287,26760,391616,-104,-954,27897,539625,30749,10465,539521,131556,94916,52989,51556,4315,29795,36667,23983,19668,221495,1981
93,"Stafford, VA",161624,7109,21486,14730,391974,-54,-313,14474,528193,18324,12694,528139,244824,107724,28441,41604,1271,18011,28851,9960,8689,114762,1981
94,"Suffolk (Independent City), VA",264113,12921,23326,24832,354473,9592,7193,25337,502733,17201,10798,512325,115697,86963,70889,47445,2330,24394,35742,19217,16887,203977,1981
95,"Surry, VA",67373,3260,4987,6618,29944,3345,2805,6569,45415,1856,8078,48760,-30860,10786,8030,6036,507,4661,8296,3004,2497,54416,1981
96,"Sussex, VA",40531,1833,3180,3032,60939,5577,4578,3349,92204,5705,9066,97781,23757,21241,15601,10785,788,10283,4696,3380,2592,25552,1981
97,"Tazewell, VA",274659,13511,32124,25124,316110,875,37,26073,470038,24935,9319,470913,67524,70725,84078,50533,3237,24972,44686,18750,15513,205001,1981
98,Virginia,45398788,1965610,5197798,4094106,44799314,263556,130489,4012663,63434621,2865181,11700,63698177,3413189,12870236,6028627,5444094,361807,2995670,7244851,2811756,2449949,35158267,1981
99,"Virginia Beach (Independent City), VA",1626996,69362,217589,150278,2727975,84,-1196,144501,3728163,124854,13567,3728247,1245480,819252,181020,274799,16372,123658,292728,115683,99311,1210610,1981
100,"Warren, VA",117598,5829,11315,10632,142416,398,-138,11145,210245,12111,9824,210643,35963,39351,28876,21442,1348,11973,16631,8777,7429,88994,1981
101,"Washington + Bristol, VA*",400561,19602,38173,37620,369328,3971,553,38412,546162,30108,8416,550133,7179,93861,86944,65368,5730,30661,56983,31447,25717,312917,1981
102,"Westmoreland, VA",40211,2054,3682,3126,72083,2347,630,3617,123691,6989,8938,126038,35489,30423,23532,14102,1242,7619,5245,4798,3556,27347,1981
103,"Wise + Norton, VA*",399095,18543,51887,35242,309287,79,-8,36164,463785,50908,9576,463864,-53644,64273,90304,48442,2619,50900,69508,20057,17438,278687,1981
104,"Wythe, VA",127391,6255,12360,11692,137870,3938,2038,12101,208877,9941,8314,212815,22580,37746,37199,25596,2295,11979,18206,11263,8968,97206,1981
105,"York + Poquoson, VA*",212419,7336,32578,16040,407518,1159,330,15356,566211,15683,12787,567370,210455,128121,31731,44372,1911,16013,40598,13505,11594,155808,1981
0,"Accomack, VA",176741,8136,20382,14216,148172,4064,-327,15244,261631,20743,8498,265695,-13325,67143,50380,31264,2987,20416,27490,14862,11875,128835,1982
1,"Albemarle + Charlottesville, VA*",953723,46372,97466,89728,719492,-1155,-5127,91236,1141710,57640,11629,1140555,-142995,310674,110389,98076,7404,52513,142330,63973,56569,758880,1982
2,"Alexandria (Independent City), VA",1650104,66998,199344,141468,1527986,0,0,137732,2273459,68182,21591,2273459,15614,607249,138224,105297,11898,68182,270078,84248,72350,1311844,1982
3,"Alleghany + Covington, VA*",189130,10034,17315,22942,145304,111,-17,21505,229902,10208,8399,230013,-22321,36246,48463,27385,1513,10191,28786,11205,9692,150153,1982
4,"Amelia, VA",23111,1252,2042,1932,47592,448,-974,2218,72574,4435,8797,73022,26699,14090,11340,8301,879,3461,3008,2713,1834,16642,1982
5,"Amherst, VA",131897,6862,13510,12624,144318,-375,-831,13174,228595,11523,7831,228220,25595,48324,35578,29143,1643,10692,19822,10192,8549,101383,1982
6,"Appomattox, VA",50279,2689,4698,5076,65679,-335,-856,5227,99900,5381,8276,99565,20627,16969,16917,12031,932,4525,7236,4500,3568,38518,1982
7,"Arlington, VA",4547244,148301,692497,347616,2236978,0,0,322109,3448654,147531,21850,3448654,-1988157,1040568,171108,157834,14320,147531,866305,161783,147463,3533408,1982
8,"Augusta, Staunton + Waynesboro, VA*",690118,35495,65288,67110,603426,-82,-5173,69050,911758,51833,9942,911676,-17642,180983,127267,91701,7157,46660,98843,45701,38544,544615,1982
9,"Bath, VA",78132,4105,5823,8042,38791,-544,-862,8126,59943,1902,10979,59399,-31215,11645,8963,5410,489,1040,9844,4183,3694,67248,1982
10,"Bedford, VA*",145310,7978,13541,13384,289352,-1631,-3497,14670,431978,20917,10106,430347,158712,84628,56367,42582,3786,17420,20233,13056,9270,107657,1982
11,"Bland, VA",20976,1114,2027,2012,32893,553,117,2120,49053,1964,7608,49606,14037,8216,8497,6520,709,2081,3033,1986,1277,15862,1982
12,"Botetourt, VA",75299,4153,6394,9314,163135,-892,-2169,8810,234820,12113,9994,233928,96646,41798,28995,23406,2017,9944,11051,6160,4143,54304,1982
13,"Brunswick, VA",67141,3282,6650,5856,79963,4055,2074,6210,124382,8053,8260,128437,19032,24718,23756,15549,1357,10127,9578,6172,4815,47436,1982
14,"Buchanan, VA",417581,19094,70550,38724,264587,251,240,38456,377405,44525,10034,377656,-114538,52005,61064,37639,1746,44765,89912,15741,13995,282904,1982
15,"Buckingham, VA",30540,1709,3117,2592,54533,-275,-650,3005,89722,4477,7688,89447,26998,16852,18062,11634,889,3827,4413,3045,2156,22300,1982
16,"Campbell + Lynchburg, VA*",1109281,56554,106759,110094,738606,-1155,-2504,111601,1143811,60405,10076,1142656,-259074,225192,178858,113402,6515,57901,161806,67554,61039,889574,1982
17,"Caroline, VA",58522,2834,6972,4828,114063,264,-549,5248,168471,7570,9384,168735,60789,31899,22773,17981,892,7021,9386,4486,3594,42115,1982
18,"Carroll + Galax, VA*",165144,8813,15765,15864,152701,760,-567,16745,258534,16798,7594,259294,4302,46059,60534,34146,3449,16231,23697,15899,12450,125216,1982
19,"Charles City, VA",8634,474,935,746,45166,27,-447,847,62162,1072,9339,62189,37379,9954,7069,6659,218,625,1308,948,730,6701,1982
20,"Charlotte, VA",39080,2053,3393,3416,53773,2353,532,3761,88711,6094,7548,91064,18454,18967,18324,12065,1595,6626,5101,4487,2892,27353,1982
21,"Chesapeake (Independent City), VA",495067,25414,46942,48506,1072812,804,-1325,49667,1415130,40739,11945,1415934,627412,220308,122814,118533,5258,39414,71195,34253,28995,384458,1982
22,"Chesterfield, VA",1036703,48130,107223,95354,1704366,-35,-518,95807,2121351,69806,13947,2121316,763470,312951,103999,152101,8414,69288,154900,58159,49745,812515,1982
23,"Clarke, VA",66638,2839,7035,5150,90534,1882,-965,5414,132010,9718,13014,133892,29310,30926,12432,10288,1484,8753,9610,5622,4138,48275,1982
24,"Craig, VA",7027,396,811,690,20150,-92,-280,741,33158,986,8258,33066,13864,7167,5749,4004,397,706,1156,939,542,5165,1982
25,"Culpeper, VA",135044,6790,13763,12358,159734,3175,301,12969,241457,11971,10612,244632,37659,53404,31494,23053,2234,12272,19942,10598,8364,102830,1982
26,"Cumberland, VA",14949,784,1098,982,34474,1315,418,1275,56762,4198,7447,58077,20800,11676,11927,7799,601,4616,1589,1711,1110,8744,1982
27,"Dickenson, VA",156093,7354,24439,13196,140999,32,-4,13952,207101,28019,10364,207133,-1142,28262,37872,19985,816,28015,31037,5970,5154,97041,1982
28,"Dinwiddie, Colonial Heights + Petersburg, VA*",480275,24215,54316,46194,525164,1963,780,47312,825888,33322,10443,827851,92201,163820,138867,79277,3961,34102,77413,32784,28823,368760,1982
29,"Essex, VA",43976,2299,3739,3948,45345,1299,279,4273,77647,5075,8932,78946,5642,19195,14406,8839,815,5354,5713,4152,3337,32909,1982
30,"Fairfax, Fairfax City + Falls Church, VA*",6318818,274113,628273,545936,9224291,2191,898,547081,12164656,431408,18113,12166847,3452554,2507275,435281,671705,49711,432306,901241,326963,277252,4985271,1982
31,"Fauquier, VA",176669,8186,19705,14220,344832,-614,-5307,15296,517885,26528,13746,517271,183459,134075,38364,37632,3698,21221,26815,15054,11356,128633,1982
32,"Floyd, VA",29801,1670,2394,2470,60631,768,-165,2905,95453,6546,8242,96221,33735,18707,16883,11674,1748,6381,3629,3784,2036,19791,1982
33,"Fluvanna, VA",30312,1663,2800,2720,55868,-111,-661,3023,91514,4918,8758,91403,28579,21317,14218,10437,818,4257,4160,2825,2007,21895,1982
34,"Franklin, VA",130409,6878,11066,11614,212735,1813,-1445,12685,312036,21276,8678,313849,95011,55080,46034,36165,3546,19831,16873,12463,8917,93705,1982
35,"Frederick + Winchester, VA*",457480,23148,41250,43584,360888,5185,1253,44940,525953,40217,9541,531138,-51652,104325,65925,55671,4166,41470,63042,29933,25767,352968,1982
36,"Giles, VA",107252,5583,11476,10900,98689,160,-190,11033,155955,7359,8869,156115,2470,27832,29594,17602,1273,7169,16926,7003,5730,83157,1982
37,"Gloucester, VA",72430,3880,6446,6224,161224,584,129,6992,242650,11232,11231,243234,95786,56349,25661,21658,1802,11361,9558,6508,4706,51511,1982
38,"Goochland, VA",41964,2232,3283,3296,105941,-289,-928,3880,152872,10092,12723,152583,67857,31950,14692,11993,920,9164,4931,3313,2393,27869,1982
39,"Grayson, VA",55766,2847,4294,5136,81739,5414,4527,5415,122586,5463,7682,128000,31388,21239,25022,16663,1752,9990,6862,5706,3954,38914,1982
40,"Greene, VA",14486,795,1142,976,48469,483,305,1283,71307,4042,8747,71790,35266,14159,9162,8207,616,4347,1630,1521,905,8509,1982
41,"Greensville + Emporia, VA*",90260,4683,8418,8438,78038,1405,507,8902,125060,7478,8180,126465,-3320,22159,26268,15460,914,7985,12637,7199,6285,69638,1982
42,"Halifax, VA",180430,9438,15982,17766,190181,4157,842,18321,301620,14649,8248,305777,28072,59171,56425,37075,4369,15491,24865,16398,12029,140074,1982
43,"Hampton (Independent City), VA",1190125,41873,197720,98214,950145,0,0,90980,1394710,33911,11074,1394710,-149000,310262,134303,125946,3880,33911,246827,64004,60124,909387,1982
44,"Hanover, VA",330639,17148,25566,31424,487398,2838,1044,32860,661509,35388,12934,664347,189619,121776,55173,51363,4298,36432,41278,22761,18463,252929,1982
45,"Henrico, VA",1482092,75222,127367,144554,1853876,-422,-938,147499,2587278,96638,13887,2586856,519283,535475,197505,186277,3714,95700,199644,82235,78521,1186748,1982
46,"Henry + Martinsville, VA*",640779,32874,60376,66418,483122,675,226,66083,711540,34927,9461,712215,-91574,132606,96487,75281,4187,35153,93585,43706,39519,512041,1982
47,"Highland, VA",5621,378,581,518,10435,-812,-1123,637,20894,1603,7239,20082,5451,5537,4110,2774,576,480,840,1109,533,4301,1982
48,"Isle of Wight, VA",191267,9598,19991,19282,174733,1144,-656,19239,246045,7850,11288,247189,2705,44973,27483,21899,1326,7194,29632,11216,9890,154441,1982
49,"James City + Williamsburg, VA*",384221,19003,36405,37246,286888,1439,986,37626,414507,17418,11935,415946,-59707,89839,39219,34852,2598,18404,55028,25804,23206,310789,1982
50,"King George, VA",146877,2453,28014,7314,87522,192,-178,6110,130451,4099,12461,130643,-53245,33706,9415,10484,1521,3921,31671,6608,5087,111285,1982
51,"King William, VA",60828,3129,5694,5776,71917,898,31,6017,104917,4484,10982,105815,17106,21264,12634,9635,639,4515,8582,3567,2928,47731,1982
52,"King and Queen, VA",12757,670,1198,852,32408,1055,543,1096,51450,2702,8877,52505,20747,10803,9294,5915,394,3245,1624,1236,842,7888,1982
53,"Lancaster, VA",59860,3301,5088,5344,51444,99,-126,5973,114003,8369,11161,114102,-2443,41673,20985,10223,1306,8243,7760,5179,3873,43857,1982
54,"Lee, VA",74433,3916,8333,6400,115025,4372,3387,7116,195610,8898,7633,199982,47708,33353,51604,26199,2864,12285,11533,7532,4668,50615,1982
55,"Loudoun, VA",408180,17143,44046,32774,693218,-19,-3558,33530,950516,37074,15804,950497,318568,208433,48846,60142,5767,33516,60433,26510,20743,314231,1982
56,"Louisa, VA",112157,5817,10353,10922,117038,878,146,11278,174268,9299,9589,175146,16159,31070,27038,18265,1333,9445,15814,6637,5304,86898,1982
57,"Lunenburg, VA",46407,2421,4726,4374,54044,1031,-468,4608,90383,5487,7627,91414,12245,19656,17714,11986,1227,5019,6913,5021,3794,34475,1982
58,"Madison, VA",25577,1305,1986,1816,46688,1980,597,2213,79770,6435,7929,81750,23324,21209,13853,10310,1234,7032,2894,3223,1989,15651,1982
59,"Mathews, VA",20122,1180,1506,1280,50450,644,400,1820,90007,6446,11219,90651,32148,24389,15812,8080,971,6846,2146,2317,1346,11130,1982
60,"Mecklenburg, VA",163616,8491,15460,16126,147312,1251,-2115,16554,244519,14640,8393,245770,250,54526,43932,29281,2618,12525,23523,14802,12184,127568,1982
61,"Middlesex, VA",32742,1753,3012,2822,46025,1166,-218,3164,81231,6023,10525,82397,16447,20989,15383,7829,934,5805,4423,3481,2547,22514,1982
62,"Montgomery + Radford, VA*",551523,27109,61964,53762,450147,394,-871,53990,661900,24863,8352,662294,-47386,132417,79730,79296,4034,23992,88845,37639,33605,438686,1982
63,"Nelson, VA",36951,2000,3146,3354,70829,2467,873,3677,109371,5091,8961,111838,37555,21758,19251,12481,1146,5964,4823,3798,2652,26164,1982
64,"New Kent, VA",20380,1133,1727,1760,76537,18,-162,2013,105451,3836,11827,105469,58170,18822,10110,8918,638,3674,2607,2034,1396,14099,1982
65,"Newport News (Independent City), VA",1657718,73604,230554,154062,1223421,0,0,150635,1711149,46798,11269,1711149,-283662,320396,167332,151851,5508,46798,307585,86753,81245,1303335,1982
66,"Norfolk (Independent City), VA",4512730,176544,730317,409102,2121543,0,0,381095,3313249,92021,12488,3313249,-2010092,834791,356915,265322,10714,92021,934868,227374,216660,3485841,1982
67,"Northampton, VA",68468,3568,6923,6348,55969,1989,-211,6742,110620,7499,7961,112609,-5757,30305,26335,14145,1193,7288,10097,6647,5454,51083,1982
68,"Northumberland, VA",35094,2005,3428,3022,47332,-463,-886,3516,98343,6015,9847,97880,15754,31082,19466,9940,1060,5129,4939,3371,2311,25026,1982
69,"Nottoway, VA",83483,4016,9112,10026,76377,226,-992,9029,131572,5902,9020,131798,1923,28652,26769,14611,1218,4910,14125,6431,5213,64448,1982
70,"Orange, VA",83644,4589,7494,8130,106068,-1220,-3247,8654,186207,11862,10055,184987,31078,51417,27502,18398,1820,8615,11559,7732,5912,63470,1982
71,"Page, VA",75346,3965,6689,7420,104226,1651,384,7675,167864,8790,8620,169515,36555,34748,30541,19665,1622,9174,10399,7043,5421,55773,1982
72,"Patrick, VA",54326,2963,5039,5002,100932,1084,48,5464,148055,7490,8545,149139,52070,23103,25104,17454,2206,7538,7540,6186,3980,39248,1982
73,"Pittsylvania + Danville, VA*",697557,36229,63094,70014,690617,7125,2341,71236,1017819,51243,9249,1024944,64296,174168,160159,110811,7826,53584,98101,50734,42908,545872,1982
74,"Portsmouth (Independent City), VA",1077695,30771,182186,74598,753393,0,0,68070,1157188,28224,10911,1157188,-256232,251219,152576,106058,4351,28224,219485,53605,49254,829986,1982
75,"Powhatan, VA",48534,2355,5102,4006,102716,1628,291,4358,136642,7024,10526,138270,58540,24148,11406,13136,826,7315,7105,3657,2831,34114,1982
76,"Prince Edward, VA",88929,4617,8658,8474,68050,369,-881,8854,121281,6708,7281,121650,-12025,29025,24575,16709,1302,5827,12895,8386,7084,70207,1982
77,"Prince George + Hopewell, VA*",565360,18124,96785,43800,330205,1401,851,40024,492490,13381,10016,493891,-195131,113695,49991,49311,1514,14232,118685,24874,23360,432443,1982
78,"Prince William, Manassas + Manassas Park, VA*",979223,44955,107819,89350,1949064,-234,-1234,89630,2482418,72427,13670,2482184,1059471,436369,96751,181575,8036,71193,152494,56488,48452,755536,1982
79,"Pulaski, VA",194414,10055,20373,19478,188178,632,-798,19794,290218,12449,8238,290850,13558,47991,54681,35304,1884,11651,30112,14550,12666,152651,1982
80,"Rappahannock, VA",14750,860,1008,1158,28487,-347,-1516,1439,54582,4799,9109,54235,15176,17142,8606,5954,827,3283,1587,2169,1342,9880,1982
81,"Richmond (Independent City), VA",4046073,197525,422294,397488,1811849,0,0,396269,2892358,154238,13259,2892358,-1837955,645224,435285,218146,25103,154238,621038,224128,199025,3270797,1982
82,"Richmond, VA",39851,2056,4140,3626,37366,523,214,3869,62609,3591,9073,63132,1384,14556,11210,6958,839,3805,5953,3355,2516,30093,1982
83,"Roanoke (Independent City), VA",1144631,58519,103521,128448,648519,0,0,122743,1064347,50236,10573,1064347,-373369,215051,200777,100667,10588,50236,167745,74557,63969,926650,1982
84,"Roanoke + Salem, VA*",770549,37290,72115,77104,805430,-65,-660,75842,1135556,55598,11645,1135491,110723,225712,104349,97509,4417,54938,110667,43975,39558,604944,1982
85,"Rockbridge, Buena Vista + Lexington, VA*",167366,8647,17118,16558,161987,-436,-1781,16926,261888,11964,8248,261452,11547,58239,41226,31699,2547,10183,25397,13262,10715,131786,1982
86,"Rockingham + Harrisonburg, VA*",540899,27129,52358,51238,471355,6006,-4527,52748,701699,51786,8949,707705,-16796,152807,83543,79086,7829,47259,77977,41535,33706,415663,1982
87,"Russell, VA",140938,7031,19224,14968,187142,1737,20,14515,277273,11079,8741,279010,60719,39921,51947,31921,2607,11099,26708,9467,6860,103131,1982
88,"Scott, VA",63611,3343,6114,5078,119072,5206,4495,5882,185835,9169,7684,191041,61343,32360,39609,24863,3345,13664,8653,6907,3562,41294,1982
89,"Shenandoah, VA",145473,7607,13895,13636,172321,1325,-1855,14425,271398,17027,9680,272723,41273,59737,40665,28173,3087,15172,20713,12930,9843,109588,1982
90,"Smyth, VA",172473,8896,17453,15950,167443,2330,775,16871,264481,17339,8035,266811,11841,46991,52377,33208,2994,18114,25428,14296,11302,128931,1982
91,"Southampton + Franklin, VA*",112498,5531,10435,9940,124900,8803,6327,10501,205352,8876,8383,214155,22903,49998,39257,25545,1816,15203,15405,9621,7805,81890,1982
92,"Spotsylvania + Fredericksburg, VA*",307267,16036,25780,29068,426125,-463,-1413,30570,597054,31269,11413,596591,149428,112298,58168,52273,4247,29856,40314,23985,19738,237097,1982
93,"Stafford, VA",177217,7998,24323,15654,430713,-421,-767,15825,584149,19069,13475,583728,269321,120234,32781,43318,1692,18302,32150,10518,8826,126765,1982
94,"Suffolk (Independent City), VA",269136,13841,24986,26156,373301,4405,1729,26919,543863,17336,11534,548268,131084,97385,77582,47533,2343,19065,38064,18721,16378,212007,1982
95,"Surry, VA",48600,2404,4896,4686,31139,1614,1113,4747,50068,1642,8647,51682,-12714,11968,8575,5977,499,2755,7239,2543,2044,38606,1982
96,"Sussex, VA",37702,2034,3539,3226,57909,381,-701,3647,96869,6161,9162,97250,23854,22940,16401,10615,783,5460,5152,3411,2628,27090,1982
97,"Tazewell, VA",291425,14853,33734,27866,327492,696,-155,28786,497459,25523,9789,498155,64853,79840,90823,50889,3391,25368,47667,18726,15335,218390,1982
98,Virginia,48645343,2163126,5787624,4411628,47709196,115393,-28436,4368940,68739383,2862935,12535,68854776,3432793,14559370,6586210,5492785,382875,2834499,7993438,2823682,2440807,37817406,1982
99,"Virginia Beach (Independent City), VA",1807492,79352,245334,164474,3050752,592,-763,161589,4182949,128944,14840,4183541,1404849,932358,200431,281910,18489,128181,327571,120850,102361,1351740,1982
100,"Warren, VA",113140,5850,11195,10464,144784,-19,-561,11082,221707,11835,10189,221688,42726,43428,33476,21757,1463,11274,16427,8338,6875,85439,1982
101,"Washington + Bristol, VA*",415336,20902,42263,39268,380047,2616,-1257,40536,579387,30580,8898,582003,5247,107249,94707,65408,5798,29323,61897,31286,25488,324116,1982
102,"Westmoreland, VA",39333,2177,4027,3154,72891,909,-1072,3754,131783,7095,9337,132692,37312,34698,25103,14212,1219,6023,5604,4690,3471,27706,1982
103,"Wise + Norton, VA*",439498,21034,61942,41682,334925,184,87,41875,505291,49902,10406,505475,-62698,75728,94822,48575,2597,49989,82783,20680,18083,306726,1982
104,"Wythe, VA",121783,6149,11857,11110,134538,4925,2906,11704,214498,10086,8573,219423,24459,43108,41777,25594,2447,12992,17412,10581,8134,91379,1982
105,"York + Poquoson, VA*",228791,8146,35878,17222,449803,1485,576,16757,624257,16069,13776,625742,237769,139227,36712,45423,1915,16645,44489,13149,11234,167657,1982
0,"Accomack, VA",183742,8668,21279,15354,154821,2306,-2263,16345,276827,25755,8942,279133,-12576,71087,53225,31215,2914,23492,28956,14773,11859,131294,1983
1,"Albemarle + Charlottesville, VA*",1056203,52067,110082,102878,787555,-1304,-4950,103506,1234100,65141,12471,1232796,-165142,324577,120664,98850,7394,60191,161521,65682,58288,834491,1983
2,"Alexandria (Independent City), VA",1792241,75599,216863,162278,1625893,0,0,156738,2397687,78169,22232,2397687,-9610,624700,147094,107849,12660,78169,298002,86491,73831,1416070,1983
3,"Alleghany + Covington, VA*",202940,10771,19362,24954,160498,67,-33,23248,250891,11922,9244,250958,-19194,38227,52233,27148,1536,11889,31839,11158,9622,159212,1983
4,"Amelia, VA",25036,1364,2335,2160,50622,-130,-1527,2444,77408,5168,9400,77278,28030,15122,11534,8221,897,3641,3415,2816,1919,17980,1983
5,"Amherst, VA",147527,7695,15369,14426,163519,171,-245,14908,253073,13552,8753,253244,30900,51138,38587,28931,1689,13307,22582,10268,8579,111638,1983
6,"Appomattox, VA",53524,2797,5190,5310,71400,587,121,5452,108453,6339,9014,109040,23328,19304,18336,12097,939,6460,7845,4511,3572,39219,1983
7,"Arlington, VA",5038414,182320,748609,430398,2335961,0,0,397519,3577450,168462,22292,3577450,-2304934,1055995,185494,160483,14891,168462,963808,169699,154808,3906144,1983
8,"Augusta, Staunton + Waynesboro, VA*",732061,37467,71809,72300,648804,822,-4115,73617,982321,60951,10706,983143,-9640,196087,138252,91828,7530,56836,107959,45092,37562,567266,1983
9,"Bath, VA",115404,5968,9197,12354,45230,-350,-641,12145,68142,2783,12342,67792,-58029,12751,9811,5493,508,2142,15374,5139,4631,97888,1983
10,"Bedford, VA*",162949,8725,15471,15164,322965,-279,-2023,16307,477812,24311,11068,477533,176323,94111,60457,43145,3808,22288,23053,13455,9647,117608,1983
11,"Bland, VA",22694,1167,2354,2112,33325,1309,903,2223,49717,2228,7826,51026,12854,8494,9207,6520,716,3131,3410,2031,1315,16153,1983
12,"Botetourt, VA",85620,4565,7630,10468,180714,492,-731,9799,256544,14876,11037,257036,104893,45267,31055,23288,2013,14145,12864,6253,4240,58611,1983
13,"Brunswick, VA",67146,3484,6537,6182,78521,1521,-321,6575,128538,9286,8082,130059,17950,25931,25607,16092,1358,8965,9628,6172,4814,48553,1983
14,"Buchanan, VA",343470,15692,51846,29410,235833,303,289,30397,359031,64470,9675,359334,-77240,52253,71248,37139,1850,64759,66551,13047,11197,212160,1983
15,"Buckingham, VA",38434,2107,4119,3422,62581,-282,-682,3818,102035,4948,8341,101753,27965,19419,19753,12199,900,4266,5830,3442,2542,28338,1983
16,"Campbell + Lynchburg, VA*",1189481,60450,115823,122114,791839,297,-971,121507,1230780,69672,10899,1231077,-276135,242920,196318,112949,6545,68701,176880,67511,60966,943900,1983
17,"Caroline, VA",64981,3181,8123,5680,124469,-1141,-1832,6021,186161,8783,10205,185020,65509,35713,24838,18130,893,6951,10963,4673,3780,47067,1983
18,"Carroll + Galax, VA*",184555,9719,17801,18192,170370,1521,270,18815,285450,19920,8390,286971,4630,51544,65057,34203,3520,20190,26897,16042,12522,137468,1983
19,"Charles City, VA",9277,517,1100,814,46817,-308,-725,924,65483,1480,9985,65175,38464,11039,7319,6527,213,755,1507,962,749,7015,1983
20,"Charlotte, VA",43080,2268,3770,3898,57834,2158,507,4217,96284,7058,8193,98442,18971,21126,19482,12016,1684,7565,5719,4632,2948,29796,1983
21,"Chesapeake (Independent City), VA",564524,28994,55669,56980,1180732,-369,-2482,57484,1558305,49333,12928,1557936,673692,245321,131883,120508,5360,46851,84159,35916,30556,433514,1983
22,"Chesterfield, VA",1135010,53694,119532,107954,1870935,174,-275,107671,2340248,83879,15163,2340422,843596,355276,114211,154348,8687,83604,173509,60537,51850,877897,1983
23,"Clarke, VA",69943,3106,7332,5800,94760,2201,-404,6006,139766,10135,13478,141967,30823,33865,13342,10533,1629,9731,10232,5736,4107,49980,1983
24,"Craig, VA",7965,453,931,772,22694,-254,-423,839,37183,1487,9272,36929,15568,8181,6054,3983,411,1064,1317,982,571,5584,1983
25,"Culpeper, VA",141831,7286,15119,13522,170151,-209,-2822,14047,260963,14516,11280,260754,42367,57257,33346,23116,2222,11694,21880,10545,8323,108257,1983
26,"Cumberland, VA",15907,835,1298,1108,37549,955,16,1389,62363,4642,8093,63318,23031,12850,12919,7824,612,4658,1852,1753,1141,9397,1983
27,"Dickenson, VA",161560,7531,23353,13302,140680,128,98,14182,209040,34524,10431,209168,-6698,27015,41473,20052,871,34622,30004,5724,4853,96934,1983
28,"Dinwiddie, Colonial Heights + Petersburg, VA*",482340,24813,53802,47336,542848,-416,-1555,48481,872726,38972,11084,872310,108989,174995,154467,78702,3922,37417,77470,32062,28140,367453,1983
29,"Essex, VA",44010,2500,4240,4382,45065,-3082,-3951,4691,84745,6321,9254,81663,5746,21381,15217,8825,968,2370,6431,4447,3479,35209,1983
30,"Fairfax, Fairfax City + Falls Church, VA*",7282953,328181,716288,666256,10140282,1556,220,661309,13362215,533933,19344,13363771,3518638,2740958,482531,690837,51431,534153,1049416,348782,297351,5699384,1983
31,"Fauquier, VA",199449,9316,22150,16812,382279,-186,-4498,17722,558715,30740,14608,558529,200552,134864,41386,38234,3788,26242,30556,15639,11851,142651,1983
32,"Floyd, VA",33352,1777,2711,2782,66216,1701,825,3168,103604,6976,9065,105305,36032,21028,18061,11617,1848,7801,4102,3977,2129,21449,1983
33,"Fluvanna, VA",34475,1852,3219,3174,62703,187,-305,3439,101120,5884,9646,101307,31667,23201,15403,10503,844,5579,4806,2910,2066,24090,1983
34,"Franklin, VA",153444,7882,13388,14012,239740,3227,102,14888,346254,24562,9624,349481,101184,61193,48548,36313,3597,24664,20394,13298,9701,108386,1983
35,"Frederick + Winchester, VA*",496559,24948,46727,48724,395914,3561,-228,49310,577312,44983,10388,580873,-51335,114550,70409,55918,4084,44755,71089,30562,26478,380715,1983
36,"Giles, VA",114917,5940,12843,11682,106165,61,-240,11781,166662,9306,9552,166723,3029,29270,31288,17455,1452,9066,18684,7196,5744,87167,1983
37,"Gloucester, VA",81303,4397,7478,7170,184849,-1194,-1646,7982,276787,14563,12146,275593,111528,62205,28539,22690,1827,12917,11063,6768,4941,57323,1983
38,"Goochland, VA",46341,2415,3791,3800,115050,-56,-617,4315,163969,10538,13576,163913,73024,33000,15863,12074,959,9921,5691,3448,2489,30729,1983
39,"Grayson, VA",62816,3179,5182,5916,90160,5452,4626,6137,135388,6734,8477,140840,33481,24409,26271,16614,1761,11360,8140,6030,4269,43316,1983
40,"Greene, VA",16653,879,1320,1112,55106,654,469,1435,80045,4971,9677,80699,39888,15580,10013,8339,669,5440,1876,1574,905,9337,1983
41,"Greensville + Emporia, VA*",96125,5084,9512,9592,80241,-1204,-2052,9880,132991,7810,8648,131787,-6004,24001,27545,15239,915,5758,14308,7314,6399,76059,1983
42,"Halifax, VA",190973,10202,17570,19666,200038,-477,-3447,20035,322413,17662,8752,321936,29100,62062,59836,36785,4470,14215,27403,16675,12205,149355,1983
43,"Hampton (Independent City), VA",1275755,48143,210036,114628,1035942,0,0,105457,1509001,39237,11860,1509001,-134356,329422,143637,127233,3816,39237,267350,64135,60319,969168,1983
44,"Hanover, VA",388981,20075,30884,38468,531075,1103,-677,39309,724187,40948,14048,725290,181403,134128,60087,51631,4442,40271,50118,24458,20016,298592,1983
45,"Henrico, VA",1634469,82609,143013,163520,2012401,10,-523,164369,2797762,112066,14688,2797772,542301,570857,214514,190475,3964,111543,224773,85287,81323,1298153,1983
46,"Henry + Martinsville, VA*",719068,36704,68735,77058,542101,299,-76,75233,789188,40762,10557,789487,-101734,146872,100514,74780,4173,40686,107264,44682,40509,571118,1983
47,"Highland, VA",7136,436,676,590,15108,-538,-828,731,25713,2140,8687,25175,8703,5641,4426,2898,611,1312,971,1147,536,4853,1983
48,"Isle of Wight, VA",202663,10359,21300,21278,192738,-2423,-4125,20998,272218,9669,12134,269795,11073,47318,29739,22234,1455,5544,31939,11417,9962,165180,1983
49,"James City + Williamsburg, VA*",415615,20734,40342,41342,316980,397,-35,41405,456947,20082,12769,457344,-57230,96687,43677,35817,2554,20047,61013,26457,23903,334555,1983
50,"King George, VA",149981,3624,28291,9622,92355,-1277,-1601,8435,139822,5003,13048,138545,-49191,36055,10135,10618,1668,3402,33102,7002,5334,113477,1983
51,"King William, VA",63151,3340,6067,6274,75894,-1212,-1983,6477,113034,5632,11534,111822,19220,22146,13782,9695,643,3649,9204,3626,2983,50298,1983
52,"King and Queen, VA",11445,742,1410,994,31916,-1887,-2344,1239,56092,3284,9142,54205,21710,12217,10072,5929,410,940,1907,1318,908,8598,1983
53,"Lancaster, VA",61487,3397,5304,5454,53455,-902,-1108,6124,122327,10933,11893,121425,-1908,44925,23045,10210,1278,9825,8031,5051,3773,43631,1983
54,"Lee, VA",71876,3982,8341,6482,109753,1134,264,7223,199598,9981,7670,200732,45100,35287,55692,26172,2918,10245,11582,7466,4548,50049,1983
55,"Loudoun, VA",438968,19506,47000,37910,765131,-2903,-6295,38461,1053677,43436,17029,1050774,364624,233419,52224,61706,5841,37141,65955,27066,21225,335872,1983
56,"Louisa, VA",99035,5155,9933,9476,113743,47,-620,9893,177920,11460,9642,177967,24601,34833,29391,18457,1411,10840,14671,6304,4893,73524,1983
57,"Lunenburg, VA",48940,2610,5259,4836,57420,-602,-1966,5028,97778,6416,8103,97176,13508,21367,18389,11992,1235,4450,7677,4989,3754,36813,1983
58,"Madison, VA",29102,1429,2270,2000,52204,2493,1145,2429,88170,8075,8577,90663,25531,22811,15648,10570,1264,9220,3270,3239,1975,16612,1983
59,"Mathews, VA",22277,1295,1749,1464,55873,-21,-302,2027,99701,7786,12240,99680,35623,26507,17300,8144,948,7484,2481,2374,1426,12312,1983
60,"Mecklenburg, VA",177080,9272,16952,18094,158372,-102,-3254,18319,266583,17102,9068,266481,-389,61064,47045,29386,2601,13848,25999,15126,12525,137233,1983
61,"Middlesex, VA",35139,1885,3317,2974,49963,688,-488,3372,88311,7783,11188,88999,18196,22493,16543,7955,968,7295,4804,3486,2518,23040,1983
62,"Montgomery + Radford, VA*",604851,30029,69588,60476,493017,1175,-61,60267,721027,29016,9070,722202,-51567,142193,86992,79627,4097,28955,99826,38116,34019,476070,1983
63,"Nelson, VA",38847,2164,3420,3518,78867,778,-593,3923,121728,6927,9850,122506,43943,22761,20878,12437,1157,6334,5179,3796,2639,27334,1983
64,"New Kent, VA",22125,1273,2084,2032,81537,-988,-1151,2289,113952,4502,12545,112964,61701,20638,10789,9005,781,3351,3100,2235,1454,15674,1983
65,"Newport News (Independent City), VA",1880114,85065,262580,182412,1346632,0,0,176271,1876415,54955,12290,1876415,-357211,351339,178444,152677,5321,54955,353786,89583,84262,1471373,1983
66,"Norfolk (Independent City), VA",4721382,190544,764289,455004,2176302,0,0,418046,3417619,110171,12461,3417619,-2127034,863756,377561,274258,11069,110171,991791,230595,219526,3619420,1983
67,"Northampton, VA",70882,3718,7294,6718,58657,1254,-872,7077,116758,8800,8367,118012,-5148,31936,27419,14105,1167,7928,10653,6458,5291,52301,1983
68,"Northumberland, VA",37267,2196,3811,3406,48579,-2424,-2807,3899,105640,7533,10532,103216,15211,33300,21337,9800,1046,4726,5514,3384,2338,27027,1983
69,"Nottoway, VA",92897,4583,10723,11480,83015,308,-862,10323,143680,6745,9862,143988,441,31638,29335,14600,1217,5883,16463,6783,5566,70551,1983
70,"Orange, VA",94582,5127,8812,9314,116364,-1713,-3636,9784,198767,14255,10658,197054,31566,51000,29690,18489,1898,10619,13469,8051,6153,70494,1983
71,"Page, VA",82326,4375,7715,8356,113334,553,-665,8553,184459,10522,9375,185012,39561,38706,32972,19734,1702,9857,11893,7261,5559,60576,1983
72,"Patrick, VA",60134,3212,5540,5578,110730,1585,607,6001,161598,9093,9293,163183,56597,25377,27076,17559,2299,9700,8329,6400,4101,42105,1983
73,"Pittsylvania + Danville, VA*",762196,39596,69069,79526,749362,4826,312,79359,1097704,58715,9981,1102530,66525,182229,170939,110464,7693,59027,108832,51017,43324,594337,1983
74,"Portsmouth (Independent City), VA",1152685,37782,194303,90634,796915,0,0,83099,1227964,32025,11550,1227964,-272671,269185,161864,106319,4369,32025,239620,54366,49997,881040,1983
75,"Powhatan, VA",50608,2535,5625,4366,105864,718,-630,4718,143034,7695,10834,143752,59974,25619,12269,13269,845,7065,7808,3772,2927,35735,1983
76,"Prince Edward, VA",98715,5108,10016,9570,74511,786,-386,9893,130842,7966,7874,131628,-14311,30965,26152,16717,1320,7580,14801,8655,7335,76334,1983
77,"Prince George + Hopewell, VA*",588275,20554,102579,50496,353653,-447,-959,45802,529420,15590,10617,528973,-188820,121577,53743,49821,1632,14631,127827,24978,23346,445817,1983
78,"Prince William, Manassas + Manassas Park, VA*",1088906,50845,119224,103352,2158474,-90,-1040,102521,2742682,86450,14769,2742592,1172089,480538,103580,185702,7888,85410,170900,58989,51101,832596,1983
79,"Pulaski, VA",227378,11588,24395,23400,212409,2324,908,23288,322577,14093,9219,324901,8319,52676,59816,35242,1904,15001,36095,15219,13315,176282,1983
80,"Rappahannock, VA",17849,959,1265,1320,32890,290,-818,1619,59411,5782,9866,59701,16660,17859,8952,6051,854,4964,1925,2262,1408,10960,1983
81,"Richmond (Independent City), VA",4303327,211655,461803,433344,1906657,0,0,428327,3048191,170409,13998,3048191,-1968343,680061,461473,217758,25538,170409,678475,222924,197386,3454443,1983
82,"Richmond, VA",41364,2230,4354,3946,38376,-1227,-1554,4203,67855,4990,9632,66628,1215,16052,12200,6917,840,3436,6327,3381,2541,31601,1983
83,"Roanoke (Independent City), VA",1262670,64697,120237,145462,704593,0,0,137428,1143962,60926,11402,1143962,-420649,224077,215292,100328,10508,60926,192968,75617,65109,1008776,1983
84,"Roanoke + Salem, VA*",824815,40206,78778,85062,879031,306,-369,82737,1232282,65520,12608,1232588,136953,239952,113605,97760,4463,65151,121309,43968,39505,638355,1983
85,"Rockbridge, Buena Vista + Lexington, VA*",181740,9415,18490,18418,178304,463,-764,18624,284771,14685,8993,285234,15188,63078,43852,31719,2593,13921,27699,13630,11037,140120,1983
86,"Rockingham + Harrisonburg, VA*",589668,29353,58843,56914,513509,7067,-3425,57810,760460,59950,9645,767527,-18349,162394,91624,79575,8648,56525,87300,43301,34653,445843,1983
87,"Russell, VA",136563,6901,18046,14608,171549,1507,12,14205,268743,12851,8496,270250,49191,39896,58805,31809,2797,12863,25350,9449,6652,98350,1983
88,"Scott, VA",66066,3558,6662,5568,121876,3505,2880,6342,195103,10420,8007,198608,62152,34230,42502,24805,3436,13300,9446,7128,3692,43320,1983
89,"Shenandoah, VA",158337,8251,15419,15252,184489,782,-2220,15877,294283,19405,10378,295065,42029,66605,43971,28432,3089,17185,23045,13246,10157,118107,1983
90,"Smyth, VA",189574,9743,19944,17970,179281,1591,167,18728,284431,20666,8614,286022,8435,50904,55837,33205,2942,20833,28929,14571,11629,139812,1983
91,"Southampton + Franklin, VA*",107759,5891,11392,10620,126434,-2195,-4594,11201,224173,10448,8695,221978,29876,54277,41267,25530,1785,5854,16702,9496,7711,85203,1983
92,"Spotsylvania + Fredericksburg, VA*",357761,18411,32283,34432,480554,-311,-1183,35627,666869,38896,12577,666558,158420,123232,62772,52997,4314,37713,49499,25180,20866,270549,1983
93,"Stafford, VA",204275,9286,28090,19164,476310,-1303,-1634,18868,647925,21959,14418,646622,290903,133140,37172,44848,1866,20325,37672,11136,9270,146278,1983
94,"Suffolk (Independent City), VA",285969,14908,27652,28738,399950,555,-2111,29277,587801,19832,12289,588356,143258,104308,84098,47878,2337,17721,42021,18512,16175,226227,1983
95,"Surry, VA",55046,2917,5827,5746,32060,-2000,-2532,5790,56497,2464,9056,54497,-17196,13147,9290,6018,569,-68,8700,2599,2030,46414,1983
96,"Sussex, VA",38152,2223,3977,3672,58086,-3049,-4049,4059,103615,6772,9634,100566,23993,25391,17089,10439,792,2723,5813,3492,2700,29616,1983
97,"Tazewell, VA",254399,13135,27046,24106,284483,1658,823,25188,469155,29213,9228,470813,55272,84041,102289,51022,3485,30036,39099,16941,13456,185264,1983
98,Virginia,53078422,2421469,6309051,5047948,51511295,38787,-97615,4945443,74200199,3390104,13341,74238986,3378316,15607360,7120331,5564662,392505,3292489,8833025,2896818,2504313,40952908,1983
99,"Virginia Beach (Independent City), VA",2052696,91677,274794,196284,3345013,-332,-1635,189819,4584742,153193,15503,4584410,1482136,1016919,222478,295718,18826,151558,372936,130313,111487,1528202,1983
100,"Warren, VA",125896,6461,12965,11882,159370,318,-163,12402,241719,13454,10994,242037,45876,47950,34717,22015,1391,13291,18906,8548,7157,93699,1983
101,"Washington + Bristol, VA*",433303,21923,45089,42200,392343,1412,-2166,43023,608585,36035,9368,609997,2063,114995,102659,65113,6536,33869,66189,31905,25369,333245,1983
102,"Westmoreland, VA",40973,2303,4283,3352,75412,155,-1741,3979,140452,8298,9842,140607,38418,38043,27152,14286,1267,6557,5959,4703,3436,28457,1983
103,"Wise + Norton, VA*",445854,21449,59461,42894,338651,99,11,42896,519404,57408,10773,519503,-64307,77143,103709,48223,2791,57419,80908,20015,17224,307527,1983
104,"Wythe, VA",130322,6572,13003,12084,145296,5433,3542,12614,230132,11858,9237,235565,27588,45360,44909,25503,2465,15400,19045,10740,8275,95877,1983
105,"York + Poquoson, VA*",256477,9899,39278,21086,492404,944,117,20442,688742,20077,14943,689686,256369,155557,41725,46154,1983,20194,49821,13749,11766,186462,1983
0,"Accomack, VA",205063,9439,22445,17438,173988,11893,6984,18158,299346,24766,10016,311239,-12917,81085,56166,31074,2726,31750,31164,14890,12164,142149,1984
1,"Albemarle + Charlottesville, VA*",1167711,58265,117972,118728,874142,1192,-2279,117629,1371048,82366,13776,1372240,-175940,369738,128360,99612,8004,80087,177336,67762,59758,910288,1984
2,"Alexandria (Independent City), VA",2015428,87249,233125,191440,1763244,0,0,182969,2606276,96861,23645,2606276,-69215,684772,158260,110226,12646,96861,328845,90869,78223,1589722,1984
3,"Alleghany + Covington, VA*",220933,11975,20707,28412,173772,32,-63,26181,280611,13282,10531,280643,-20980,51785,55086,26649,1517,13219,34913,11473,9956,172801,1984
4,"Amelia, VA",36851,1619,2619,2618,63275,7378,5968,2928,84756,6601,11252,92134,29352,16695,12164,8188,909,12569,3928,2936,2027,20354,1984
5,"Amherst, VA",163249,8711,16620,16808,183241,-33,-435,17115,280252,15833,9687,280219,37107,56752,40226,28926,1733,15398,25024,10492,8759,122827,1984
6,"Appomattox, VA",60895,3231,5636,6160,80811,385,-47,6311,122375,8589,10160,122760,26227,23122,18827,12083,996,8542,8716,4792,3796,43637,1984
7,"Arlington, VA",5633279,211372,806163,507246,2566337,0,0,464995,3905780,192008,23938,3905780,-2601947,1138874,200569,163163,15086,192008,1059786,181837,166751,4381485,1984
8,"Augusta, Staunton + Waynesboro, VA*",819709,41806,77350,83678,726602,11926,6937,83645,1094566,68379,12058,1106492,-9462,234409,145481,91764,7735,75316,119189,46741,39006,625204,1984
9,"Bath, VA",104906,5406,8566,11588,49370,195,-82,11200,75876,2556,14100,76071,-44336,16218,10483,5395,488,2474,14360,4674,4186,88072,1984
10,"Bedford, VA*",181181,9913,16500,17904,365142,-827,-2504,18865,538899,26562,12152,538072,202826,109728,63202,44277,3992,24058,25452,14090,10098,131671,1984
11,"Bland, VA",25933,1376,2550,2496,36942,1249,859,2624,55114,3195,8749,56363,13633,9717,9704,6442,735,4054,3798,2112,1377,18081,1984
12,"Botetourt, VA",94289,5166,8336,11938,201591,742,-479,11135,284868,16181,12227,285610,118437,52160,31859,23359,2062,15702,14305,6498,4436,64282,1984
13,"Brunswick, VA",79178,3948,7190,7306,89074,6608,4827,7601,136670,9260,8973,143278,17497,27734,26470,15968,1270,14087,10843,6203,4933,54248,1984
14,"Buchanan, VA",407826,19474,47260,38930,275718,262,242,38939,397970,76364,10942,398232,-93169,54570,67944,36396,1955,76606,66725,14308,12353,264495,1984
15,"Buckingham, VA",46207,2464,4475,4018,70434,1724,1280,4473,112430,7046,9148,114154,28700,22457,21263,12479,1015,8326,6484,3616,2601,31397,1984
16,"Campbell + Lynchburg, VA*",1318266,67416,121861,142314,874815,3534,2306,138573,1353405,74748,12011,1356939,-304878,274609,207515,112974,6757,77054,193018,70610,63853,1048194,1984
17,"Caroline, VA",76849,3573,8274,6416,142008,4939,4343,6781,202531,10787,11338,207470,71940,39196,26266,18299,1004,15130,11482,4772,3768,50237,1984
18,"Carroll + Galax, VA*",200867,10692,19223,20802,186045,2368,1149,21093,311892,21524,9241,314260,6271,59808,68407,34007,3447,22673,29624,16470,13023,148570,1984
19,"Charles City, VA",12085,622,1188,968,50889,997,627,1106,69512,2275,10776,70509,39910,12008,7612,6543,231,2902,1672,966,735,7511,1984
20,"Charlotte, VA",48910,2516,4010,4418,64639,4638,3109,4725,103479,7962,9072,108117,20454,23583,19895,11918,1612,11071,6219,4624,3012,31620,1984
21,"Chesapeake (Independent City), VA",656963,33979,62515,69618,1339279,3771,1610,68788,1759941,57096,14200,1763712,751104,284343,140090,124209,5770,58706,97324,39027,33257,500933,1984
22,"Chesterfield, VA",1249588,59344,128224,123744,2068062,1289,839,121216,2591034,95416,16204,2592323,939690,400615,123646,159979,9571,96255,190096,63434,53863,963237,1984
23,"Clarke, VA",72278,3470,6791,6594,102008,1533,-949,6767,151719,11006,14293,153252,36497,37218,14026,10722,1558,10057,10088,5604,4046,52133,1984
24,"Craig, VA",9173,510,970,834,26045,374,219,927,41389,1640,10226,41763,17799,9282,6436,4084,419,1859,1387,994,575,5927,1984
25,"Culpeper, VA",160933,8292,15975,15794,195426,1655,-800,16189,292972,17837,12609,294627,50682,63880,35321,23366,2276,17037,23872,11214,8938,120024,1984
26,"Cumberland, VA",23064,970,1417,1298,46116,6094,5075,1619,68366,5617,9487,74460,24671,14530,13814,7849,679,10692,2066,1812,1133,10306,1984
27,"Dickenson, VA",161540,7938,17954,14870,143205,108,79,15373,212553,33952,10713,212661,-2962,26502,42954,19851,923,34031,25389,5743,4820,102120,1984
28,"Dinwiddie, Colonial Heights + Petersburg, VA*",509125,26542,54427,51734,584092,5232,4091,52409,944116,44647,12255,949348,127376,201391,163865,77466,4014,48738,80294,31997,27983,380093,1984
29,"Essex, VA",51310,2694,4394,4838,52823,1442,681,5113,92153,6981,10561,93595,6626,24457,16315,8862,920,7662,6813,4380,3460,36835,1984
30,"Fairfax, Fairfax City + Falls Church, VA*",8538071,391129,800310,820738,11493348,1294,-120,801498,15192688,669621,21194,15193982,3756775,3170340,530294,716913,56790,669501,1210679,385912,329122,6657891,1984
31,"Fauquier, VA",235090,11018,24352,20292,444791,2841,-1244,21164,650544,38660,16681,653385,230865,164207,44387,39169,4175,37416,34498,16591,12416,163176,1984
32,"Floyd, VA",39460,2059,2958,3202,75939,3238,2393,3660,115492,9327,10144,118730,40139,23900,18891,11704,1833,11720,4559,4004,2171,23181,1984
33,"Fluvanna, VA",35638,1982,3275,3334,69175,-258,-713,3649,114127,6944,10815,113869,37186,28055,16639,10529,938,6231,4942,2895,1957,24465,1984
34,"Franklin, VA",170440,8856,14769,16614,266366,4121,1026,17163,387710,24512,10685,391831,113089,75085,50380,36672,3456,25538,23076,13694,10238,121826,1984
35,"Frederick + Winchester, VA*",561565,28219,49339,56818,454038,6017,2237,56628,656594,58092,11711,662611,-50899,135213,73360,56579,4512,60329,77748,32022,27510,423488,1984
36,"Giles, VA",123690,6469,13713,13174,115424,322,55,13056,181233,8674,10448,181555,4790,33208,32923,17377,1378,8729,20300,7159,5781,94661,1984
37,"Gloucester, VA",91790,4922,8211,8318,210824,1182,732,9081,311690,15428,13002,312872,128115,70870,31178,24064,1952,16160,12370,7178,5226,63260,1984
38,"Goochland, VA",54150,2833,4085,4484,128060,592,88,5075,187096,13413,15079,187688,78985,42514,17114,12447,1146,13501,6327,3662,2516,34322,1984
39,"Grayson, VA",66010,3504,5455,6640,95632,3828,3031,6824,147026,7949,9051,150854,36446,27756,27466,16668,1817,10980,8775,5993,4176,46255,1984
40,"Greene, VA",19228,1034,1508,1346,61386,840,647,1707,88628,5773,10484,89468,43865,17439,10643,8534,738,6420,2181,1704,966,10627,1984
41,"Greensville + Emporia, VA*",107799,5544,9947,11076,88754,3338,2504,11082,142371,7086,9587,145709,-7963,27410,29545,15199,895,9590,15485,7421,6526,82724,1984
42,"Halifax, VA",217729,11087,18566,22018,225653,12915,10172,22096,342837,19441,9704,355752,30020,68122,61977,36662,4194,29613,29575,16541,12347,158541,1984
43,"Hampton (Independent City), VA",1380646,54006,221571,130314,1129359,0,0,119163,1645480,41293,12962,1645480,-132124,366324,149797,126944,4256,41293,286728,67483,63227,1052625,1984
44,"Hanover, VA",443398,22827,33321,45342,579917,5134,3309,45498,793041,47950,15264,798175,182017,153761,64497,52291,4582,51259,55992,25707,21125,336147,1984
45,"Henrico, VA",1870892,95055,157021,198390,2219976,1259,694,194250,3112985,116541,16034,3114244,543334,659137,235131,194225,5891,117235,256216,93176,87285,1497441,1984
46,"Henry + Martinsville, VA*",776144,39807,72529,87672,584649,521,199,83643,869827,43171,11655,870348,-107852,179101,106598,74675,4263,43370,116365,46358,42095,616409,1984
47,"Highland, VA",9840,501,755,682,17602,1286,1007,842,27653,2431,9890,28939,8604,6628,4709,2926,609,3438,1096,1214,605,5306,1984
48,"Isle of Wight, VA",226401,11373,21442,24268,220258,3527,1866,23507,302200,11104,13472,305727,17364,53744,31725,22693,1486,12970,33576,11527,10041,179855,1984
49,"James City + Williamsburg, VA*",459301,23120,43113,48050,357486,1295,866,47145,526783,24239,14276,528078,-54670,122654,47938,36991,2745,25105,67138,28081,25336,367058,1984
50,"King George, VA",188996,4587,34475,12280,112958,1292,992,10727,164182,6770,15131,165474,-65311,41584,10932,10936,1564,7762,40615,7328,5764,140619,1984
51,"King William, VA",79794,3998,6629,7878,89068,3393,2687,7937,125975,6637,13396,129368,17211,25721,14579,9657,676,9324,10568,3978,3302,59902,1984
52,"King and Queen, VA",18067,862,1559,1190,40540,2981,2551,1457,61701,3670,10759,64682,23930,13495,10647,6012,470,6221,2154,1429,959,9692,1984
53,"Lancaster, VA",66411,3644,5476,6090,57768,1144,942,6689,134190,10401,13072,135334,-1954,53175,24391,10353,1248,11343,8521,5003,3755,46547,1984
54,"Lee, VA",80905,4524,8412,7446,120798,3230,2435,8247,212812,11727,8282,216042,48140,36723,58521,26085,2899,14162,12135,7480,4581,54608,1984
55,"Loudoun, VA",506665,22915,50555,45688,879557,2526,-826,45759,1196029,55029,18680,1198555,418651,262155,56843,64163,6436,54203,73399,29186,22750,379063,1984
56,"Louisa, VA",122016,6320,10971,12196,132700,1926,1299,12418,200197,13816,10888,202123,23102,38207,31216,18563,1483,15115,17069,6588,5105,89832,1984
57,"Lunenburg, VA",57293,2840,5489,5462,66740,4616,3349,5571,104627,6430,9188,109243,15018,23246,19257,11890,1196,9779,8220,5001,3805,39294,1984
58,"Madison, VA",33879,1601,2432,2256,59247,4928,3591,2729,97958,9164,9501,102886,28097,26911,16728,10829,1321,12755,3560,3302,1981,17564,1984
59,"Mathews, VA",22638,1347,1728,1536,59876,851,524,2115,109732,7453,13411,110583,39353,32277,18430,8246,911,7977,2496,2207,1296,12165,1984
60,"Mecklenburg, VA",197523,10088,17774,20560,177321,8108,5047,20368,286232,17244,9926,294340,166,67293,49726,29652,2521,22291,28054,15243,12722,147178,1984
61,"Middlesex, VA",38555,2092,3601,3416,54410,1465,461,3800,100025,7698,12611,101490,19655,29309,17771,8048,949,8159,5309,3515,2566,25087,1984
62,"Montgomery + Radford, VA*",682734,34423,77626,71936,554575,1584,338,70391,804949,31943,9980,806533,-57768,161131,90827,80811,4312,32281,113594,40362,36050,536859,1984
63,"Nelson, VA",46431,2603,3885,4154,86371,1159,-47,4680,133164,9517,10745,134323,44620,26327,21625,12501,1196,9470,5962,4133,2937,30999,1984
64,"New Kent, VA",27563,1517,2343,2464,90118,339,185,2749,124919,5812,13733,125258,65304,23611,11529,9121,804,5997,3575,2282,1478,17991,1984
65,"Newport News (Independent City), VA",2078087,95614,272542,208888,1480909,0,0,200058,2063304,67878,13368,2063304,-397120,392924,189471,154351,5866,67878,376986,93316,87450,1633223,1984
66,"Norfolk (Independent City), VA",5143519,211170,820343,516494,2290892,0,0,469417,3623204,115312,13092,3623204,-2383210,941449,390863,276757,10723,115312,1078590,236945,226222,3949617,1984
67,"Northampton, VA",79126,4023,7690,7430,67215,5550,3399,7738,125948,9277,9499,131498,-4173,35514,28769,13844,1119,12676,11405,6371,5252,55045,1984
68,"Northumberland, VA",40493,2251,3668,3446,52630,1144,786,3974,117505,8206,11927,118649,16111,43053,22966,9948,1058,8992,5391,3336,2278,26110,1984
69,"Nottoway, VA",107668,5177,12415,13102,94395,4733,3568,11728,157072,7316,11158,161805,-1545,36054,31356,14501,1172,10884,18966,7005,5833,77818,1984
70,"Orange, VA",107818,5786,9689,10818,131196,691,-1196,11195,217111,16053,11591,217802,34573,55192,31414,18791,1916,14857,15098,8295,6379,77863,1984
71,"Page, VA",96999,4966,8329,9594,131082,5583,4389,9763,203600,13091,10503,209183,43846,42594,35507,19917,1742,17480,13126,7363,5621,66393,1984
72,"Patrick, VA",74126,3947,6389,7326,124667,2818,1872,7610,178247,10475,10322,181065,58151,28705,27693,17541,2190,12347,10052,6756,4566,51727,1984
73,"Pittsylvania + Danville, VA*",812432,42074,69966,87804,800523,19112,14693,85976,1180715,62180,10901,1199827,74067,218446,180858,110065,7586,76873,113868,51216,43630,621691,1984
74,"Portsmouth (Independent City), VA",1238975,41720,208451,101742,854195,0,0,92591,1316840,34214,12324,1316840,-292189,296110,166535,106852,4190,34214,259322,55317,51127,945439,1984
75,"Powhatan, VA",52826,2688,5596,4754,110732,1655,259,5065,150385,8448,11412,152040,62971,28247,13061,13323,867,8707,7973,3633,2766,36146,1984
76,"Prince Edward, VA",108002,5620,10604,10802,81196,1968,814,11021,141237,9666,8601,143205,-15785,34321,27688,16650,1329,10480,16005,8677,7348,81517,1984
77,"Prince George + Hopewell, VA*",630685,22353,108562,55530,384285,2026,1528,50118,570618,17638,11523,572644,-196282,131555,56804,49695,1732,19166,136327,25485,23753,475192,1984
78,"Prince William, Manassas + Manassas Park, VA*",1285359,60652,134940,126600,2470679,396,-528,123952,3123192,108996,16303,3123588,1309272,542251,110658,191597,9538,108468,198240,65166,55628,978651,1984
79,"Pulaski, VA",272695,14003,29151,29614,245077,1306,-149,28810,365296,15918,10387,366602,1192,59704,61821,35295,1920,15769,43958,16655,14735,212968,1984
80,"Rappahannock, VA",21500,1126,1479,1588,38774,896,-187,1920,68998,7041,11284,69894,19194,21687,9433,6194,892,6854,2273,2352,1460,12373,1984
81,"Richmond (Independent City), VA",4626545,229906,480555,484896,2060477,0,0,472354,3311004,225170,15404,3311004,-2093714,771458,479069,214947,23434,225170,723003,223816,200382,3678372,1984
82,"Richmond, VA",45543,2368,4466,4308,42561,1308,948,4522,75058,5089,11227,76366,1540,20651,13154,6802,771,6037,6620,3459,2688,32886,1984
83,"Roanoke (Independent City), VA",1416178,73474,131682,171192,779647,0,0,159070,1273614,76973,12745,1273614,-477461,272034,221933,99934,9456,76973,217278,77428,67972,1121927,1984
84,"Roanoke + Salem, VA*",939380,46317,87030,102784,995987,2019,1236,97709,1394424,73380,14164,1396443,154316,278401,122055,98594,5307,74616,138422,47750,42443,726342,1984
85,"Rockbridge, Buena Vista + Lexington, VA*",194154,10261,18799,20708,188119,538,-623,20615,305625,16340,9766,306163,14580,72645,45399,31349,2608,15717,29153,13592,10984,149284,1984
86,"Rockingham + Harrisonburg, VA*",683908,32825,62797,65608,599456,38857,28027,65629,839999,68047,11024,878856,-18823,182142,97258,79725,8562,96074,95601,44841,36279,492233,1984
87,"Russell, VA",147512,7761,16441,16692,184113,1295,-41,16107,286584,15357,9129,287879,52708,45374,58392,31536,2819,15316,24787,9727,6908,107409,1984
88,"Scott, VA",70491,3960,6966,6438,127803,3086,2502,7179,208353,10486,8593,211439,64491,38043,45593,24607,3297,12988,10185,7183,3886,47318,1984
89,"Shenandoah, VA",189326,9627,17315,18500,213524,7032,4080,18877,328268,22881,11661,335300,43075,75419,46357,28755,3081,26961,26565,14162,11081,135800,1984
90,"Smyth, VA",211092,10933,21171,21008,197318,3993,2634,21437,309015,21891,9493,313008,7663,57094,58596,32974,2942,24525,31675,14996,12054,154892,1984
91,"Southampton + Franklin, VA*",133444,6721,12620,12700,156621,10447,8030,13071,248142,10930,10172,258589,36248,58579,43389,25422,1757,18960,18970,9803,8046,95514,1984
92,"Spotsylvania + Fredericksburg, VA*",413450,21381,35721,40956,556045,524,-303,41859,766721,50874,14077,767245,184454,144419,66781,54503,4574,50571,56199,27068,22494,306680,1984
93,"Stafford, VA",227054,10538,29209,21700,537640,-555,-875,21388,729119,28852,15695,728564,331974,150432,40492,46420,2372,27977,40059,12121,9749,159018,1984
94,"Suffolk (Independent City), VA",322229,16648,29461,33376,446705,7604,4872,33336,645903,21576,13608,653507,157812,116780,90022,48025,2426,26448,46149,18992,16566,249632,1984
95,"Surry, VA",69256,3448,6385,7176,37828,2423,1878,7036,59992,2496,10214,62415,-24392,14905,9682,6111,550,4374,9973,2778,2228,54909,1984
96,"Sussex, VA",47499,2410,4125,4202,68307,4172,3209,4511,108423,6025,10811,112595,25319,26331,17957,10415,746,9234,6226,3390,2644,32039,1984
97,"Tazewell, VA",269321,14275,26132,26808,308629,1493,661,27679,502281,33702,10089,503774,66987,92278,102867,49933,3485,34363,39536,17132,13647,195422,1984
98,Virginia,59515460,2749775,6765372,5904886,57388025,321131,187120,5702218,82317103,3968624,14642,82638234,3574783,17718899,7531310,5643868,406722,4155744,9717815,3041492,2634770,45641901,1984
99,"Virginia Beach (Independent City), VA",2340708,106730,302162,234966,3763507,2354,1067,224213,5157758,172934,16647,5160112,1647012,1152004,244601,309977,19766,174001,419645,141034,121268,1747062,1984
100,"Warren, VA",143193,7391,14706,13974,183467,306,-124,14378,273788,16087,12308,274094,54652,54042,36585,22269,1537,15963,21693,9132,7595,105537,1984
101,"Washington + Bristol, VA*",484885,24672,48211,49446,427743,4907,1490,49395,661583,39569,10252,666490,-7747,131262,107485,65013,6580,41059,72934,33124,26544,370892,1984
102,"Westmoreland, VA",46375,2546,4551,3886,85837,2590,706,4489,154658,8013,10915,157248,43951,42202,29209,14406,1267,8719,6494,4730,3463,31162,1984
103,"Wise + Norton, VA*",493755,24558,52741,50072,374286,178,96,49594,560313,77700,11690,560491,-69875,80256,105949,47946,2865,77796,77777,20542,17677,338182,1984
104,"Wythe, VA",149272,7737,14349,14742,165873,4315,2481,15108,258418,14483,10352,262733,31709,50390,46470,25380,2457,16964,21720,11323,8866,110588,1984
105,"York + Poquoson, VA*",290239,11440,44031,24942,538266,833,57,23911,760192,21763,16108,761025,271938,176081,46678,47245,2531,21820,56502,15182,12651,211917,1984
0,"Accomack, VA",229927,11525,25149,19364,195538,8770,3383,21207,333471,36509,11013,342241,-13182,87447,59256,31075,2536,39892,34831,15356,12820,155204,1985
1,"Albemarle + Charlottesville, VA*",1273734,66899,132446,127724,955949,2336,-996,130761,1495127,94334,14754,1497463,-187024,404185,137329,101492,8800,93338,196308,69554,60754,984088,1985
2,"Alexandria (Independent City), VA",2245208,104977,255623,216298,1898024,0,0,213126,2762958,112858,24819,2762958,-134058,699167,165767,111324,12831,112858,363772,96116,83285,1768578,1985
3,"Alleghany + Covington, VA*",239304,13598,23634,30378,185006,-76,-159,28787,297105,13716,11242,297029,-25511,54192,57831,26422,1547,13557,38823,11962,10415,186924,1985
4,"Amelia, VA",39168,1864,3048,2812,67254,6955,5494,3270,91511,7278,11898,98466,31356,18332,12880,8276,936,12772,4454,3019,2083,21942,1985
5,"Amherst, VA",175973,9910,18986,18038,192816,-582,-962,18929,295153,16328,10258,294571,35772,59637,42118,28715,1809,15366,28005,10869,9060,132602,1985
6,"Appomattox, VA",67615,3794,6759,6744,86347,-150,-567,7166,131616,9685,10843,131466,25898,24974,20145,12124,1079,9118,10131,5076,3997,48366,1985
7,"Arlington, VA",6162951,250899,871949,569584,2771586,0,0,535691,4160193,215361,25159,4160193,-2855674,1178956,209651,165356,15685,215361,1156741,188874,173189,4790849,1985
8,"Augusta, Staunton + Waynesboro, VA*",856582,45704,85584,85866,762724,14271,9129,88637,1155568,70674,12737,1169839,-5221,250295,156820,91846,8077,79803,128517,47500,39423,648262,1985
9,"Bath, VA",85032,4608,7329,9134,46384,-377,-639,9175,72507,2749,13533,72130,-29473,15052,10694,5330,480,2110,11896,3686,3206,71026,1985
10,"Bedford, VA*",195233,11277,18939,19326,398163,-1099,-2727,20940,587134,26594,12948,586035,223870,119250,68622,45261,4246,23867,28602,14883,10637,142764,1985
11,"Bland, VA",30175,1682,3238,2878,40548,1095,719,3121,59788,3831,9457,60883,13494,10170,10165,6438,771,4550,4677,2296,1525,20948,1985
12,"Botetourt, VA",103294,6030,9744,12584,217850,532,-727,12322,306686,17106,12898,307218,126878,56201,33167,23819,2146,16379,16036,6919,4773,70879,1985
13,"Brunswick, VA",82864,4488,8337,7880,91722,4347,2613,8428,144442,9094,9362,148789,17286,29082,27985,15893,1201,11707,12277,6320,5119,58880,1985
14,"Buchanan, VA",389393,20261,40263,37940,265035,173,149,39231,389899,70223,10962,390072,-85127,54467,70570,35585,1912,70372,59233,14172,12260,259788,1985
15,"Buckingham, VA",50062,2836,5050,4366,74230,1502,1012,5019,118564,8180,9615,120066,29187,24093,21743,12488,1157,9192,7233,3786,2629,33637,1985
16,"Campbell + Lynchburg, VA*",1378916,73790,131756,147228,923843,2443,1241,147404,1441055,75810,12777,1443498,-307669,288977,230678,112974,7160,77051,205370,71474,64314,1096495,1985
17,"Caroline, VA",83006,4233,9629,7178,151936,2672,2159,7822,218881,11860,12158,221553,76752,41587,28030,18223,1142,14019,13218,5163,4021,55769,1985
18,"Carroll + Galax, VA*",207147,11613,21336,21194,192598,1357,152,22210,326213,22163,9685,327570,7661,61237,73735,33824,3422,22315,31933,16516,13094,152899,1985
19,"Charles City, VA",12363,730,1352,1078,53712,137,-200,1269,74010,2777,11355,74147,42618,12647,7788,6530,251,2577,1891,986,735,7895,1985
20,"Charlotte, VA",49079,2785,4583,4614,64608,2623,1179,5092,108186,7930,9424,110809,20621,25158,21043,11758,1568,9109,6890,4578,3010,33080,1985
21,"Chesapeake (Independent City), VA",743331,40449,74732,78642,1475534,1952,-312,79770,1935147,60219,15038,1937099,811973,311190,150375,128814,6282,59907,114053,42229,35947,569371,1985
22,"Chesterfield, VA",1382003,69169,148118,136384,2291177,1221,772,137361,2868986,100289,17233,2870207,1046535,442863,136167,166556,10732,101061,216310,67963,57231,1064632,1985
23,"Clarke, VA",74338,3947,7167,6916,108387,359,-2037,7405,161959,11565,14852,162318,41454,39232,14699,10929,1489,9528,10625,5531,4042,54185,1985
24,"Craig, VA",10150,598,1172,926,28611,158,11,1061,44615,1636,10870,44773,19522,9575,6587,4119,437,1647,1635,1077,640,6868,1985
25,"Culpeper, VA",178922,9767,18712,17698,220295,92,-2231,18616,328646,19420,13767,328738,59989,70248,38195,23879,2362,17189,27561,11835,9473,134172,1985
26,"Cumberland, VA",24848,1131,1685,1444,49247,6247,5121,1853,72780,6076,10028,79027,26252,15371,14409,7881,761,11197,2407,1929,1168,11244,1985
27,"Dickenson, VA",150458,8080,14658,13448,138023,32,8,14804,213120,35767,10856,213152,2369,29615,45514,19635,979,35775,21382,5562,4583,93301,1985
28,"Dinwiddie, Colonial Heights + Petersburg, VA*",528414,29214,58964,53522,605332,1914,742,55975,995438,46818,12923,997352,132893,212959,179061,77178,4183,47560,85725,32570,28387,395129,1985
29,"Essex, VA",52680,3061,5060,5160,53761,-1301,-1970,5641,97396,7611,10914,96095,6722,25170,17164,8805,886,5641,7640,4439,3553,39399,1985
30,"Fairfax, Fairfax City + Falls Church, VA*",9938445,487210,930413,966284,12848869,1187,-350,970352,16901624,775785,22713,16902811,3880776,3479991,573951,744202,63602,775435,1413555,424176,360574,7749455,1985
31,"Fauquier, VA",279545,13794,30586,24384,507829,1594,-2327,25986,735660,42800,18066,737254,254270,182593,46832,40809,4625,40473,42778,18077,13452,196294,1985
32,"Floyd, VA",43156,2374,3451,3338,80909,3545,2724,4043,122218,10805,10767,125763,41796,25293,19561,11680,1848,13529,5120,4062,2214,24507,1985
33,"Fluvanna, VA",34905,2120,3463,3182,73379,-692,-1134,3711,121744,7228,11247,121052,42185,29883,17790,10763,1052,6094,5054,2893,1841,23757,1985
34,"Franklin, VA",180736,9870,16942,17528,285777,5005,1862,18634,413479,23658,11333,418484,123675,80283,52424,36926,3361,25520,25706,13783,10422,129510,1985
35,"Frederick + Winchester, VA*",615766,32736,55785,61876,502444,2556,-1293,63674,726354,64537,12739,728910,-49648,149287,77179,57218,5058,63244,86723,33952,28894,465799,1985
36,"Giles, VA",129176,7107,15131,13550,120592,-247,-487,13882,190540,8434,11076,190293,5298,34889,34812,17180,1328,7947,21906,7089,5761,99323,1985
37,"Gloucester, VA",104366,6017,9594,9226,237862,-543,-1002,10630,349591,20627,13650,349048,144126,76905,34281,25572,2090,19625,14207,7683,5593,70534,1985
38,"Goochland, VA",60330,3408,4751,4972,142431,66,-382,5894,209047,15536,16511,209113,87995,48873,17809,12665,1377,15154,7237,3973,2596,37939,1985
39,"Grayson, VA",62696,3580,6025,6112,94281,2392,1602,6636,150132,8362,9243,152524,38221,29351,28892,16501,1906,9964,9081,5793,3887,43651,1985
40,"Greene, VA",20609,1209,1825,1496,66113,412,217,1957,95626,5996,10926,96038,47461,18701,11224,8790,827,6213,2573,1845,1018,11823,1985
41,"Greensville + Emporia, VA*",115394,6310,11520,12104,92344,876,47,12362,151464,6763,10109,152340,-10688,28444,31552,15069,895,6810,17572,7701,6806,91012,1985
42,"Halifax, VA",220678,12180,20982,22660,226317,5783,3216,23510,358305,19741,9965,364088,29149,71988,65783,36535,3982,22957,32312,16500,12518,165409,1985
43,"Hampton (Independent City), VA",1456416,61050,234028,139786,1211457,0,0,130943,1758179,42652,13887,1758179,-114016,387673,159049,126607,4801,42652,303921,69692,64891,1109843,1985
44,"Hanover, VA",484741,26262,39038,49072,629216,3471,1556,50798,861087,52188,16270,864558,195273,165418,69924,53138,4792,53744,63574,26625,21833,367423,1985
45,"Henrico, VA",2083434,110897,179419,220358,2450031,1261,640,221076,3420528,117868,17304,3421789,587673,720344,251414,197750,8105,118508,289598,101101,92996,1675328,1985
46,"Henry + Martinsville, VA*",810923,43402,80208,90286,611639,-289,-557,88545,916904,44442,12253,916615,-110739,189933,115043,74809,4451,43885,125351,47182,42731,641687,1985
47,"Highland, VA",10146,564,834,710,16636,1120,839,919,27347,2591,10178,28467,7409,7004,4827,2797,610,3430,1189,1230,620,5527,1985
48,"Isle of Wight, VA",237991,12490,22600,25086,238087,4126,2480,25033,324247,11800,14122,328373,25129,56588,33698,23252,1550,14280,35143,11163,9613,188568,1985
49,"James City + Williamsburg, VA*",516288,27311,49798,53748,404212,661,235,54185,583437,27290,15314,584098,-57891,125291,54595,38142,3027,27525,76672,30382,27355,412091,1985
50,"King George, VA",195619,5871,35600,14242,119705,-112,-379,12992,176798,8375,15447,176686,-62922,44862,12119,11438,1498,7996,42721,7583,6085,144902,1985
51,"King William, VA",87563,4734,7667,8888,95291,972,322,9178,137474,6988,14181,138446,16906,27904,15251,9763,725,7310,12111,4241,3516,68142,1985
52,"King and Queen, VA",17306,980,2060,1374,41864,714,314,1667,67001,3355,10984,67715,26225,14977,10874,6165,540,3669,2747,1547,1007,10890,1985
53,"Lancaster, VA",72222,4265,6217,6720,61952,-195,-381,7625,144792,11407,13809,144597,-2645,56319,26326,10471,1225,11026,9577,5186,3961,51619,1985
54,"Lee, VA",83738,5041,9177,7994,121211,1285,553,9038,219265,11135,8552,220550,46511,37141,62198,25789,2898,11688,13174,7535,4637,58876,1985
55,"Loudoun, VA",595300,29219,59889,55582,995992,-291,-3639,57010,1354556,61948,20145,1354265,457702,297034,61239,67225,7195,58309,87680,31981,24786,449311,1985
56,"Louisa, VA",116472,6399,11518,11188,133735,1287,681,11993,206365,13979,11067,207652,29256,40780,33137,18763,1580,14660,17112,6647,5067,84700,1985
57,"Lunenburg, VA",54845,3048,6020,5532,65700,970,-229,5814,109027,6088,9348,109997,16669,24203,20094,11767,1182,5859,8786,4909,3727,40200,1985
58,"Madison, VA",34524,1877,2909,2514,61902,2516,1176,3134,105653,9593,10018,108169,30512,29070,17197,10798,1392,10769,4166,3415,2023,19589,1985
59,"Mathews, VA",24372,1597,1914,1632,64930,-3,-395,2413,118020,9150,14209,118017,42971,33702,19385,8306,866,8755,2730,2136,1270,12887,1985
60,"Mecklenburg, VA",207515,11359,20246,21886,185121,4247,1213,22302,306181,16189,10521,310428,-92,71862,53445,29506,2475,17402,31189,15511,13036,158924,1985
61,"Middlesex, VA",41977,2487,4178,3708,59703,206,-652,4341,110302,9402,13436,110508,22067,31650,19155,8225,925,8750,6032,3594,2669,27195,1985
62,"Montgomery + Radford, VA*",731391,38660,87511,76352,597651,1154,-116,76836,869370,33252,10639,870524,-56904,174488,98385,81823,4648,33136,125687,41649,37001,572568,1985
63,"Nelson, VA",49710,3018,4423,4544,88615,-119,-1153,5290,140078,10553,11176,139959,44195,28726,22618,12523,1265,9400,6695,4278,3013,33615,1985
64,"New Kent, VA",30451,1817,2782,2804,97538,-447,-594,3219,134881,6535,14537,134434,70306,24555,12341,9248,839,5941,4184,2411,1572,20326,1985
65,"Newport News (Independent City), VA",2297992,111683,293821,229670,1607859,0,0,226518,2236298,80831,14251,2236298,-463615,425437,203002,156924,6554,80831,408656,97483,90929,1808505,1985
66,"Norfolk (Independent City), VA",5506401,236812,882317,556042,2368461,0,0,514833,3748419,117483,14061,3748419,-2623107,977650,402308,266585,10603,117483,1160338,242855,232252,4228580,1985
67,"Northampton, VA",81176,4585,8603,7892,69384,1089,-1131,8531,135996,11106,10010,137085,-3261,37440,30261,13695,1083,9975,12549,6385,5302,58652,1985
68,"Northumberland, VA",43712,2667,4148,3680,56093,-397,-732,4507,126717,10566,12710,126320,16888,46290,23937,9939,1082,9834,5988,3435,2353,27890,1985
69,"Nottoway, VA",113901,5951,13991,13924,97617,3783,2618,12913,165603,7661,11198,169386,-3371,38080,33689,15126,1145,10279,20953,6955,5810,82669,1985
70,"Orange, VA",116024,6530,10977,11424,141532,1731,-128,12242,234481,16234,12408,236212,37750,60703,33977,19037,1963,16106,16689,8486,6523,83229,1985
71,"Page, VA",106374,5677,9500,10194,142119,6889,5692,10774,218127,14526,11208,225016,46519,45726,37171,20076,1793,20218,14597,7432,5639,71559,1985
72,"Patrick, VA",80536,4542,7475,7954,130661,2316,1380,8519,188818,11163,10949,191134,58644,31734,28739,17457,2113,12543,11452,6884,4771,56541,1985
73,"Pittsylvania + Danville, VA*",827314,45392,76596,89130,812366,10895,6455,89957,1223579,61921,11251,1234474,75009,228173,193935,109724,7605,68376,121161,50585,42980,637777,1985
74,"Portsmouth (Independent City), VA",1290098,48703,217414,112116,897528,0,0,104761,1376460,35228,12917,1376460,-287809,305270,173662,106562,4054,35228,273472,56304,52250,981398,1985
75,"Powhatan, VA",52154,2889,5625,4760,117612,1256,-242,5269,160912,8373,12357,162168,70727,30637,13919,13124,907,8131,8005,3519,2612,36018,1985
76,"Prince Edward, VA",113297,6241,11809,11250,84972,1157,16,11866,149330,10919,9037,150487,-16459,35138,30377,16652,1365,10935,17434,8766,7401,84928,1985
77,"Prince George + Hopewell, VA*",626130,24837,108144,57802,402790,379,-121,53738,598507,19077,11966,598886,-169602,134718,61378,50051,1870,18956,137045,26507,24637,470129,1985
78,"Prince William, Manassas + Manassas Park, VA*",1467913,73212,157786,144328,2772198,-305,-1199,145376,3479937,121884,17439,3479632,1449661,587100,120334,199527,11431,120685,229950,72322,60891,1117278,1985
79,"Pulaski, VA",300589,16043,34370,32340,262197,790,-738,32213,387716,16458,11027,388506,-6179,61953,64356,35233,1969,15720,50540,17489,15520,234329,1985
80,"Rappahannock, VA",21653,1292,1708,1616,42819,-328,-1398,2100,75563,7797,12158,75235,23266,22533,9883,6188,950,6399,2516,2365,1415,12738,1985
81,"Richmond (Independent City), VA",5030983,262097,537890,526178,2178632,0,0,525186,3484152,216461,16378,3484152,-2327165,799098,506422,212730,21534,216461,800979,227969,206435,4013543,1985
82,"Richmond, VA",46964,2676,4895,4654,42762,-508,-908,5003,80104,5266,11584,79596,801,22057,14777,6871,713,4358,7222,3362,2649,35384,1985
83,"Roanoke (Independent City), VA",1551061,84390,150169,184602,840323,0,0,176691,1349337,90224,13630,1349337,-534047,274808,234206,99000,8541,90224,242470,79970,71429,1218367,1985
84,"Roanoke + Salem, VA*",1021266,53219,99121,111346,1091141,2520,1630,108892,1530981,78641,15436,1533501,178767,305995,136365,99344,6326,80271,154794,50953,44627,786201,1985
85,"Rockbridge, Buena Vista + Lexington, VA*",209802,11542,21307,22078,199939,1433,319,22581,323180,17134,10395,324613,12718,76455,48219,31228,2673,17453,32346,13896,11223,160003,1985
86,"Rockingham + Harrisonburg, VA*",743890,37499,70545,70728,648410,44435,33018,72863,906150,72633,11821,950585,-22617,195349,106826,80416,8641,105651,105909,46105,37464,532330,1985
87,"Russell, VA",163850,9136,18071,18568,188385,474,-719,18420,296156,15383,9539,296630,42955,47111,61134,31096,2860,14664,27355,10104,7244,121831,1985
88,"Scott, VA",73958,4436,7885,6934,137394,2486,1939,7903,223354,9642,9203,225840,71339,39578,48868,24541,3195,11581,11352,7269,4074,51025,1985
89,"Shenandoah, VA",206610,11019,19479,19778,229816,8355,5396,20908,352333,24719,12479,360688,44114,81304,49568,28904,3119,30115,29368,14430,11311,147127,1985
90,"Smyth, VA",224224,12286,23482,22298,206189,2846,1540,23435,323162,22419,9934,326008,5400,58294,61525,32817,2990,23959,34631,15242,12252,165634,1985
91,"Southampton + Franklin, VA*",142305,7635,14472,13802,169883,8765,6291,14536,269580,10933,11015,278345,42114,62927,45535,25270,1760,17224,21373,10074,8314,103708,1985
92,"Spotsylvania + Fredericksburg, VA*",470223,25602,42256,46396,626245,-295,-1095,48800,858918,57788,15215,858623,204822,158389,73989,56432,4907,56693,65454,28962,24055,348076,1985
93,"Stafford, VA",243726,12084,30433,22922,589396,-980,-1288,23545,793307,33476,16584,792327,369215,159528,43403,47777,2950,32188,41894,13146,10196,169644,1985
94,"Suffolk (Independent City), VA",332852,18101,32431,34246,469912,6229,3350,35224,679474,22295,14053,685703,172284,120907,94884,48793,2548,25645,49554,19267,16719,257653,1985
95,"Surry, VA",76417,4051,7606,8072,39102,464,-123,8087,63935,2500,10627,64399,-29228,15298,9999,6060,538,2377,11642,3060,2522,62398,1985
96,"Sussex, VA",45316,2582,4603,4302,67274,1565,632,4733,111368,5038,10845,112933,26691,26679,18980,10413,718,5670,6754,3405,2687,32892,1985
97,"Tazewell, VA",277960,15672,27142,27906,312397,1235,395,29625,514826,31591,10516,516061,64062,93221,110443,49072,3281,31986,41095,17369,14088,204879,1985
98,Virginia,65054570,3193745,7477081,6484978,62316171,223587,89531,6436234,89084823,4279320,15627,89308410,3697835,18944612,8047627,5715149,428365,4368851,10719570,3181471,2753106,49966149,1985
99,"Virginia Beach (Independent City), VA",2632175,126661,341770,265010,4174032,2269,998,259166,5696134,185004,17735,5698403,1801023,1254652,269719,321304,21016,186002,474275,152732,131716,1971898,1985
100,"Warren, VA",150172,8168,16301,14358,201275,-45,-424,15347,297048,17560,13127,297003,66450,58029,37699,22626,1717,17136,23480,9412,7695,109556,1985
101,"Washington + Bristol, VA*",511470,27543,51703,51850,451265,5793,2442,53468,697642,41616,10905,703435,-6737,138365,113805,64507,6736,44058,77628,33906,27170,389784,1985
102,"Westmoreland, VA",47000,2870,5058,3992,88992,227,-1677,4866,164258,9648,11413,164485,46858,44987,30506,14412,1274,7971,7054,4732,3458,31975,1985
103,"Wise + Norton, VA*",476143,25604,48643,50214,356520,-220,-289,50711,552136,62886,11583,551916,-68912,81205,114191,47648,2805,62597,73750,20275,17470,339796,1985
104,"Wythe, VA",160581,8728,16318,15668,177168,4458,2642,16562,278439,16179,11187,282897,33149,53307,52422,25288,2481,18821,24152,11576,9095,117608,1985
105,"York + Poquoson, VA*",319442,13906,47711,27888,585936,755,26,27850,826956,27544,17267,827711,294344,191153,50622,47936,3148,27570,61655,16718,13570,230217,1985
0,"Accomack, VA",260862,13425,27481,22070,222651,16028,10657,24460,360366,41630,12053,376394,-13751,92446,61297,31228,2359,52287,38516,15409,13050,170059,1986
1,"Albemarle + Charlottesville, VA*",1380316,75066,148415,143646,1030545,1445,-1483,146889,1607664,85773,15899,1609109,-202882,434831,143733,101207,9692,84290,220238,72831,63139,1075788,1986
2,"Alexandria (Independent City), VA",2604907,127539,290317,258834,2026953,0,0,256956,2925947,125991,26321,2925947,-320998,724749,174245,111165,13142,125991,419734,104024,90882,2059182,1986
3,"Alleghany + Covington, VA*",248337,14624,25724,32848,190007,-43,-118,31048,307474,15156,11700,307431,-27282,57328,60096,26276,1553,15038,42148,11629,10076,191151,1986
4,"Amelia, VA",45700,2177,3449,3148,75843,9691,8314,3751,98331,8359,12889,108022,33894,18782,13397,8381,964,16673,5023,3048,2084,24004,1986
5,"Amherst, VA",193262,11199,21202,20064,209527,-8,-334,21231,315027,18315,10994,315019,37496,61804,43688,28654,1900,17981,31234,11167,9267,144047,1986
6,"Appomattox, VA",73133,4325,7665,7390,92265,-1094,-1441,8020,141340,11138,11547,140246,27152,26590,21391,12146,1160,9697,11360,5264,4104,52076,1986
7,"Arlington, VA",6561720,283032,902490,635012,2946014,0,0,600538,4373216,217875,26108,4373216,-3015168,1211598,215604,167502,16535,217875,1219996,195807,179272,5123849,1986
8,"Augusta, Staunton + Waynesboro, VA*",913884,50249,95419,93142,819240,19214,14345,96820,1235824,75974,13602,1255038,2176,268838,166960,92272,8462,90319,141990,48454,39992,681575,1986
9,"Bath, VA",58241,3301,5819,6106,40695,-431,-661,6354,67799,2941,13166,67368,-11192,15642,11031,5117,467,2280,8872,3076,2609,47089,1986
10,"Bedford, VA*",213735,12816,21581,21622,433147,-1570,-3020,23627,635924,28647,13631,634354,243039,126813,74394,46538,4520,25627,32392,15395,10875,155716,1986
11,"Bland, VA",31429,1860,3397,3042,41686,433,97,3381,62627,4902,9835,63060,13638,10706,10668,6412,796,4999,4918,2255,1459,21512,1986
12,"Botetourt, VA",106700,6484,10557,12872,226932,719,-467,12920,320600,18571,13389,321319,133152,59199,35188,23998,2235,18104,16993,6956,4721,71603,1986
13,"Brunswick, VA",86509,4886,9049,8344,94072,4037,2510,9058,151816,9767,9841,155853,16621,31777,30004,15837,1122,12277,13221,6112,4990,61011,1986
14,"Buchanan, VA",333795,17831,45265,37504,219887,-43,-71,36583,358219,19562,10330,358176,-77325,63364,74925,34675,1871,19491,64017,13599,11728,250287,1986
15,"Buckingham, VA",56613,3298,5543,4868,81820,2305,1808,5732,127972,10360,10422,130277,30939,26421,22036,12500,1305,12168,7977,3975,2670,36468,1986
16,"Campbell + Lynchburg, VA*",1459233,80730,145703,159760,981559,3418,2343,160610,1529219,78330,13558,1532637,-317064,299384,251694,113045,7624,80673,225583,71978,64354,1152977,1986
17,"Caroline, VA",89613,4823,10465,7874,163599,1689,1310,8760,235490,13825,13077,237179,82746,44477,29103,18137,1301,15135,14402,5293,3992,60076,1986
18,"Carroll + Galax, VA*",227537,13100,23940,23508,209584,2938,1861,24854,348957,23692,10499,351895,6901,64087,78224,33518,3371,25553,35694,16704,13333,166290,1986
19,"Charles City, VA",14011,905,1539,1254,56749,-489,-757,1532,79499,3750,12303,79010,44270,14059,8202,6422,278,2993,2166,1015,737,8852,1986
20,"Charlotte, VA",53227,3194,5096,5192,68190,1894,672,5790,114850,8633,10015,116744,20753,26417,22137,11657,1504,9305,7692,4500,2996,36230,1986
21,"Chesapeake (Independent City), VA",854984,47939,90575,92376,1636719,1768,-400,94127,2138344,67990,16154,2140112,875862,343924,159469,132485,7022,67590,136763,46117,39095,650631,1986
22,"Chesterfield, VA",1551206,81135,168340,158694,2543505,1607,1186,160482,3186361,108702,18190,3187968,1152781,496536,147927,175256,12153,109888,247687,73121,60968,1193631,1986
23,"Clarke, VA",78279,4373,7407,7344,117665,1312,-806,8045,172512,12390,15512,173824,47431,41009,15150,11206,1420,11584,11079,5347,3927,55616,1986
24,"Craig, VA",11139,687,1308,1052,30722,31,-93,1213,47489,1757,11377,47520,20796,9991,6807,4177,454,1664,1834,1130,676,7641,1986
25,"Culpeper, VA",201570,11369,21835,20266,249838,470,-1545,21502,367275,21891,15141,367745,69770,76973,40934,24288,2477,20346,31968,12426,9949,149256,1986
26,"Cumberland, VA",28257,1306,1885,1602,55193,7695,6561,2107,77787,6943,10949,85482,29043,16984,13305,7807,846,13504,2686,2038,1192,12067,1986
27,"Dickenson, VA",138071,7561,19130,14916,118712,-42,-61,15019,194903,10030,10181,194861,-4340,28382,47767,19140,1048,9969,26588,5882,4834,101514,1986
28,"Dinwiddie, Colonial Heights + Petersburg, VA*",532756,30852,56170,54640,628615,3029,1942,58172,1038822,50702,13577,1041851,154031,225721,187515,76735,4398,52644,83490,32465,28067,396622,1986
29,"Essex, VA",57154,3446,5737,5692,57901,-1595,-2124,6292,105233,8424,11823,103638,7039,28023,17714,8766,847,6300,8583,4480,3633,42271,1986
30,"Fairfax, Fairfax City + Falls Church, VA*",11275618,581434,1048033,1135610,14185468,949,-586,1149239,18631407,855057,24099,18632356,4059089,3830251,616637,773144,72218,854471,1615838,458317,386099,8805309,1986
31,"Fauquier, VA",321463,16766,35177,29122,575711,-505,-3908,31327,827193,47850,19417,826688,285575,202068,48909,42576,5170,43942,49738,19259,14089,227783,1986
32,"Floyd, VA",49677,2846,3902,3776,87494,4223,3496,4734,130009,13173,11502,134232,42551,26753,19985,11670,1855,16669,5790,4204,2349,27218,1986
33,"Fluvanna, VA",40733,2521,4089,3728,84121,-210,-598,4385,135663,8214,12462,135453,47773,32535,18797,10869,1181,7616,5953,3110,1929,27164,1986
34,"Franklin, VA",195713,11090,19068,19226,307568,5558,2652,20703,443202,25010,12206,448760,132558,86538,54654,36765,3251,27662,28681,13641,10390,139370,1986
35,"Frederick + Winchester, VA*",705530,38779,65912,71964,577847,5980,2389,74761,817381,75132,14059,823361,-52922,162898,82616,58565,5721,77521,101894,36174,30453,526115,1986
36,"Giles, VA",139232,7859,17099,15250,127759,-65,-252,15484,200060,8303,11831,199995,4011,36464,35772,16905,1267,8051,24724,7206,5939,106457,1986
37,"Gloucester, VA",118983,7161,11281,10680,264031,-1014,-1439,12501,386667,24254,14309,385653,157549,84339,37283,26951,2292,22815,16621,8361,6069,79547,1986
38,"Goochland, VA",64581,3837,5450,5534,156081,68,-295,6604,226022,15499,17590,226090,98104,52128,17881,12853,1606,15204,8217,4379,2773,41160,1986
39,"Grayson, VA",61414,3627,5983,5812,97436,3156,2454,6533,155228,9161,9694,158384,42555,30472,30476,16339,1978,11615,8889,5523,3545,40910,1986
40,"Greene, VA",22549,1414,1961,1700,72913,236,58,2264,105505,6775,11753,105741,52628,21221,11607,8997,925,6833,2811,1961,1036,12905,1986
41,"Greensville + Emporia, VA*",123911,6798,12540,12908,98442,4492,3732,13252,156526,6756,10890,161018,-12217,29977,32599,14786,893,10488,18994,7624,6731,94429,1986
42,"Halifax, VA",242664,14047,23990,25988,243623,2322,162,27041,386558,21969,10725,388880,28000,76096,69161,36260,3713,22131,36984,16682,12969,183549,1986
43,"Hampton (Independent City), VA",1553023,67827,244471,153740,1285662,0,0,144697,1865928,44287,14608,1865928,-122664,410558,169708,127730,5506,44287,321341,71313,65807,1187395,1986
44,"Hanover, VA",560059,31536,47911,58086,696538,2290,466,60579,951190,58559,17479,953480,197058,180727,76215,54551,5085,59025,76954,29476,24391,424080,1986
45,"Henrico, VA",2281324,125958,205517,248534,2673740,855,238,250225,3725942,116408,18507,3726797,642641,781448,271609,201376,10761,116646,329784,109250,98489,1834894,1986
46,"Henry + Martinsville, VA*",887608,49042,91527,101170,666269,-204,-420,99627,982560,45373,13110,982356,-121712,195277,120810,74929,4671,44953,142112,49695,45024,700543,1986
47,"Highland, VA",11877,656,939,786,16385,1738,1490,1049,26625,3076,10687,28363,5557,6997,4981,2654,608,4566,1332,1245,637,5979,1986
48,"Isle of Wight, VA",264188,14105,25852,27896,258435,8440,6951,28053,345067,13339,15024,353507,22300,59900,35172,23529,1625,20290,39800,11479,9854,204098,1986
49,"James City + Williamsburg, VA*",570288,31236,57489,60758,451041,504,105,61615,651636,30771,16534,652140,-57632,141813,59286,39443,3371,30876,87868,32121,28750,451544,1986
50,"King George, VA",213040,7059,36976,16620,132466,-893,-1109,15369,195601,10187,16209,194708,-65205,49418,12824,12012,1405,9078,45286,7880,6475,158676,1986
51,"King William, VA",90559,5144,8524,9484,102324,-310,-854,9886,147944,7416,14869,147634,21651,29546,15764,9929,779,6562,13266,4191,3412,70731,1986
52,"King and Queen, VA",20487,1185,3189,1922,43942,-549,-883,2146,72657,2949,11647,72108,25601,17324,10842,6191,616,2066,4150,1770,1154,14271,1986
53,"Lancaster, VA",74431,4604,6727,7088,64189,-389,-551,8148,154257,11269,14497,153868,-2094,60941,28738,10614,1228,10718,10271,5346,4118,53442,1986
54,"Lee, VA",81378,5252,10377,8594,116951,-2235,-2829,9549,222455,7528,8669,220220,45122,38871,64398,25403,2857,4699,14674,7639,4782,62005,1986
55,"Loudoun, VA",699382,36602,69618,68452,1117199,-3527,-6573,70828,1499313,70138,21060,1495786,488645,313511,65076,71026,8105,63565,103844,35554,27449,531973,1986
56,"Louisa, VA",141381,7991,14676,14320,154738,1419,895,15151,231587,14030,12187,233006,28508,43426,34842,19120,1701,14925,21836,7243,5542,104620,1986
57,"Lunenburg, VA",55249,3223,6449,5674,67846,439,-576,6060,114537,6255,9818,114976,18657,25873,21257,11711,1157,5679,9286,4734,3577,40284,1986
58,"Madison, VA",38664,2226,3220,2812,68760,2892,1683,3632,114512,11140,10700,117404,33728,31044,17600,10972,1471,12823,4626,3537,2066,21215,1986
59,"Mathews, VA",26543,1827,2136,1850,70201,-48,-457,2752,127206,9912,15291,127158,46410,37056,19901,8316,834,9455,3061,2124,1290,14027,1986
60,"Mecklenburg, VA",214679,12272,21677,23200,191373,2766,29,23872,320338,16340,10979,323104,566,74756,56975,29428,2416,16369,33277,15253,12837,165033,1986
61,"Middlesex, VA",45717,2824,4581,4070,64775,164,-472,4859,119827,10343,14509,119991,23917,34757,20459,8270,919,9871,6616,3531,2612,29230,1986
62,"Montgomery + Radford, VA*",800808,43588,97987,86300,646054,1167,-20,86738,939960,34105,11276,941127,-68016,189900,105173,83463,5060,34085,141137,43286,38226,625586,1986
63,"Nelson, VA",56449,3508,4981,4920,98229,757,-13,5968,151201,13112,12174,151958,47748,29794,23935,12482,1335,13099,7441,4358,3023,35909,1986
64,"New Kent, VA",35542,2217,3299,3358,106124,-789,-917,3896,147359,7864,15673,146570,74478,27247,13199,9352,884,6947,4978,2588,1704,23617,1986
65,"Newport News (Independent City), VA",2442011,122547,318588,256312,1713809,0,0,250703,2390272,91693,15051,2390272,-477499,458844,217619,158808,7514,91693,446744,100885,93371,1903574,1986
66,"Norfolk (Independent City), VA",5963513,264647,957370,623718,2459093,0,0,576506,3910396,119058,14517,3910396,-2927914,1034224,417079,269371,10731,119058,1269229,250479,239748,4575226,1986
67,"Northampton, VA",90344,5049,9279,8512,79075,5361,3260,9305,145630,11977,11164,150991,-1964,40414,31502,13525,1048,15237,13535,6190,5142,61572,1986
68,"Northumberland, VA",45091,2962,4426,3950,57699,-1583,-1875,4937,133041,11729,13043,131458,17545,48939,24820,10079,1120,9854,6401,3320,2200,28836,1986
69,"Nottoway, VA",122448,6570,15110,15420,103292,5296,4232,14280,173175,8336,11911,178471,-4876,40247,34932,14984,1111,12568,22820,6960,5849,87060,1986
70,"Orange, VA",126137,7450,12455,12650,153990,534,-1131,13775,254193,17865,13028,254727,41628,64564,36173,19552,2031,16734,18780,8729,6698,90623,1986
71,"Page, VA",117841,6438,10699,11178,157219,9445,8347,12027,233618,16924,12023,243063,51405,48546,37298,20217,1863,25271,16288,7637,5774,76282,1986
72,"Patrick, VA",90078,5231,8344,8900,142617,2970,2135,9681,202871,13138,11861,205841,62220,32984,30240,17355,2007,15273,12794,6910,4903,62011,1986
73,"Pittsylvania + Danville, VA*",865886,49372,83496,95012,846301,8320,4245,96878,1282040,64649,11887,1290360,77293,239509,204550,108556,7602,68894,131002,49957,42355,665990,1986
74,"Portsmouth (Independent City), VA",1332078,53977,215318,122004,936443,0,0,114979,1439228,36659,13760,1439228,-280656,320181,182604,104593,3979,36659,276320,56108,52129,1019099,1986
75,"Powhatan, VA",57642,3326,6191,5346,129690,1275,-191,5999,175346,9453,13188,176621,78047,32227,14704,13393,948,9262,8864,3657,2709,39516,1986
76,"Prince Edward, VA",127975,7258,13448,12954,93992,1876,843,13735,161603,12326,9744,163479,-20248,37546,31941,16778,1405,13169,19925,9027,7622,94881,1986
77,"Prince George + Hopewell, VA*",640530,26677,108652,61538,426891,323,-144,57446,631273,21162,12602,631596,-156193,140790,63915,50118,2043,21018,139421,26579,24536,480091,1986
78,"Prince William, Manassas + Manassas Park, VA*",1709902,89154,183206,174076,3109629,-871,-1658,176192,3894022,139335,18608,3893151,1575919,646854,136668,209220,13770,137677,270244,80792,67022,1301981,1986
79,"Pulaski, VA",297812,16389,36074,32524,266581,1631,160,32651,397762,17456,11409,399393,1420,65199,67613,35008,2029,17616,52336,16686,14657,227860,1986
80,"Rappahannock, VA",23644,1504,1830,1710,48980,-378,-1340,2359,83704,9115,13435,83326,27695,24194,10152,6202,1012,7775,2685,2323,1311,13184,1986
81,"Richmond (Independent City), VA",5368120,287035,603367,582410,2228071,0,0,578240,3615618,142049,17177,3615618,-2561809,848769,538778,210497,19759,142049,894572,231254,211495,4331499,1986
82,"Richmond, VA",52810,3132,5648,5450,46043,-1087,-1492,5857,86244,5572,12242,85157,-910,23632,15482,6956,653,4080,8373,3446,2793,40357,1986
83,"Roanoke (Independent City), VA",1645350,92747,165963,201060,877748,0,0,193277,1416026,101640,14321,1416026,-574325,290519,247759,98880,7589,101640,266493,80540,72951,1277217,1986
84,"Roanoke + Salem, VA*",1090138,59226,108827,122552,1167214,3854,2932,120502,1639078,85437,16458,1642932,197578,327630,148088,99825,7538,88369,170103,53602,46064,831666,1986
85,"Rockbridge, Buena Vista + Lexington, VA*",223649,12722,23662,23744,209283,1319,320,24594,341917,18780,11088,343236,10228,82690,51263,30956,2737,19100,35534,14243,11506,169015,1986
86,"Rockingham + Harrisonburg, VA*",866970,44708,84106,83532,747681,62000,50943,86474,1008477,79508,13146,1070477,-32815,211386,111410,81428,8690,130451,125872,48414,39724,610647,1986
87,"Russell, VA",158456,9182,20043,18702,183722,-622,-1570,18533,297640,11542,9646,297018,43799,47722,65574,30793,2886,9972,29394,9879,6993,119090,1986
88,"Scott, VA",69709,4547,8276,6986,136759,-686,-1159,8040,228615,8990,9375,227929,75090,40076,51094,24313,3033,7831,11769,6987,3954,50109,1986
89,"Shenandoah, VA",242486,13286,23205,23578,261407,11262,8533,25075,396192,28012,13952,407454,43996,93507,52540,29205,3156,36545,34994,15176,12020,170947,1986
90,"Smyth, VA",246033,13925,26669,25158,221864,2731,1589,26504,345305,24373,10686,348036,2335,61723,64449,32569,3019,25962,39248,15556,12537,180823,1986
91,"Southampton + Franklin, VA*",158242,8473,16053,15190,191605,14278,11974,16068,290401,11676,12024,304679,49431,65460,47614,25340,1763,23650,23648,10164,8401,110944,1986
92,"Spotsylvania + Fredericksburg, VA*",540694,30593,50594,54074,714110,-666,-1364,57630,973242,68047,16352,972576,231046,177390,81076,59479,5369,66683,77631,31220,25851,396380,1986
93,"Stafford, VA",276367,14299,34705,26384,655486,-1136,-1401,27491,871257,39293,17706,870121,406610,169423,45212,49143,3638,37892,47897,14241,10603,190578,1986
94,"Suffolk (Independent City), VA",323453,18182,32477,33460,480946,8742,5967,34912,698901,23939,14266,707643,192405,127792,98905,49605,2725,29906,49207,18550,15825,244340,1986
95,"Surry, VA",89634,4756,9288,9530,44918,2644,2086,9521,68532,2528,11573,71176,-35195,15876,10382,6150,526,4614,14053,3168,2642,70967,1986
96,"Sussex, VA",49989,2819,5064,4686,70672,3703,2872,5162,114146,4684,11324,117849,25845,27440,19737,10407,679,7556,7407,3379,2700,35026,1986
97,"Tazewell, VA",276481,16144,30822,30784,302773,14,-750,31536,515531,10703,10690,515545,57828,95785,116987,48226,3017,9953,46214,17392,14375,220314,1986
98,Virginia,70915359,3625050,8218800,7308142,67457322,270571,148032,7279121,96070899,4372819,16577,96341470,3821084,20352911,8531237,5811692,456552,4520851,11872871,3316133,2859581,54521637,1986
99,"Virginia Beach (Independent City), VA",2901655,145238,375995,301264,4603088,5471,4322,295870,6257001,184941,18329,6262472,1997303,1364891,294493,341671,23122,189263,526627,161802,138680,2185765,1986
100,"Warren, VA",159781,9052,17789,15640,225585,-199,-490,16872,326712,19604,14136,326513,82676,62558,38370,23098,1943,19114,25609,9824,7881,115058,1986
101,"Washington + Bristol, VA*",558054,31113,58144,57976,483198,6073,3080,60101,741922,40979,11658,747995,-14755,145688,119109,64160,6842,44059,87132,35017,28175,426863,1986
102,"Westmoreland, VA",49739,3214,5408,4394,95775,-412,-2181,5411,178080,10196,12172,177668,51447,49634,32259,14596,1303,8015,7605,4615,3312,34119,1986
103,"Wise + Norton, VA*",443021,24642,54310,51488,326568,-350,-411,50386,533330,26627,11401,532980,-66067,82806,123606,46750,2698,26216,80054,19774,17076,336751,1986
104,"Wythe, VA",178716,10034,19092,17708,190837,4696,3053,18888,297027,18011,11909,301723,31009,56379,54507,25336,2501,21064,27946,12182,9681,129706,1986
105,"York + Poquoson, VA*",341956,15837,49696,30974,625098,658,23,31324,885521,31239,18151,886179,314466,210094,50987,48822,3863,31262,65183,17918,14055,245511,1986
0,"Accomack, VA",272117,14441,29885,24612,229553,10676,4922,26747,378218,34441,12320,388894,-15817,95986,63355,31565,2267,39363,42191,16101,13834,190563,1987
1,"Albemarle + Charlottesville, VA*",1495822,80977,158328,153602,1130188,3564,821,157778,1747463,86466,16982,1751027,-207856,471176,149663,103111,10688,87287,235129,76339,65651,1173406,1987
2,"Alexandria (Independent City), VA",2938054,146774,296860,293796,2165439,0,0,293672,3075942,144623,27809,3075942,-478943,732788,177715,110611,13090,144623,443758,110612,97522,2349673,1987
3,"Alleghany + Covington, VA*",266643,15646,28212,34448,203974,302,229,32870,321050,17038,12454,321352,-29799,55918,61460,25803,1624,17267,45436,11982,10358,203940,1987
4,"Amelia, VA",48244,2473,3681,3426,81056,7934,6536,4186,105852,9903,13572,113786,36998,19040,13690,8384,1026,16439,5394,3158,2132,26411,1987
5,"Amherst, VA",215072,12375,23181,21642,233006,1136,843,23196,338535,21528,11879,339671,41130,62825,43840,28595,2026,22371,34002,11721,9695,158699,1987
6,"Appomattox, VA",80815,4764,8288,7858,101293,-356,-667,8693,150471,12608,12232,150115,29171,26835,21987,12272,1290,11941,12217,5459,4169,56657,1987
7,"Arlington, VA",6978790,309305,878193,687356,3151218,0,0,652983,4586358,227652,27290,4586358,-3174589,1216024,219116,168060,16787,227652,1221871,202501,185714,5529267,1987
8,"Augusta, Staunton + Waynesboro, VA*",998063,54964,105355,100880,898578,16972,12015,105404,1333190,79489,14404,1350162,5919,278346,173238,93737,8951,91504,155795,51201,42250,750764,1987
9,"Bath, VA",52531,2996,5028,5302,40678,135,-82,5647,67737,3443,13459,67872,-6206,16201,10993,5043,472,3361,7679,2920,2448,41491,1987
10,"Bedford, VA*",238552,14177,23694,23244,483540,1956,578,25799,695276,32133,14522,697232,270787,134888,78804,48013,4867,32711,35316,16376,11509,170525,1987
11,"Bland, VA",35790,2105,3689,3294,45915,965,639,3752,67135,6083,10604,68100,13877,11304,10881,6422,854,6722,5336,2355,1501,23732,1987
12,"Botetourt, VA",118943,7095,11921,13316,245531,2516,1306,13753,339974,19639,14089,342490,140341,60484,36475,24309,2389,20945,18579,7310,4921,79419,1987
13,"Brunswick, VA",91646,5136,9286,8420,100690,5902,4475,9346,156827,10604,10254,162729,18390,31642,30397,15870,1062,15079,13496,5978,4916,63071,1987
14,"Buchanan, VA",351300,18303,54829,38530,228730,139,107,37568,360413,14494,10657,360552,-85002,55038,76784,33833,1932,14601,74094,13473,11541,262605,1987
15,"Buckingham, VA",62114,3649,5993,5212,88760,2573,2041,6255,134393,12159,10918,136966,32901,26086,22120,12545,1529,14200,8599,4261,2732,39315,1987
16,"Campbell + Lynchburg, VA*",1562262,85928,160703,167814,1057055,4925,3899,169835,1651250,81648,14708,1656175,-335372,326453,272667,112607,8238,85547,244610,74538,66300,1232105,1987
17,"Caroline, VA",101838,5523,11465,8820,178560,1524,1244,9933,252155,16127,13925,253679,86655,45429,29690,18217,1498,17371,15875,5731,4233,68592,1987
18,"Carroll + Galax, VA*",252524,14420,26473,25154,232300,6120,5090,26997,370500,26674,11312,376620,6773,63659,80661,33293,3378,31764,39050,17383,14005,181710,1987
19,"Charles City, VA",17586,1086,1806,1476,61799,194,-28,1824,84517,4572,13474,84711,46037,14368,8544,6287,313,4544,2544,1109,796,10498,1987
20,"Charlotte, VA",60225,3607,5676,5794,74453,2696,1599,6504,120467,9090,10572,123163,20732,26077,22633,11650,1483,10689,8573,4668,3185,40963,1987
21,"Chesapeake (Independent City), VA",939200,52498,98739,99348,1775981,2533,300,102172,2308524,74122,16805,2311057,938953,369454,165622,137526,7676,74422,148413,49338,41662,716365,1987
22,"Chesterfield, VA",1744977,91448,183566,177052,2872921,2518,2091,179974,3571058,122343,19311,3573576,1307918,546313,154342,185053,13583,124434,272092,79344,65761,1348451,1987
23,"Clarke, VA",87982,4856,7353,7790,130511,3997,1994,8751,185980,14884,16399,189977,51280,44060,15406,11585,1371,16878,11248,5159,3788,59856,1987
24,"Craig, VA",12082,733,1369,1106,33385,480,368,1286,49789,1658,11759,50269,22589,9974,6910,4275,484,2026,1922,1192,708,8134,1987
25,"Culpeper, VA",228561,12722,22814,22110,282496,5327,3462,23777,401912,25433,16282,407239,77712,81155,43588,25012,2595,28895,33869,12941,10346,165797,1987
26,"Cumberland, VA",32856,1485,1986,1754,62217,10001,8775,2362,82916,8060,11809,92917,31723,17529,13171,7868,976,16835,2863,2155,1179,13158,1987
27,"Dickenson, VA",132814,7272,19873,13450,120813,83,69,13997,199703,11902,10680,199786,1996,29779,49194,18707,1156,11971,26598,5597,4441,94245,1987
28,"Dinwiddie, Colonial Heights + Petersburg, VA*",575180,33309,59757,57724,692691,4165,3079,62171,1120512,54877,14643,1124677,179682,234697,197289,76804,4621,57956,88619,33094,28473,428605,1987
29,"Essex, VA",64408,3766,6241,6082,64802,684,246,6807,111022,9038,12671,111706,7201,28632,18272,8816,818,9284,9282,4614,3796,45842,1987
30,"Fairfax, Fairfax City + Falls Church, VA*",12724664,663762,1090481,1282510,15660860,1183,-469,1305017,20474191,963736,25525,20475374,4241213,4169463,645051,802182,79340,963267,1731736,492883,413543,10029661,1987
31,"Fauquier, VA",377755,19760,37849,33438,654295,5303,2165,36479,928718,58483,20888,934021,313019,229525,50201,44716,5731,60648,54568,20809,15078,262539,1987
32,"Floyd, VA",60039,3319,4436,4186,99301,7757,7073,5412,137710,15687,12329,145467,44674,26411,19755,11799,1927,22760,6529,4352,2425,30750,1987
33,"Fluvanna, VA",48546,2979,4854,4324,96616,64,-310,5141,150752,9404,13477,150816,53211,34713,19487,11191,1332,9094,7016,3488,2156,32436,1987
34,"Franklin, VA",211355,12059,20161,20534,332586,6260,3376,22326,469109,25914,12719,475369,143557,87616,55167,37374,3169,29290,30428,14007,10838,151637,1987
35,"Frederick + Winchester, VA*",800154,43796,74345,80244,662023,9569,5981,83918,912281,83487,15215,921850,-54213,174368,85459,60587,6437,89468,114467,39394,32957,596219,1987
36,"Giles, VA",146437,8223,17719,15578,136276,1358,1212,16012,207074,9093,12437,208432,5851,36029,36127,16759,1223,10305,25508,7216,5993,110624,1987
37,"Gloucester, VA",132169,7918,12772,11914,289878,-211,-636,13875,417922,23814,14830,417711,171584,88696,39137,28167,2538,23178,18729,9230,6692,90262,1987
38,"Goochland, VA",78708,4683,6165,6238,180311,686,377,7802,254098,21852,19155,254784,109405,56656,17817,13301,1917,22229,9284,4922,3005,47195,1987
39,"Grayson, VA",67300,3949,6372,6010,106509,4837,4166,6954,162514,10494,10277,167351,46163,30474,30368,16284,2113,14660,9377,5607,3494,43263,1987
40,"Greene, VA",26547,1650,2283,1930,81757,700,535,2615,114314,7790,12416,115014,57825,21580,11677,9263,1058,8325,3248,2220,1162,14974,1987
41,"Greensville + Emporia, VA*",130320,7164,12935,13408,102698,5051,4300,13868,161135,6974,11308,166186,-13754,29862,33626,14696,907,11274,19639,7596,6689,99407,1987
42,"Halifax, VA",261492,15032,25854,26926,261153,5724,3800,28495,404560,24452,11351,410284,28156,77877,71254,36145,3516,28252,39317,16645,13129,193923,1987
43,"Hampton (Independent City), VA",1657639,73548,246666,164732,1358348,0,0,155914,1966410,50771,15089,1966410,-143377,429117,178945,130319,6226,50771,329032,73565,67339,1277836,1987
44,"Hanover, VA",620314,34940,53090,63106,773188,1759,-107,66493,1046118,65453,18417,1047877,219367,193452,81237,56897,5396,65346,84643,31445,26049,470325,1987
45,"Henrico, VA",2553070,139969,231166,274700,2973838,1041,383,277319,4107038,121009,19892,4108079,698087,850782,283459,206524,13622,121392,368516,118415,104793,2063162,1987
46,"Henry + Martinsville, VA*",956156,52623,99775,106700,721784,167,-18,105973,1042690,46440,13705,1042857,-128399,196154,124919,76092,4955,46422,153125,51253,46298,756609,1987
47,"Highland, VA",14575,747,1013,860,18518,3260,3027,1177,27163,3484,11710,30423,5120,6932,4973,2598,628,6511,1443,1284,656,6621,1987
48,"Isle of Wight, VA",279389,14959,27406,29008,269351,7734,6296,29463,360365,15042,15417,368099,19425,62850,35898,23876,1717,21338,41910,11664,9947,216141,1987
49,"James City + Williamsburg, VA*",638782,34907,62163,67004,505659,816,414,68409,729002,38383,17586,729818,-64714,160086,64073,41499,3731,38797,95665,34384,30653,504320,1987
50,"King George, VA",222580,7974,33931,18262,144410,-112,-287,17105,209303,11492,16868,209191,-61065,51274,13507,12402,1311,11205,43062,8052,6741,168313,1987
51,"King William, VA",96913,5474,8814,9922,112977,583,102,10435,158726,8038,15886,159309,26499,30042,16290,10028,856,8140,13775,4318,3462,74998,1987
52,"King and Queen, VA",24001,1353,3447,2158,49636,355,62,2432,77555,3546,12492,77910,28067,17531,10743,6237,720,3608,4526,1892,1172,15867,1987
53,"Lancaster, VA",83078,5119,7579,7946,70894,196,51,9092,172977,10709,16145,173173,-3092,71856,30423,10726,1242,10760,11552,5658,4416,60766,1987
54,"Lee, VA",91202,5785,11048,8854,129783,362,-141,10212,234168,10604,9275,234530,48793,38456,66291,25286,2913,10463,15475,7722,4809,65264,1987
55,"Loudoun, VA",826315,43636,75076,80416,1258055,2657,-301,83844,1666472,82792,22085,1669129,515584,342924,68150,75578,9006,82491,115284,39022,30016,628540,1987
56,"Louisa, VA",159599,9010,16273,15652,173512,2087,1603,16836,253211,17302,13161,255298,30749,46133,35653,19398,1859,18905,24099,7697,5838,116595,1987
57,"Lunenburg, VA",59504,3395,6641,5880,74144,2406,1495,6335,118989,5973,10459,121395,20975,25817,21434,11607,1165,7468,9581,4634,3469,42455,1987
58,"Madison, VA",46223,2562,3545,3144,79358,5690,4528,4134,124191,12617,11638,129881,37269,32695,17828,11160,1582,17145,5117,3750,2168,23961,1987
59,"Mathews, VA",27237,1936,2307,2016,74152,62,-398,2944,133402,8887,15806,133464,49859,38989,20323,8444,822,8489,3315,2144,1322,15433,1987
60,"Mecklenburg, VA",241068,13596,23921,25510,213292,6296,3648,26351,341282,15671,11731,347578,-1425,76408,57878,29630,2403,19319,36676,16211,13808,185073,1987
61,"Middlesex, VA",46311,2901,4636,4076,68260,576,103,4939,124095,9546,14997,124671,26888,35022,21389,8313,935,9649,6674,3467,2532,29988,1987
62,"Montgomery + Radford, VA*",886851,47819,107479,93510,710190,3685,2497,94574,1013160,37567,11999,1016845,-82087,198708,107947,84744,5480,40064,154234,45786,40306,692553,1987
63,"Nelson, VA",61227,3793,5316,5430,97095,1879,1320,6508,149416,12496,12074,151295,42376,29365,24835,12531,1457,13816,8031,4550,3093,39380,1987
64,"New Kent, VA",40764,2526,3612,3692,117991,-218,-337,4372,160069,9346,16490,159851,81599,28176,13684,9694,940,9009,5458,2684,1744,26297,1987
65,"Newport News (Independent City), VA",2529279,127514,322252,261570,1800193,0,0,258299,2513211,111243,15758,2513211,-470787,482731,230287,159484,8327,111243,453037,102224,93897,1964999,1987
66,"Norfolk (Independent City), VA",6405138,287956,994722,677690,2576257,0,0,626801,4071977,138982,14756,4071977,-3202080,1067615,428105,275951,10444,138982,1333567,260895,250451,4932589,1987
67,"Northampton, VA",94501,5259,9863,8580,84863,6858,4718,9549,150839,12397,11655,157697,-89,40456,32378,13530,1050,17115,14153,6279,5229,63233,1987
68,"Northumberland, VA",50533,3291,4841,4258,63890,-472,-740,5420,139932,12891,13759,139460,18777,50572,24998,10136,1199,12151,6970,3440,2241,31412,1987
69,"Nottoway, VA",127888,7001,16005,15990,107019,4078,3039,14996,180151,8860,12384,184229,-5873,40903,36307,14876,1103,11899,24000,7065,5962,91989,1987
70,"Orange, VA",145298,8399,14107,14032,173543,3778,2196,15415,275036,19131,13897,278814,43660,67347,37924,20063,2101,21327,21123,9179,7078,102848,1987
71,"Page, VA",129672,7189,11626,11990,172246,9725,8643,13184,250523,19982,12594,260248,55758,50383,37619,20665,1941,28625,17621,8021,6080,83426,1987
72,"Patrick, VA",101833,5826,9449,9636,156013,5283,4484,10644,215300,14300,12754,220583,64824,33207,31363,17295,1985,18784,14267,7212,5227,68782,1987
73,"Pittsylvania + Danville, VA*",942150,53609,91641,100758,917431,11515,7489,103988,1358306,71999,12724,1369821,79269,243071,209319,107658,7756,79488,142020,51339,43583,720642,1987
74,"Portsmouth (Independent City), VA",1377062,57766,207595,128502,970189,0,0,122017,1480795,37746,14070,1480795,-284856,320987,189619,105245,3787,37746,271846,57152,53365,1067470,1987
75,"Powhatan, VA",64365,3680,6747,5848,145696,2015,466,6604,193465,10480,14243,195480,87935,34661,15123,13725,1001,10946,9671,3843,2842,43748,1987
76,"Prince Edward, VA",139018,7869,14345,13678,102139,2866,1866,14708,171292,13982,10237,174158,-22171,38943,33076,17012,1486,15848,21184,9219,7733,101986,1987
77,"Prince George + Hopewell, VA*",708614,29727,113485,68704,479187,831,349,64079,693712,22765,13931,694543,-165348,149529,65827,49855,2223,23114,147837,27797,25574,537663,1987
78,"Prince William, Manassas + Manassas Park, VA*",1964634,102670,204159,198756,3449883,30,-694,202048,4297870,164049,19461,4297900,1687297,704989,143028,220846,16096,163355,303537,90315,74219,1497742,1987
79,"Pulaski, VA",311668,17153,36339,33272,283137,3581,2057,33789,414370,18054,12005,417951,5258,66529,68285,34815,2098,20111,52975,16526,14428,238582,1987
80,"Rappahannock, VA",28441,1714,1988,1856,57892,1627,707,2642,94010,10371,15132,95637,32093,27431,10314,6320,1092,11078,2916,2425,1333,14447,1987
81,"Richmond (Independent City), VA",5911043,314838,649127,629350,2409887,0,0,629513,3854244,166757,18528,3854244,-2871643,882831,561526,208018,17072,166757,963802,236755,219683,4780484,1987
82,"Richmond, VA",58081,3351,6045,5854,50688,623,180,6278,90674,4929,12888,91297,-1115,24307,16302,7084,605,5109,8972,3501,2896,44000,1987
83,"Roanoke (Independent City), VA",1781310,100501,178233,211876,941710,0,0,206439,1500513,121951,15303,1500513,-633161,300300,258503,98051,6292,121951,284171,80885,74593,1375188,1987
84,"Roanoke + Salem, VA*",1167142,63557,116103,128626,1267414,3070,2060,127870,1763622,99372,17489,1766692,228142,342839,156439,101017,8865,101432,180416,56756,47891,885294,1987
85,"Rockbridge, Buena Vista + Lexington, VA*",238987,13535,24664,24396,224795,3789,2823,25733,360461,21309,11771,364250,11541,86085,53370,30946,2842,24132,36862,14534,11692,177993,1987
86,"Rockingham + Harrisonburg, VA*",913310,49002,90885,90250,785426,32454,20968,94127,1089800,87679,13543,1122254,-33757,221245,115583,82868,8803,108647,136010,49974,41171,668653,1987
87,"Russell, VA",172319,9755,22095,18324,198759,3524,2743,18917,309172,18298,10351,312696,45357,45809,68128,30210,2996,21041,31257,9849,6853,120021,1987
88,"Scott, VA",82647,5226,9365,7924,147524,1994,1557,9188,238197,10022,9987,240191,74065,39836,52831,24050,2959,11579,13327,7121,4162,57741,1987
89,"Shenandoah, VA",280008,15438,26577,27092,292276,11386,8682,28984,427802,31826,14698,439188,41252,92825,54087,29881,3212,40508,40123,16118,12906,199377,1987
90,"Smyth, VA",267908,15032,28574,26576,240057,6176,5115,28320,360925,26532,11261,367101,469,61107,65937,32599,3100,31647,41862,15765,12665,194399,1987
91,"Southampton + Franklin, VA*",159862,8736,16173,15298,202823,12778,10479,16385,305509,12100,12730,318287,59346,66132,49332,25003,1780,22579,23822,9959,8179,113461,1987
92,"Spotsylvania + Fredericksburg, VA*",628525,35478,56994,61646,812979,371,-282,66301,1098390,78393,17377,1098761,250755,197709,88073,63230,5773,78111,87817,34474,28701,462597,1987
93,"Stafford, VA",316337,16439,38751,30038,726289,-312,-550,31458,957649,45913,18701,957337,441410,184395,46653,51193,4366,45363,53770,15813,11447,217204,1987
94,"Suffolk (Independent City), VA",356909,20140,35435,36152,515646,8682,5807,38216,738225,28776,14775,746907,196953,132106,99155,50553,2884,34583,53511,19340,16456,268815,1987
95,"Surry, VA",83873,4397,9207,8660,45663,3075,2501,8727,69631,2415,11948,72706,-29483,16339,10704,6085,524,4916,13537,2918,2394,65420,1987
96,"Sussex, VA",53302,3055,5327,5072,74499,3604,2813,5591,117463,4276,11602,121067,26788,26120,20448,10435,662,7089,7863,3516,2854,38350,1987
97,"Tazewell, VA",294185,17151,31866,30360,315985,3351,2612,32331,530672,23008,11244,534023,54131,94704,123334,47492,2890,25620,47046,17226,14336,221519,1987
98,Virginia,77743162,4002665,8635110,7956000,73697174,363730,243565,7980665,103700436,4884393,17542,104064166,3934677,21507196,8859796,5932273,483517,5127958,12613110,3479609,2996092,60002094,1987
99,"Virginia Beach (Independent City), VA",3216292,161882,400234,332780,5079194,6947,5845,328272,6867387,205514,19167,6874334,2191174,1482007,313133,358652,24263,211359,566624,172270,148007,2438309,1987
100,"Warren, VA",177274,10065,18940,16968,255104,800,577,18549,358529,22343,14965,359329,96379,65601,38624,24011,2181,22920,27424,10510,8329,126930,1987
101,"Washington + Bristol, VA*",604816,33397,64196,61070,513833,11581,8710,63932,773174,44233,12197,784755,-27051,148685,122237,64339,7137,52943,94731,35704,28567,457142,1987
102,"Westmoreland, VA",54524,3515,5732,4794,103174,664,-1109,5912,187212,10085,12642,187876,54562,51479,33223,14861,1378,8976,8129,4733,3355,37419,1987
103,"Wise + Norton, VA*",483260,26567,64033,54508,353353,239,180,53821,563065,28765,12239,563304,-76086,82159,127792,46027,2752,28945,91287,20429,17677,363028,1987
104,"Wythe, VA",196987,10996,20640,18878,208329,7260,5668,20435,313743,20889,12609,321003,31777,56993,55681,25458,2549,26557,30079,12567,10018,140351,1987
105,"York + Poquoson, VA*",368892,17290,51376,34158,665358,736,145,34369,944269,30697,18597,945005,330835,228030,51617,50814,4725,30842,68455,19385,14660,269595,1987
0,"Accomack, VA",284615,15190,31056,26228,242034,19303,12653,28304,396632,30187,13118,415935,-14277,104186,69715,31708,2462,42840,44170,16553,14091,197605,1988
1,"Albemarle + Charlottesville, VA*",1706474,95755,172929,174536,1301565,3647,794,183023,1998015,162170,19047,2001662,-221886,542182,157915,105091,9926,162964,260197,77441,67515,1283313,1988
2,"Alexandria (Independent City), VA",3218815,166311,323938,330684,2329306,0,0,331653,3321964,169733,29854,3321964,-557856,808928,183730,111273,10630,169733,489280,108661,98031,2559802,1988
3,"Alleghany + Covington, VA*",278307,17189,27013,37156,213989,224,137,35767,337510,17970,13226,337734,-28551,59188,64557,25535,1415,18107,45591,11884,10469,214609,1988
4,"Amelia, VA",57363,2964,4261,4142,90534,9617,8109,5035,115678,12016,14749,125295,38206,20072,14689,8495,933,20125,6332,3210,2277,30906,1988
5,"Amherst, VA",222980,13388,23658,23632,244491,840,498,25204,354565,20039,12437,355405,46715,64303,46611,28576,2092,20537,35474,11802,9710,166969,1988
6,"Appomattox, VA",84966,5114,8659,8460,106096,779,401,9344,158411,11746,12894,159190,30474,29424,23670,12346,1192,12147,12889,5312,4120,59930,1988
7,"Arlington, VA",7478434,344985,936085,762654,3460006,0,0,726312,4973846,283235,29275,4973846,-3292116,1286345,227495,169903,17543,283235,1317412,204132,186589,5877787,1988
8,"Augusta, Staunton + Waynesboro, VA*",1097213,62030,113353,113062,990708,23689,18355,118561,1447396,91470,15483,1471085,12056,299892,180485,95015,8620,109825,169884,52603,43983,817504,1988
9,"Bath, VA",54811,3247,4923,5660,42232,305,88,6077,69021,3563,13862,69326,-6502,15642,11452,5001,455,3651,7753,2869,2414,43407,1988
10,"Bedford, VA*",265469,16363,26197,26572,525148,1105,-335,29649,763096,36330,15502,764201,289328,152926,86127,49296,4324,35995,39483,16641,12317,189991,1988
11,"Bland, VA",37736,2351,4073,3720,47224,127,-246,4211,69831,5780,10924,69958,13699,11550,11184,6404,899,5534,5933,2481,1582,26269,1988
12,"Botetourt, VA",124352,7670,11482,13818,254404,3287,1963,14579,354975,20022,14493,358262,144631,64162,39696,24720,2159,21985,18391,7211,5052,83976,1988
13,"Brunswick, VA",97630,5663,9801,9160,106577,7190,5598,10243,163603,11126,10755,170793,19190,32492,31724,15880,1029,16724,14381,5934,4905,66525,1988
14,"Buchanan, VA",408552,23207,38571,41458,282942,275,244,43936,420506,72882,12807,420781,-81674,59668,78171,32856,1698,73126,59300,13139,11441,276126,1988
15,"Buckingham, VA",68993,4170,6724,6088,95438,2934,2411,7214,144680,12832,11633,147614,33659,28146,24030,12689,1042,15243,9768,3844,2802,43982,1988
16,"Campbell + Lynchburg, VA*",1657064,94039,167565,181186,1125964,6066,4928,184632,1776626,94583,15783,1782692,-346468,365653,291075,112948,7835,99511,258158,75886,68051,1299395,1988
17,"Caroline, VA",112531,6253,12115,9976,193271,3309,2955,11241,270572,17709,14813,273881,91981,48720,31890,18489,1266,20664,17103,5641,4375,74764,1988
18,"Carroll + Galax, VA*",273540,16080,29373,27764,249574,7663,6555,29962,392138,27352,11988,399801,5996,67885,82342,33350,3045,33907,43255,17715,14670,196378,1988
19,"Charles City, VA",18683,1169,1893,1628,63879,694,387,1983,87776,4334,13996,88470,47179,15844,8747,6321,340,4721,2707,1169,829,11255,1988
20,"Charlotte, VA",64356,3989,6005,5974,78846,3752,2508,6976,127106,11196,11240,130858,21466,27832,24180,11642,1426,13704,8992,4538,3112,41660,1988
21,"Chesapeake (Independent City), VA",1029808,59267,106140,111986,1940384,7359,4544,115260,2523022,78136,17739,2530381,1025836,414008,175989,142643,8288,82680,162133,51709,43421,784995,1988
22,"Chesterfield, VA",1986907,106596,207384,206230,3181858,3708,3119,209711,3987523,150390,20635,3991231,1404662,633642,175731,193417,14003,153509,310499,84866,70863,1522899,1988
23,"Clarke, VA",91990,5161,7702,8104,141200,4501,2130,9213,203057,16934,17454,207558,58423,50004,16354,11892,1515,19064,11754,5377,3862,61172,1988
24,"Craig, VA",13653,854,1430,1202,36581,868,744,1455,53259,2397,12503,54127,24383,10030,7516,4329,410,3141,2031,1117,707,8481,1988
25,"Culpeper, VA",252968,14546,25344,24990,315182,4279,2031,27041,446857,30958,17503,451136,89255,90166,45788,25775,2684,32989,37839,13457,10773,182140,1988
26,"Cumberland, VA",39085,1695,2145,2006,70135,13584,12197,2698,88353,9146,13017,101937,33748,17273,14529,7831,734,21343,3148,1959,1225,14594,1988
27,"Dickenson, VA",147658,8809,12835,12228,140854,167,150,14923,224865,44283,12268,225032,8119,32793,51385,18343,1032,44433,18949,5297,4265,84276,1988
28,"Dinwiddie, Colonial Heights + Petersburg, VA*",619562,37387,63499,64486,745266,6016,4779,69630,1207535,56467,15917,1213551,195334,254777,213508,76241,4246,61246,95742,33522,29276,462574,1988
29,"Essex, VA",67447,4046,6459,6460,68844,1312,794,7276,117497,9390,13477,118809,8673,30848,19117,8816,815,10184,9689,4487,3672,47574,1988
30,"Fairfax, Fairfax City + Falls Church, VA*",14717811,782308,1276030,1513520,17629068,933,-628,1539068,23033804,1174248,27917,23034737,4450325,4702366,703303,825128,81843,1173620,2032790,519762,437919,11511401,1988
31,"Fauquier, VA",439060,23283,42867,39724,743032,8332,4495,43145,1041338,69691,22552,1049670,347117,254375,52263,46545,5488,74186,62729,21582,16094,302145,1988
32,"Floyd, VA",59788,3427,4564,4280,100884,7689,6805,5567,141257,15483,12487,148946,46663,27077,20985,11928,1782,22288,6704,4089,2307,30796,1988
33,"Fluvanna, VA",53448,3383,5106,4994,107314,401,7,5880,167575,9625,14630,167976,59746,39638,21024,11482,1111,9632,7603,3417,2306,36213,1988
34,"Franklin, VA",233283,13652,22559,23266,353173,7297,4080,25285,499884,26901,13362,507181,145175,92987,61021,37958,3104,30981,34192,14741,11637,168110,1988
35,"Frederick + Winchester, VA*",883320,49390,80607,90276,740380,7825,3884,94528,1024939,97334,16426,1032764,-48412,198535,93849,62874,6497,101218,125745,40893,34396,656357,1988
36,"Giles, VA",156248,9123,18138,16774,145578,1950,1794,17510,220096,11527,13375,222046,6840,38081,38387,16601,1233,13321,26525,7262,6029,116402,1988
37,"Gloucester, VA",143050,8790,13784,13176,315648,870,423,15378,454210,25858,15574,455080,187976,97713,41719,29220,2566,26281,20372,9297,6731,96397,1988
38,"Goochland, VA",82036,4910,6901,7322,193740,931,577,8571,274547,17565,20248,275478,120275,62579,19159,13605,1470,18142,10562,4578,3108,53332,1988
39,"Grayson, VA",69920,4308,6669,6300,112922,4998,4282,7458,176071,11339,11142,181069,50460,34830,33317,16251,2003,15621,9819,5362,3359,44480,1988
40,"Greene, VA",35570,2201,3139,2808,93557,921,674,3605,129658,9543,13748,130579,61592,24104,12918,9498,877,10217,4543,2276,1399,20810,1988
41,"Greensville + Emporia, VA*",135807,7714,13590,14182,106871,6097,5237,14805,165577,7372,11816,171674,-14131,31092,33711,14529,756,12609,20681,7476,6720,102517,1988
42,"Halifax, VA",285961,16688,28136,29468,281181,12185,9760,31422,428673,25582,12253,440858,26642,80862,78815,35980,3357,35342,42870,16863,13506,207749,1988
43,"Hampton (Independent City), VA",1776728,82144,268620,184714,1431962,0,0,174501,2085173,54133,15773,2085173,-170265,462246,190965,132200,6389,54133,360977,75664,69275,1361618,1988
44,"Hanover, VA",701576,40035,59803,72464,851392,4842,2819,76267,1156614,75838,19601,1161456,226083,222100,87964,59254,5747,78657,96035,33209,27462,526884,1988
45,"Henrico, VA",2963315,166326,262735,327594,3283620,1891,1153,330123,4546706,140956,21407,4548597,650428,951636,313341,212486,14197,142109,426532,128024,113827,2394674,1988
46,"Henry + Martinsville, VA*",945260,53668,101031,106098,719271,547,328,106717,1082329,47856,14273,1082876,-119272,222196,141409,75871,5170,48184,154080,49455,44285,742996,1988
47,"Highland, VA",16311,859,1109,966,20673,3632,3379,1342,29991,4073,12755,33623,5704,7786,5164,2636,612,7452,1592,1282,670,7267,1988
48,"Isle of Wight, VA",300013,16482,29025,31890,294725,8867,7089,32427,391323,15078,16440,400190,27139,67058,38407,24343,1628,22167,44970,12028,10400,232876,1988
49,"James City + Williamsburg, VA*",693261,39171,65994,74368,564307,909,494,76355,821315,45275,18960,822224,-52599,185396,72521,43366,3529,45769,103178,35911,32382,544314,1988
50,"King George, VA",243977,9227,37268,20718,159904,839,590,19586,228886,14017,17975,229725,-64487,55090,14731,12780,1014,14607,47627,8052,7038,181743,1988
51,"King William, VA",109948,6297,9645,11334,125917,1979,1400,11964,174471,9592,17141,176450,27933,33385,17148,10294,820,10992,15312,4562,3742,83644,1988
52,"King and Queen, VA",28864,1640,3353,2240,58878,1902,1545,2760,86263,7218,14145,88165,32774,17845,11442,6233,511,8763,4473,1606,1095,15628,1988
53,"Lancaster, VA",93589,5946,8232,9150,79078,788,636,10521,195197,11931,18197,195985,-3990,85145,31762,10770,1310,12567,12807,5862,4552,68215,1988
54,"Lee, VA",101539,6814,10926,9736,137785,1041,456,11682,246760,15512,9923,247801,47928,41543,68473,24972,2640,15968,15794,7677,5037,69777,1988
55,"Loudoun, VA",1000512,54017,91117,101900,1439150,2699,-784,104967,1901108,89592,24063,1903807,543605,392571,72086,79117,9535,88808,142067,43186,33651,769637,1988
56,"Louisa, VA",162273,9493,15613,16032,185277,2334,1792,17509,271035,20775,13962,273369,40513,50027,38065,19579,1802,22567,23629,7613,5811,116077,1988
57,"Lunenburg, VA",66039,3873,7287,6546,80956,3352,2267,7146,128586,6977,11433,131938,22063,27576,23406,11540,993,9244,10560,4671,3678,46235,1988
58,"Madison, VA",53143,2967,3923,3620,89150,6879,5557,4777,138077,15102,12715,144956,40784,36609,19197,11400,1400,20659,5733,3648,2248,26751,1988
59,"Mathews, VA",30488,2231,2480,2276,81012,376,-124,3369,144672,10045,17125,145048,53893,42816,21220,8470,808,9921,3618,2165,1357,16949,1988
60,"Mecklenburg, VA",263289,15257,26230,28034,232601,9680,6592,29274,366346,17003,12826,376026,-1414,81175,62250,29318,2382,23595,40247,16770,14388,199447,1988
61,"Middlesex, VA",51588,3330,4786,4550,74154,1275,807,5605,133925,10906,16017,135200,28171,38281,22765,8441,1028,11713,7061,3544,2516,32814,1988
62,"Montgomery + Radford, VA*",979156,54777,119732,106324,779615,4819,3527,107939,1106628,43732,12783,1111447,-91602,217736,114096,86946,5724,47259,172894,48094,42370,759003,1988
63,"Nelson, VA",65159,4221,5600,5998,101336,1560,879,7220,160612,12629,12931,162172,43397,34462,26374,12541,1406,13508,8599,4645,3239,43052,1988
64,"New Kent, VA",46164,2885,3896,4264,127335,450,309,5017,170724,10372,17092,171174,86188,29448,14391,10015,866,10681,6028,2657,1791,29455,1988
65,"Newport News (Independent City), VA",2631260,136893,332466,282330,1878495,0,0,278058,2648611,113375,16264,2648611,-474707,520047,250069,162854,8827,113375,473631,105102,96275,2044254,1988
66,"Norfolk (Independent City), VA",6680294,314879,1025035,745270,2598993,0,0,687514,4205494,159558,15671,4205494,-3393787,1153226,453275,268370,10584,159558,1397670,258830,248246,5123066,1988
67,"Northampton, VA",112742,5804,10054,9392,102683,20307,17663,10500,160325,12590,13571,180632,441,43242,34707,13310,1010,30253,14750,6146,5136,67739,1988
68,"Northumberland, VA",59090,3844,5127,5068,72173,1143,834,6378,153125,14402,15014,154268,19461,55875,26220,10275,1148,15236,7661,3419,2271,36193,1988
69,"Nottoway, VA",137233,7960,15908,17652,112854,4880,3687,16786,188451,9440,13066,193331,-7593,42346,38131,14797,1140,13127,24734,7332,6192,99372,1988
70,"Orange, VA",156745,9471,14884,15456,186305,2935,1060,17199,299360,21940,14730,302295,46759,75654,40336,20523,2073,23000,22612,9252,7179,111133,1988
71,"Page, VA",143498,7911,11820,12970,188515,16268,15135,14396,268091,21351,13531,284359,59413,55763,40081,21016,2001,36486,18305,8136,6135,88707,1988
72,"Patrick, VA",110039,6450,10326,10448,160242,6559,5649,11674,221100,15124,13233,227659,61877,33364,34053,17204,1951,20773,15550,7299,5348,73716,1988
73,"Pittsylvania + Danville, VA*",1016170,59530,98529,109618,977021,17729,13093,114339,1443292,78503,13582,1461021,75190,260559,223441,107574,7454,91596,153338,52526,45072,771236,1988
74,"Portsmouth (Independent City), VA",1591584,68726,247173,155298,1046733,0,0,146375,1600412,39262,14791,1600412,-398476,348890,204789,108200,3887,39262,324822,61074,57187,1227500,1988
75,"Powhatan, VA",74473,4376,7439,6900,160505,2833,1374,7826,211008,12871,15005,213841,93858,37640,15696,14251,1049,14245,10889,4053,3004,49339,1988
76,"Prince Edward, VA",145782,8624,14195,14592,107910,3473,2405,15920,180662,16143,10742,184135,-21952,41104,35121,17142,1241,18548,21491,8847,7606,105743,1988
77,"Prince George + Hopewell, VA*",720164,32067,114443,73478,504817,1436,923,68806,727526,24975,14719,728962,-146541,153278,70867,49526,1939,25898,151182,26978,25039,543084,1988
78,"Prince William, Manassas + Manassas Park, VA*",2193630,117181,226803,228676,3829779,-52,-794,231519,4770798,190814,20425,4770746,1867668,781876,159091,233570,16728,190020,341141,95575,78847,1662469,1988
79,"Pulaski, VA",343273,19256,43172,37140,306793,4265,2730,37826,445608,20576,12898,449873,1346,70141,72939,34879,2054,23306,61742,16846,14792,258225,1988
80,"Rappahannock, VA",30180,1817,2127,2084,64248,2167,1245,2859,105552,9948,16902,107719,36927,32755,10716,6373,1114,11193,3169,2432,1318,15818,1988
81,"Richmond (Independent City), VA",6346574,351082,668585,684884,2643585,0,0,693524,4218474,311486,20473,4218474,-3009465,991755,583134,206050,14169,311486,1011027,232409,218240,5024061,1988
82,"Richmond, VA",67963,3944,6766,6746,57984,2763,2187,7317,94942,5948,13661,97705,-2662,23196,16525,7152,628,8135,10139,3683,3055,49689,1988
83,"Roanoke (Independent City), VA",1812458,105853,175604,220234,949715,0,0,215970,1560284,107515,16103,1560284,-646773,341412,269157,96894,5881,107515,285721,80329,74448,1419222,1988
84,"Roanoke + Salem, VA*",1266183,70804,121812,142124,1350211,4132,3007,141866,1890694,112702,18594,1894826,225894,386328,158287,101904,8063,115709,192874,56427,48364,957600,1988
85,"Rockbridge, Buena Vista + Lexington, VA*",258092,15017,25877,26538,242744,7388,6340,28286,388991,23128,12735,396379,12938,93535,60100,31125,2715,29468,39146,14509,11794,189478,1988
86,"Rockingham + Harrisonburg, VA*",1015311,55191,98640,101674,870367,47216,34643,106028,1205042,95597,14745,1252258,-38916,251798,130093,84927,8679,130240,149477,51531,42852,735594,1988
87,"Russell, VA",171361,10269,16870,18382,201431,7241,6406,19460,312300,20154,10812,319541,49530,47384,70726,29555,2841,26560,26061,9599,6758,118740,1988
88,"Scott, VA",92631,6096,9885,8728,157807,3757,3238,10460,253435,13216,10805,257192,75636,45015,54370,23803,2934,16454,14249,7080,4146,61928,1988
89,"Shenandoah, VA",297734,16824,28042,28832,310389,12990,10027,31240,459112,37547,15555,472102,43895,104314,57399,30350,3501,47574,42458,16663,13162,207702,1988
90,"Smyth, VA",290276,16800,31316,29540,256860,7177,6079,31570,386782,28796,12204,393959,-1846,66518,70581,32282,2997,34875,46086,16053,13056,209315,1988
91,"Southampton + Franklin, VA*",175109,9811,17076,16968,225223,18075,15365,18295,330755,12472,13887,348830,68409,70833,52774,25119,1494,27837,25560,9741,8247,121712,1988
92,"Spotsylvania + Fredericksburg, VA*",716615,41170,64564,71334,926755,401,-266,76837,1247889,94429,18556,1248290,286977,225590,95945,67271,5675,94163,100231,35908,30233,522221,1988
93,"Stafford, VA",343971,18609,39198,34094,792412,-155,-372,35656,1044223,51340,19070,1044068,484097,202023,49633,54749,4103,50968,56245,16296,12193,236758,1988
94,"Suffolk (Independent City), VA",378955,22128,36569,39226,555224,12199,8906,41741,795163,30727,15771,807362,218010,148721,103417,51193,3024,39633,56182,19687,16663,283140,1988
95,"Surry, VA",103502,5571,10047,10884,50989,4734,3874,11013,78816,2873,13619,83550,-41500,21048,11513,6135,402,6747,15489,3020,2618,81266,1988
96,"Sussex, VA",61912,3534,5853,5676,82311,6900,5617,6372,125655,5706,12730,132555,26771,27441,22803,10413,666,11323,8691,3600,2934,41898,1988
97,"Tazewell, VA",344662,20892,33984,35190,350430,4792,3972,38487,575325,40734,12466,580117,44255,102702,126985,46537,2944,44706,51579,17946,15002,248377,1988
98,Virginia,85293416,4532597,9278171,8937872,80619960,515335,379562,9001533,113401274,5930755,18870,113916609,4328077,23822861,9473788,6036908,475187,6310317,13747107,3558017,3082830,65235992,1988
99,"Virginia Beach (Independent City), VA",3509419,182492,433089,373354,5501730,7532,6290,369169,7479904,263640,20022,7487436,2361480,1647254,338452,373955,25565,269930,619766,177877,152312,2619723,1988
100,"Warren, VA",194083,11328,20266,18704,286708,455,187,20680,401631,27790,16307,402086,113305,74257,41121,24658,2176,27977,29618,10755,8579,136488,1988
101,"Washington + Bristol, VA*",663612,37844,69579,68370,549943,12762,9667,72029,836633,52337,13261,849395,-41640,164995,134457,64054,6850,62004,103764,36144,29294,497844,1988
102,"Westmoreland, VA",63720,4087,6150,5350,116355,3949,1895,6762,201636,12570,13666,205585,59397,53863,35367,15044,1312,14465,8825,4660,3348,40430,1988
103,"Wise + Norton, VA*",514825,30401,50683,57370,380060,166,101,59086,609562,64273,13509,609728,-75679,88472,141196,45134,2730,64374,79368,20727,17997,371083,1988
104,"Wythe, VA",214952,12422,22529,21010,225528,8147,6379,22927,336025,23396,13506,344172,33503,60577,58067,25483,2614,29775,33034,12608,9994,152143,1988
105,"York + Poquoson, VA*",393883,19314,52579,38132,711155,1081,424,38380,1018301,36451,19506,1019382,355652,253123,55104,52261,3368,36875,71645,18538,15170,285363,1988
0,"Accomack, VA",292990,16410,34068,27250,250043,20296,13010,30035,434277,28257,14264,454573,-12912,126070,78460,31868,2531,41267,47693,15809,13278,204030,1989
1,"Albemarle + Charlottesville, VA*",1825590,103583,200646,185972,1393817,5279,2460,196569,2175964,147842,20382,2181243,-235204,612907,174519,107020,10109,150302,293632,79961,69852,1381656,1989
2,"Alexandria (Independent City), VA",3382206,179867,353344,352504,2413485,0,0,356119,3493586,147559,31418,3493586,-612602,881996,198105,111198,10713,147559,529596,110684,99971,2705051,1989
3,"Alleghany + Covington, VA*",285240,18099,29809,37266,221377,395,298,36732,357866,17148,14256,358261,-27131,66285,70599,25130,1387,17446,48442,11805,10418,219352,1989
4,"Amelia, VA",61782,3311,4784,4296,97849,11797,10249,5459,124013,12459,15525,135810,41526,22357,15604,8748,950,22708,6932,3201,2251,32142,1989
5,"Amherst, VA",235495,14408,27050,24340,261310,1483,1106,26578,380957,20265,13465,382440,52393,70087,51043,28402,2175,21371,39220,12063,9888,174904,1989
6,"Appomattox, VA",96973,6062,10157,9050,118632,1350,913,10587,173379,16196,14192,174729,32246,31885,24212,12312,1216,17109,14682,5589,4373,65182,1989
7,"Arlington, VA",7892252,372316,1018122,817726,3633605,0,0,781179,5258770,260424,30863,5258770,-3477468,1384514,240651,170391,17118,260424,1426985,204822,187704,6204843,1989
8,"Augusta, Staunton + Waynesboro, VA*",1167387,67388,127507,117684,1063702,31850,26404,126230,1577447,96614,16672,1609297,22545,351784,193811,96527,8746,123018,186349,53093,44347,858020,1989
9,"Bath, VA",56631,3464,5271,5796,43531,477,269,6362,76920,3887,15760,77397,-6738,21614,12252,4911,469,4156,8169,2897,2428,44306,1989
10,"Bedford, VA*",287998,18519,30344,28492,575736,3399,1967,32765,841942,36520,16687,845341,320503,173793,95812,50658,4461,38487,44590,17239,12778,204921,1989
11,"Bland, VA",44676,2833,5182,4244,52266,595,188,4955,77398,6591,12086,77993,12545,12742,12985,6453,864,6779,7304,2657,1793,30593,1989
12,"Botetourt, VA",134288,8663,12762,13792,272726,3812,2440,15559,384802,22947,15690,388614,153997,72843,43045,24768,2223,25387,19658,7385,5162,89243,1989
13,"Brunswick, VA",102591,6168,11103,9354,112348,8405,6715,10845,177407,11045,11601,185812,20602,36557,36907,16017,1010,17760,15780,5856,4846,69051,1989
14,"Buchanan, VA",396461,23158,44480,42954,265051,363,336,44635,419700,40424,13131,420063,-86775,70601,84411,31990,1605,40760,65957,13536,11931,289744,1989
15,"Buckingham, VA",75555,4716,7542,6250,103647,4817,4328,7841,158074,15013,12678,162891,35933,33369,25875,12848,1101,19341,10667,3911,2810,45547,1989
16,"Campbell + Lynchburg, VA*",1764558,102324,188473,191938,1198407,7285,6087,198293,1937775,93768,17148,1945060,-367858,439912,306741,113431,7908,99855,284442,78076,70168,1380261,1989
17,"Caroline, VA",120329,7093,13639,10604,203734,3386,2973,12395,292157,18922,15632,295543,95800,56719,35090,18906,1358,21895,18941,5875,4517,79493,1989
18,"Carroll + Galax, VA*",298367,18174,33902,29656,268725,9076,7941,33002,425477,29947,13047,434553,3360,76762,89066,33308,3103,37888,48730,18235,15132,211749,1989
19,"Charles City, VA",22200,1442,2370,1906,66340,948,565,2395,93981,4516,15111,94929,46535,18098,10491,6282,389,5081,3323,1305,916,13796,1989
20,"Charlotte, VA",70278,4575,6867,6428,84736,5053,3715,7789,139329,11390,12345,144382,22247,31423,28223,11696,1395,15105,10081,4526,3131,45092,1989
21,"Chesapeake (Independent City), VA",1145267,66647,127666,122866,2075623,8064,4787,128080,2741493,81328,18647,2749557,1058436,468230,205704,147455,8861,86115,189099,55960,47099,870053,1989
22,"Chesterfield, VA",2216403,120717,249005,229354,3494317,4191,3458,235394,4424512,154390,22011,4428703,1513308,731121,203265,201200,14816,157848,363682,90809,75993,1694873,1989
23,"Clarke, VA",97114,5702,8529,8598,150431,5548,2912,10001,218950,16830,18477,224498,63318,55722,18345,12150,1566,19742,12828,5298,3732,64544,1989
24,"Craig, VA",14952,996,1559,1262,40408,1189,1056,1627,58157,2978,13618,59346,27083,11146,7792,4358,396,4034,2190,1095,699,8728,1989
25,"Culpeper, VA",271659,16179,27726,26672,340988,5704,3164,29515,493681,31352,18661,499385,98844,108705,49692,26761,2813,34516,41062,13630,10817,196081,1989
26,"Cumberland, VA",39936,1846,2283,1994,74587,14783,13300,2843,95820,8809,14144,110603,37494,20355,15661,7820,716,22109,3280,1884,1168,14547,1989
27,"Dickenson, VA",110310,7142,12931,10194,113746,175,155,12239,205032,20312,11475,205207,15675,37923,53538,17883,1000,20467,18028,5069,4069,71815,1989
28,"Dinwiddie, Colonial Heights + Petersburg, VA*",657265,40771,72526,67612,796679,6829,5500,74577,1305514,54458,17338,1312343,213991,284872,230792,75692,4117,59958,106332,34210,30093,490975,1989
29,"Essex, VA",70976,4430,7320,6738,72049,2286,1711,7799,125698,8972,14659,127984,8872,33924,22011,8731,799,10683,10689,4422,3623,49604,1989
30,"Fairfax, Fairfax City + Falls Church, VA*",16076716,869992,1476101,1675868,19013009,1141,-234,1707926,24908741,1041233,29655,24909882,4644219,5147910,748963,839978,83019,1040999,2314035,545558,462539,12721682,1989
31,"Fauquier, VA",458958,25168,48242,42002,797912,10914,6533,46169,1142212,64907,24001,1153126,385123,294459,60755,48044,5718,71440,69243,21892,16174,318275,1989
32,"Floyd, VA",62472,3836,4987,4438,103977,9154,8101,6055,149157,15100,13173,158311,47560,30200,24134,12018,1858,23201,7206,4166,2308,32065,1989
33,"Fluvanna, VA",60175,3993,5931,5546,120538,1122,728,6766,190595,10334,15999,191717,67129,46789,24390,11983,1171,11062,8704,3560,2389,40409,1989
34,"Franklin, VA",250174,15123,25521,24458,380863,10418,7013,27352,541594,27491,14179,552012,158041,106098,65051,38932,3082,34504,37750,14910,11828,177920,1989
35,"Frederick + Winchester, VA*",951343,54815,93032,97386,808815,6673,2580,103508,1144783,96889,17641,1151456,-39020,239123,103518,65272,6986,99469,141725,43151,36165,710149,1989
36,"Giles, VA",164713,9909,20583,17526,151551,2329,2169,18672,232320,10551,14196,234649,5510,42057,41041,16529,1298,12720,29346,7322,6024,122647,1989
37,"Gloucester, VA",149462,9629,15410,13736,337736,1596,1147,16497,490809,23843,16461,492405,204771,108771,45898,29913,2514,24990,22278,9319,6805,102194,1989
38,"Goochland, VA",89628,5538,8393,7902,212296,1582,1198,9489,307426,18004,22088,309008,132157,78103,18609,13990,1535,19202,12344,4843,3308,58082,1989
39,"Grayson, VA",72403,4747,7250,6226,120072,6132,5395,7860,184590,11678,11721,190722,55529,38077,32573,16272,2050,17073,10363,5200,3150,44967,1989
40,"Greene, VA",43906,2865,4004,3334,105927,1273,954,4532,147224,12522,15000,148497,66553,27532,15038,9900,968,13476,5671,2549,1581,24759,1989
41,"Greensville + Emporia, VA*",150928,8771,16852,15620,115061,6055,5124,16581,180721,8030,13036,186776,-19286,35134,36581,14328,742,13154,24662,8100,7358,113112,1989
42,"Halifax, VA",312368,18916,32995,32308,302999,12776,9940,35070,466088,24597,13302,478864,25701,92047,83818,35999,3288,34537,49149,17551,14263,228682,1989
43,"Hampton (Independent City), VA",1882263,90152,288451,197892,1503602,0,0,189098,2227975,57662,16711,2227975,-189563,507999,216374,133327,6396,57662,387397,76387,69991,1437204,1989
44,"Hanover, VA",775358,45135,73308,79654,931990,6626,4549,84962,1267767,76704,20600,1274393,241594,244982,97421,61864,6085,81253,113135,36075,29990,580970,1989
45,"Henrico, VA",3361044,190921,314068,370508,3575355,2356,1572,376175,4975508,146854,22987,4977864,590486,1055023,347486,216547,14781,148426,499322,136552,121771,2713296,1989
46,"Henry + Martinsville, VA*",1013095,58878,113238,112496,771832,865,622,115126,1199313,50299,16205,1200178,-126137,272443,155903,74062,5151,50921,169486,49948,44797,792688,1989
47,"Highland, VA",18346,1026,1303,1066,23445,4398,4136,1559,33312,4374,14388,37710,6658,8547,5718,2621,619,8510,1836,1299,680,8000,1989
48,"Isle of Wight, VA",310223,17396,32608,32634,312146,8760,6720,33713,423999,15471,17496,432759,35636,76739,43874,24735,1713,22191,48925,12070,10357,239107,1989
49,"James City + Williamsburg, VA*",752720,43145,76723,80234,619369,875,470,83262,919235,42618,20391,920110,-50089,216427,84314,45123,3609,43088,116840,37058,33449,592792,1989
50,"King George, VA",263063,10561,41807,23478,172572,1407,1088,22300,250605,13733,19147,252012,-68191,63843,15597,13162,1064,14821,53546,8358,7294,194696,1989
51,"King William, VA",117847,6907,11230,11988,137415,2693,2038,12901,193201,10255,18425,195894,32469,38477,20002,10632,831,12293,17224,4628,3797,88330,1989
52,"King and Queen, VA",30305,1806,3752,2458,63412,2656,2251,3035,93152,6129,15198,95808,36142,19647,12749,6304,519,8380,4981,1646,1127,16944,1989
53,"Lancaster, VA",99255,6694,9387,9536,84019,886,737,11462,217063,12766,20112,217949,-3774,98935,34995,10837,1279,13503,14155,5982,4703,71597,1989
54,"Lee, VA",105309,7466,12093,9912,141499,3095,2440,12422,260866,13882,10638,263961,48612,47219,75243,24813,2635,16322,17049,7583,4948,71938,1989
55,"Loudoun, VA",1191904,65330,117313,122076,1601411,4752,886,126368,2153200,95806,25973,2157952,535875,477865,78676,83084,9863,96692,178351,47850,37987,916861,1989
56,"Louisa, VA",209574,12467,21372,21168,220344,3054,2472,23051,317896,21132,16132,320950,33821,58610,41996,19895,1863,23604,31956,8687,6824,154014,1989
57,"Lunenburg, VA",71662,4362,8260,6860,87327,4482,3268,7792,138010,7819,12364,142492,23457,30754,24411,11525,1003,11087,11690,4742,3739,48885,1989
58,"Madison, VA",58557,3536,4597,3966,96947,7706,6282,5519,151237,16216,13594,158943,43909,42325,19671,11692,1459,22498,6580,3768,2309,29479,1989
59,"Mathews, VA",32947,2635,2908,2490,87455,944,426,3880,156532,9813,18814,157476,58388,47504,22517,8370,833,10239,4153,2251,1418,18555,1989
60,"Mecklenburg, VA",288268,17083,29876,29830,254085,13196,9805,31998,399041,20010,14073,412237,-2185,90392,67760,29292,2446,29815,44791,17117,14671,213662,1989
61,"Middlesex, VA",54690,3778,5623,4818,77662,1206,768,6187,144441,10440,17151,145647,29159,44661,23324,8492,1020,11208,8032,3599,2579,35450,1989
62,"Montgomery + Radford, VA*",1029380,57810,135061,109416,824468,4769,3440,112518,1193453,42172,13564,1198222,-92394,249969,123785,88338,5824,45612,189769,49066,43242,793999,1989
63,"Nelson, VA",70729,4888,6292,6522,106560,1450,674,8149,175694,12948,13995,177144,43980,39996,30588,12658,1454,13622,9553,4655,3201,47554,1989
64,"New Kent, VA",49749,3255,4619,4490,137085,693,536,5500,186025,10604,18291,186718,92836,32444,17189,10208,882,11140,6864,2760,1878,31745,1989
65,"Newport News (Independent City), VA",2704034,142816,363534,289626,1943326,0,0,287629,2815375,101997,16773,2815375,-473079,586255,285794,167851,8584,101997,508347,105969,97385,2093690,1989
66,"Norfolk (Independent City), VA",6930527,332587,1080997,782262,2597328,0,0,723718,4327828,146711,16452,4327828,-3609481,1234302,496198,263064,10999,146711,1472128,260010,249011,5311688,1989
67,"Northampton, VA",107995,5996,10498,8944,100033,18596,15568,10468,173788,11982,14721,192384,2506,54986,37365,13069,1058,27550,14970,5984,4926,65475,1989
68,"Northumberland, VA",63172,4391,5707,5108,76972,2565,2230,6945,163590,16110,15905,166155,20745,61142,28041,10447,1151,18340,8261,3477,2326,36571,1989
69,"Nottoway, VA",145386,8661,17379,17936,119251,6817,5525,17629,202538,10150,14004,209355,-8506,47598,42506,14950,1138,15675,26347,7351,6213,103364,1989
70,"Orange, VA",172106,10789,17112,16574,203576,5025,2941,19076,338253,23366,16274,343278,50546,91316,48386,21094,2067,26307,25399,9488,7421,120400,1989
71,"Page, VA",158157,8920,13693,13758,203175,21784,20655,15799,283779,21350,14237,305563,60817,59202,43186,21462,2042,42005,20572,8417,6375,95580,1989
72,"Patrick, VA",115847,7172,11692,11086,166557,7007,6019,12715,234567,14294,13888,241574,63425,38084,36933,17394,1922,20313,17235,7446,5524,78299,1989
73,"Pittsylvania + Danville, VA*",1088773,65796,113914,115426,1040017,18782,13734,123509,1556974,84934,14598,1575756,74753,296073,239666,107943,7511,98668,171627,52987,45476,818478,1989
74,"Portsmouth (Independent City), VA",1617943,73646,256838,160790,1055946,0,0,154041,1650296,37646,15711,1650296,-407956,366972,227378,105041,4001,37646,337233,59617,55616,1243064,1989
75,"Powhatan, VA",87313,5219,9544,8038,178018,3766,2486,9238,237140,13005,16153,240906,99943,44228,18660,14914,1135,15491,13563,4459,3324,58259,1989
76,"Prince Edward, VA",157263,9606,16468,15552,114944,4140,3058,17382,197560,16480,11775,201700,-24937,46936,39820,17130,1203,19538,24244,8940,7737,113481,1989
77,"Prince George + Hopewell, VA*",744152,34675,119587,77266,540406,1121,596,73308,782195,25966,15690,783316,-130438,165000,77910,49923,2043,26562,158220,27225,25182,559370,1989
78,"Prince William, Manassas + Manassas Park, VA*",2427608,131888,266376,254192,4167382,417,-306,258984,5222645,185216,21386,5223062,1998758,872252,183428,244225,17532,184910,393472,101947,84415,1849226,1989
79,"Pulaski, VA",364590,21053,46475,38926,321164,5446,3982,40516,473661,20968,13845,479107,-2910,80287,77656,34604,2050,24950,65938,16629,14579,273702,1989
80,"Rappahannock, VA",32235,2135,2391,2240,70527,2141,1266,3255,120490,10372,18892,122631,41547,40297,11807,6491,1158,11638,3511,2450,1292,17086,1989
81,"Richmond (Independent City), VA",6597940,368805,753722,703528,2721636,0,0,720569,4558145,306539,22348,4558145,-3155735,1218920,617589,203963,13971,306539,1105486,227528,213557,5185915,1989
82,"Richmond, VA",73758,4370,7612,7224,61447,4135,3452,7982,102683,5712,14768,106818,-4329,26993,18378,7233,627,9164,11224,3669,3042,53370,1989
83,"Roanoke (Independent City), VA",1917891,114134,196636,225448,991688,0,0,226858,1672480,103006,17387,1672480,-699345,388000,292792,96190,5686,103006,309360,83187,77501,1505525,1989
84,"Roanoke + Salem, VA*",1368594,78274,139122,151048,1453988,5538,4353,153798,2077548,116279,20323,2083086,239192,454816,174282,102501,8172,120632,214646,57626,49454,1033316,1989
85,"Rockbridge, Buena Vista + Lexington, VA*",275321,16670,28615,27972,258788,7110,6034,30656,428113,24347,13855,435223,14123,111426,65009,31413,2709,30381,42601,14778,12069,202339,1989
86,"Rockingham + Harrisonburg, VA*",1113989,60889,113889,108748,955299,72630,59612,115263,1308333,95615,15957,1380963,-43427,287395,138269,86545,8915,155227,168263,52875,43960,790499,1989
87,"Russell, VA",180924,11204,20262,18666,210548,8542,7683,20537,329528,19494,11664,338070,50161,54977,72545,28984,2739,27177,29595,10057,7318,124152,1989
88,"Scott, VA",100243,6984,10990,9098,169222,5225,4637,11533,273779,14367,11902,279004,80512,50521,59261,23442,2894,19004,15539,7194,4300,65700,1989
89,"Shenandoah, VA",321583,18804,31388,30428,331231,17564,14487,34018,487501,40117,16310,505065,43666,111448,62386,30967,3599,54604,46602,17031,13432,220377,1989
90,"Smyth, VA",329268,19527,38355,32984,284900,8251,7168,36019,426924,31945,13485,435175,-8349,75475,74800,32270,2999,39113,54847,17012,14013,235308,1989
91,"Southampton + Franklin, VA*",188297,10860,19646,17908,242627,20216,17212,19814,361344,12677,15065,381560,74144,77571,61362,25327,1419,29889,28600,9737,8318,129808,1989
92,"Spotsylvania + Fredericksburg, VA*",790592,46890,74614,78104,1035833,890,243,85942,1411637,100250,19600,1412527,331183,269235,107459,72066,6146,100493,113666,37859,31713,576433,1989
93,"Stafford, VA",392095,21650,47858,40114,862240,296,115,41707,1139751,46287,19609,1140047,511852,226365,51442,58139,4539,46402,67915,18345,13806,277778,1989
94,"Suffolk (Independent City), VA",414575,24793,43397,42492,591758,14298,10749,46039,854718,30355,16754,869016,223222,162717,114541,51869,3050,41104,64643,20487,17437,308828,1989
95,"Surry, VA",121718,6657,11939,12566,56886,5411,4295,12940,86298,3505,14985,91709,-51892,22488,12335,6120,388,7800,18222,3205,2817,95696,1989
96,"Sussex, VA",65764,3930,6649,6000,87027,7585,5843,6930,137643,5555,14049,145228,28193,30614,27587,10337,664,11398,9649,3649,2985,44717,1989
97,"Tazewell, VA",358847,22640,38969,36676,362587,5180,4313,40978,613329,35782,13440,618509,44718,118244,137678,46021,2945,40095,57307,18340,15395,261445,1989
98,Virginia,91220891,4959104,10407139,9573576,86036838,634621,489375,9745892,122602410,5649338,20136,123237031,4561839,26823928,10376265,6120246,483977,6138713,15193927,3655230,3171253,69888251,1989
99,"Virginia Beach (Independent City), VA",3688199,196293,471116,394580,5827103,6979,5655,393583,8099079,244103,21093,8106058,2532487,1870047,408908,384304,26556,249758,668406,183552,156996,2770035,1989
100,"Warren, VA",202869,12326,22794,19636,311430,762,457,22144,436589,25561,17084,437351,130705,82014,43907,25600,2179,26018,32612,10834,8655,144239,1989
101,"Washington + Bristol, VA*",711013,41793,80153,73160,580064,12386,9207,78373,891096,49475,14075,903482,-52576,181525,141893,64189,6828,58682,116733,37198,30370,535598,1989
102,"Westmoreland, VA",68928,4706,7061,5776,125130,5050,2806,7594,219520,12464,14805,224570,63796,60821,38619,15169,1252,15270,9949,4641,3389,43709,1989
103,"Wise + Norton, VA*",499073,30551,55533,57136,363480,165,94,59119,613718,41756,13877,613883,-76474,101365,149038,44239,2544,41850,84101,20467,17923,373122,1989
104,"Wythe, VA",229324,13680,25718,22278,239017,10621,8752,24819,359840,21154,14556,370461,34512,69270,62174,25450,2591,29906,36857,12961,10370,162561,1989
105,"York + Poquoson, VA*",425722,21788,58739,41648,753636,1311,619,42612,1098272,38397,20884,1099583,370526,291334,54613,52653,3498,39016,79563,19498,16000,307143,1989
0,"Accomack, VA",308248,17204,38172,29460,263212,18300,9560,31934,447905,27238,14659,466205,-13102,117918,85075,31803,2643,36798,52902,16514,13871,218548,1990
1,"Albemarle + Charlottesville, VA*",1949186,112872,219002,198560,1493709,7336,4279,212152,2361001,159068,21687,2368337,-243325,686420,188208,109204,10655,163347,318282,80918,70263,1467557,1990
2,"Alexandria (Independent City), VA",3497950,188220,365693,369672,2446486,0,0,373056,3534839,153915,31705,3534839,-678408,879842,208511,111491,10794,153915,550529,108340,97546,2793506,1990
3,"Alleghany + Covington, VA*",295988,18696,30753,39218,230136,382,263,38305,373940,16215,15105,374322,-27547,67420,76766,24782,1473,16478,50362,12017,10544,229148,1990
4,"Amelia, VA",59768,3344,5089,4470,98418,9640,7885,5579,128328,10954,15637,137968,44229,22358,17192,8823,931,18839,7324,3173,2242,33605,1990
5,"Amherst, VA",242007,14720,28546,25204,275932,1658,1207,27322,398270,18704,13938,399928,61247,70861,53135,28694,2289,19911,41148,12397,10108,180948,1990
6,"Appomattox, VA",95407,5903,10861,9336,122413,1339,791,10571,181311,11738,14835,182650,37577,33965,26272,12312,1278,12529,15529,5772,4494,67349,1990
7,"Arlington, VA",7630568,368037,975583,813742,3754103,0,0,774908,5417372,257788,31650,5417372,-3101557,1411781,251488,171164,15821,257788,1382454,195413,179592,5990326,1990
8,"Augusta, Staunton + Waynesboro, VA*",1232434,72230,138423,125756,1128373,35187,29053,135108,1672498,85461,17408,1707685,31047,370694,208618,98096,9154,114514,201301,54582,45428,916619,1990
9,"Bath, VA",57508,3457,5678,5888,44437,904,687,6401,77766,3259,16424,78670,-6670,21058,13175,4790,455,3946,8622,2821,2366,44940,1990
10,"Bedford, VA*",316259,20224,33915,31746,629487,3949,2383,36097,911496,36198,17612,915445,349325,181251,104707,51978,5003,38581,49788,18336,13333,227890,1990
11,"Bland, VA",49546,3067,5963,4802,54938,919,437,5468,83098,6179,12856,84017,10860,13811,15268,6535,921,6616,8364,2867,1946,34566,1990
12,"Botetourt, VA",132544,8512,13609,13654,280897,3148,1577,15339,398476,17623,16007,401624,163692,75003,45724,25091,2267,19200,20436,7493,5226,92908,1990
13,"Brunswick, VA",109147,6289,12349,10072,118475,10368,8401,11325,184770,8622,12207,195138,20653,37186,39477,15986,1021,17023,17385,5914,4893,74739,1990
14,"Buchanan, VA",403527,23840,46419,44160,273880,393,364,45920,440775,33920,14129,441168,-83727,75086,92202,31224,1669,34284,68499,13747,12078,300744,1990
15,"Buckingham, VA",75161,4603,8167,6706,103333,5376,4874,7956,157357,10488,12600,162733,36128,31402,27998,12915,1009,15362,11520,3897,2888,48279,1990
16,"Campbell + Lynchburg, VA*",1860585,108113,200597,204420,1259643,7447,6059,210323,1996696,90733,17591,2004143,-390619,417797,326703,113929,8244,96792,302807,78754,70510,1460986,1990
17,"Caroline, VA",116931,7063,13635,10696,200282,2641,2122,12411,293520,16351,15313,296161,95762,56871,39008,19341,1312,18473,18983,5697,4385,79475,1990
18,"Carroll + Galax, VA*",308188,18724,35654,30966,275927,8438,7161,34207,446367,28176,13631,454805,1946,78522,100356,33366,3219,35337,51137,18518,15299,221714,1990
19,"Charles City, VA",22330,1525,2488,1922,68314,973,465,2486,96307,4584,15441,97280,48470,17655,11311,6300,424,5049,3449,1357,933,13832,1990
20,"Charlotte, VA",70792,4694,7365,6502,86010,6252,4671,7945,141542,9725,12623,147794,23163,32131,29653,11708,1425,14396,10616,4590,3165,45780,1990
21,"Chesapeake (Independent City), VA",1308716,75203,151197,143506,2195225,9601,5459,146956,2917818,65785,19092,2927419,1033465,492957,239237,153335,9098,71244,222950,62011,52913,1014522,1990
22,"Chesterfield, VA",2383412,132512,271451,251252,3719246,4337,3369,258138,4730311,139559,22362,4734648,1593972,784895,230507,211727,15891,142928,397077,96849,80958,1843407,1990
23,"Clarke, VA",101290,5936,9243,9480,133003,5955,2759,10676,206037,13386,17550,211992,42389,59475,19514,12079,1608,16145,13983,5434,3826,71162,1990
24,"Craig, VA",14393,1014,1609,1248,42506,1135,982,1638,60847,2698,14132,61982,29751,11181,8295,4386,438,3680,2233,1060,622,8480,1990
25,"Culpeper, VA",283767,16681,29633,28548,349765,9287,6168,30955,511375,25558,18532,520662,96953,115639,55258,28096,3007,31726,43907,13604,10597,208134,1990
26,"Cumberland, VA",36076,1861,2501,2130,73695,10639,8894,2926,100732,8112,14189,111371,40545,20519,17157,7849,685,17006,3566,1850,1165,15504,1990
27,"Dickenson, VA",122622,7717,14587,11950,119188,612,586,13692,211043,16786,12059,211655,10258,36260,56207,17552,1039,17372,20562,5205,4166,84688,1990
28,"Dinwiddie, Colonial Heights + Petersburg, VA*",727775,44124,85690,75468,851167,9147,7582,81858,1373635,50271,18323,1382782,205250,287859,243756,75469,4239,57853,123424,36413,32174,546498,1990
29,"Essex, VA",78795,4842,8506,7764,74737,1839,1142,8724,131857,8316,15332,133696,4666,34706,24253,8720,863,9458,12388,4706,3843,56949,1990
30,"Fairfax, Fairfax City + Falls Church, VA*",17089472,943040,1589544,1828112,19957477,2534,1221,1857096,26648965,907111,31314,26651499,4725101,5849949,844073,851111,86482,908332,2503600,556597,470115,13677540,1990
31,"Fauquier, VA",458653,25513,50748,44020,804505,10942,5515,47523,1181396,52229,24379,1192338,393375,318745,69088,48908,5877,57744,72758,22302,16425,328151,1990
32,"Floyd, VA",63306,3811,5376,4660,105346,9887,8539,6141,151020,13367,13429,160907,48181,30385,25176,11982,1801,21906,7706,4090,2289,33694,1990
33,"Fluvanna, VA",62448,4137,6511,5844,128955,1317,881,7059,203661,9482,16329,204978,73566,50211,25812,12553,1268,10363,9433,3696,2428,42652,1990
34,"Franklin, VA",265771,15637,27437,25858,406161,14995,11035,28566,572921,25176,14782,587916,168956,109983,71772,39773,3145,36211,40366,15116,11971,189194,1990
35,"Frederick + Winchester, VA*",988615,58259,101286,104122,856912,6923,2236,110320,1215258,76324,17879,1222181,-21383,251154,114115,68358,7295,78560,153347,44318,37023,756708,1990
36,"Giles, VA",170637,10210,21480,18316,156045,2049,1868,19368,243239,10401,15000,245288,4776,44374,44869,16352,1335,12269,30638,7259,5924,127730,1990
37,"Gloucester, VA",158095,10129,17348,14920,362057,1701,1201,17589,525757,22383,17452,527458,221551,115283,50118,30224,2600,23584,24808,9624,7024,109703,1990
38,"Goochland, VA",92626,5740,9790,8926,219376,933,478,10203,328147,12755,23180,329080,136953,88391,21313,14197,1598,13233,14253,5180,3582,65140,1990
39,"Grayson, VA",82839,5285,8457,6948,129694,6757,5930,8759,199154,14824,12615,205911,55614,39449,36768,16323,2170,20754,11931,5447,3277,50154,1990
40,"Greene, VA",48862,3278,4969,4224,112485,1315,881,5390,156110,10323,15137,157425,69013,28642,16298,10400,1049,11204,7081,2858,1809,30577,1990
41,"Greensville + Emporia, VA*",165595,9635,19016,17230,124866,6926,5825,18250,194773,7237,14294,201699,-22479,37571,39262,14111,768,13062,27631,8258,7490,124902,1990
42,"Halifax, VA",326448,19399,35762,33936,316246,14374,10805,36367,483923,21995,13815,498297,26165,91534,90517,36069,3339,32800,52730,18061,14722,240918,1990
43,"Hampton (Independent City), VA",1953457,94713,295435,212506,1597327,0,0,200966,2341843,48501,17445,2341843,-155164,512443,232073,134245,6453,48501,401688,75839,69386,1503268,1990
44,"Hanover, VA",803358,47286,78471,83836,974288,6474,4118,89204,1320112,70201,20790,1326586,260134,245436,106862,63808,6381,74319,120389,36236,29855,608650,1990
45,"Henrico, VA",3592908,206884,343190,397824,3726017,2480,1558,405796,5313222,154440,24322,5315702,538905,1212400,377285,218556,15789,155998,542102,141134,125345,2894808,1990
46,"Henry + Martinsville, VA*",1021085,59808,115925,113390,782540,1499,1207,116503,1232878,46388,16878,1234377,-122042,276675,175162,73136,5170,47595,172620,49408,44238,800870,1990
47,"Highland, VA",18132,987,1471,1132,23703,4422,4123,1553,35649,3443,15207,40071,7124,10747,5621,2635,623,7566,2037,1300,677,8529,1990
48,"Isle of Wight, VA",320361,17962,33847,33480,314730,11725,9182,34702,431133,16468,17589,442858,29071,75967,52161,25178,1815,25650,50587,12084,10269,244124,1990
49,"James City + Williamsburg, VA*",812137,46726,86514,87692,654356,881,448,90572,978940,38288,20964,979821,-67209,235362,90103,46738,3976,38736,130360,38339,34363,643041,1990
50,"King George, VA",292308,12151,47343,27742,192763,1528,1095,26022,273817,11762,20241,275345,-73523,65400,17182,13603,1108,12857,61214,9057,7949,218237,1990
51,"King William, VA",115967,7034,11061,11934,141295,2436,1633,13001,203268,9143,18704,205704,38329,41058,23351,10998,890,10776,17028,4623,3733,88163,1990
52,"King and Queen, VA",29502,1965,3605,2520,65944,2315,1812,3225,96700,5634,15742,99015,39667,19566,13505,6290,538,7446,4865,1595,1057,17191,1990
53,"Lancaster, VA",103234,6889,10067,10006,87737,640,479,11892,227917,12475,20921,228557,-3605,102520,38300,10925,1329,12954,15070,5882,4553,75210,1990
54,"Lee, VA",113041,7644,13382,10540,151458,4354,3566,12914,277802,14212,11546,282156,51331,49005,81693,24438,2607,17778,18652,7782,5175,76611,1990
55,"Loudoun, VA",1354674,74667,140926,142170,1677832,10812,6133,145752,2233943,82235,25740,2244755,468910,480043,86880,87208,10292,88368,212011,53140,42848,1054295,1990
56,"Louisa, VA",194063,11656,21306,19536,216782,2808,2123,21424,317096,19110,15601,319904,44143,58089,45033,20506,2052,21233,31074,8369,6317,141756,1990
57,"Lunenburg, VA",73853,4383,8634,7086,91475,5689,4211,7926,144600,6857,13144,150289,25548,31551,27263,11434,1032,11068,12177,4717,3685,50608,1990
58,"Madison, VA",55229,3348,5019,4154,97009,7071,5391,5425,154047,11819,13411,161118,47205,42280,21829,12014,1470,17210,7096,3720,2250,30923,1990
59,"Mathews, VA",34117,2597,3301,2768,90745,1084,495,3981,162886,8481,19632,163970,60609,48988,24237,8352,854,8976,4685,2331,1477,20456,1990
60,"Mecklenburg, VA",297047,17444,32488,30572,262371,13466,9395,32730,416354,19880,14686,429820,-1946,93914,73535,29268,2556,29275,47774,17428,14872,219998,1990
61,"Middlesex, VA",54066,3725,5942,4712,78869,991,549,6081,152562,10147,17613,153553,30884,48201,26483,8718,1032,10696,8298,3507,2475,35072,1990
62,"Montgomery + Radford, VA*",1082689,60589,144970,115304,867711,4817,3308,118241,1253050,38218,13944,1257867,-96737,252811,137345,90211,6124,41526,202622,49351,43227,838541,1990
63,"Nelson, VA",72682,4973,6922,6738,108330,1326,372,8342,180463,12704,14172,181789,43990,40961,32498,12827,1438,13076,10291,4565,3127,49315,1990
64,"New Kent, VA",52420,3461,5114,4960,144918,588,397,5941,195718,9617,18576,196306,98439,33046,18342,10568,950,10014,7594,2878,1928,34812,1990
65,"Newport News (Independent City), VA",2894780,152775,400361,317724,2076015,0,0,311637,2983000,77899,17310,2983000,-507128,603107,303878,172324,8689,77899,559223,109896,101207,2257658,1990
66,"Norfolk (Independent City), VA",7218304,349187,1094733,843822,2652985,0,0,771098,4422620,123642,16917,4422620,-3794221,1244521,525114,261425,11228,123642,1516644,258527,247299,5578018,1990
67,"Northampton, VA",103897,6287,11181,9264,97041,12556,8779,10919,176659,11011,14456,189215,4063,53184,38990,13089,1093,19790,15813,5928,4835,68294,1990
68,"Northumberland, VA",64962,4519,6387,5696,78358,1978,1580,7367,173361,13597,16620,175339,20763,65049,31932,10550,1199,15177,9235,3482,2283,40550,1990
69,"Nottoway, VA",154602,9160,19236,19704,123042,6090,4560,19012,209417,8002,14315,215507,-12548,47280,45185,15055,1182,12562,29088,7660,6478,112952,1990
70,"Orange, VA",189020,11652,19002,18732,218996,6615,4084,21018,357837,20121,16916,364452,50994,93164,52292,21545,2306,24205,28368,10124,7818,136447,1990
71,"Page, VA",146896,8629,14611,13670,190245,14511,13274,15464,283080,17166,13676,297591,58813,60435,46911,21760,2063,30440,21446,8485,6422,95010,1990
72,"Patrick, VA",121996,7255,12964,11946,169382,7482,6309,13228,240354,11772,14208,247836,60614,38720,39734,17444,1933,18081,18937,7623,5690,84978,1990
73,"Pittsylvania + Danville, VA*",1095481,67383,118445,115638,1048728,24739,18720,125202,1594592,80026,14851,1619331,78449,304512,266091,109036,7844,98746,176264,52644,44800,820471,1990
74,"Portsmouth (Independent City), VA",1644586,76815,261093,168714,1055311,0,0,161172,1659055,39284,15978,1659055,-428103,359164,244580,103833,4157,39284,345450,58676,54519,1259852,1990
75,"Powhatan, VA",96676,5759,11606,9198,187825,3398,2176,10358,251595,11295,16511,254993,101507,45026,22142,15444,1203,13471,16205,4840,3637,67000,1990
76,"Prince Edward, VA",175920,10919,19167,17780,124560,3944,2736,19809,216408,15970,12669,220352,-31551,53925,41867,17393,1231,18706,28057,9556,8325,129157,1990
77,"Prince George + Hopewell, VA*",805203,39628,122467,87554,595981,2094,1505,83405,845085,22683,16682,847179,-125817,165843,85355,50785,2204,24188,166244,27592,25388,614771,1990
78,"Prince William, Manassas + Manassas Park, VA*",2454519,135572,277234,263746,4383163,1085,311,267445,5489331,138709,21823,5490416,2196089,908056,199197,251587,18368,139020,409107,103287,84919,1906392,1990
79,"Pulaski, VA",356196,20575,46119,37944,319247,5891,4355,39547,479456,19013,14019,485347,2598,81173,84927,34621,2097,23368,65091,16691,14594,267737,1990
80,"Rappahannock, VA",34160,2329,2824,2660,72393,1146,236,3659,122233,9676,18564,123379,41892,38772,12214,6646,1143,9912,4154,2536,1393,20094,1990
81,"Richmond (Independent City), VA",6675485,372822,791530,716248,2712386,0,0,730946,4620805,298730,22711,4620805,-3232153,1263684,644735,203463,14437,298730,1149654,219643,205206,5227101,1990
82,"Richmond, VA",72518,4222,7786,7234,62751,4433,3559,7839,105618,4547,15119,110051,-1928,27514,19786,7279,589,8106,11403,3422,2833,53009,1990
83,"Roanoke (Independent City), VA",2029627,120866,212997,244524,1026382,0,0,243128,1751681,100213,18087,1751681,-760117,412266,313033,96846,5812,100213,335259,84070,78258,1594155,1990
84,"Roanoke + Salem, VA*",1487192,86976,150594,164070,1575599,5748,4370,169011,2216243,144789,21501,2221991,257418,458523,187869,103344,8552,149159,232629,59227,50675,1105404,1990
85,"Rockbridge, Buena Vista + Lexington, VA*",295213,17751,31510,30580,277541,6300,5081,33041,461731,21665,14710,468031,15369,119272,71218,31817,2834,26746,46800,15517,12683,221667,1990
86,"Rockingham + Harrisonburg, VA*",1173749,64701,125647,116466,1000193,70833,55938,122934,1374911,90384,16270,1445744,-50622,290135,155416,88857,9099,146322,183880,54138,45039,843547,1990
87,"Russell, VA",189101,11588,21079,19936,219762,8177,7213,21556,345376,16461,12324,353553,52217,55176,78615,28688,2779,23674,31047,10020,7241,134380,1990
88,"Scott, VA",104376,6929,12143,10012,175577,5957,5231,11935,283945,9718,12487,289902,83136,51693,62632,23216,2833,14949,17149,7437,4604,72278,1990
89,"Shenandoah, VA",326924,19414,33065,31570,329760,14645,11114,35199,498076,38771,16114,512721,38035,116192,66769,31818,3876,49885,48850,17248,13372,228189,1990
90,"Smyth, VA",355080,20815,42990,36148,301983,9121,7949,38889,448628,28461,14112,457749,-14208,76436,79330,32437,3156,36410,61064,17744,14588,257606,1990
91,"Southampton + Franklin, VA*",207620,11385,21741,19486,267183,28638,25002,21128,382493,10422,16136,411131,80691,79282,64666,25479,1413,35424,31484,10061,8648,140712,1990
92,"Spotsylvania + Fredericksburg, VA*",834665,49532,83339,84362,1101638,1374,683,91713,1505668,87465,19263,1507042,358686,280978,124426,78237,6902,88148,125520,40022,33120,620997,1990
93,"Stafford, VA",397543,22254,48027,42366,916532,1653,1492,43437,1214886,35041,19434,1216539,562426,242723,57284,62600,4373,36533,69210,18449,14076,291800,1990
94,"Suffolk (Independent City), VA",423278,23350,46422,43962,589848,16505,12290,45331,857423,23338,16736,873928,211901,164444,119636,52220,3166,35628,68403,20472,17306,319247,1990
95,"Surry, VA",118525,6383,12680,12576,62795,7163,5648,12671,89409,2697,15652,96572,-43059,20685,13092,6170,414,8345,18968,3176,2762,91212,1990
96,"Sussex, VA",74630,4323,7365,6550,96636,13085,10655,7598,144753,4226,15390,157838,29604,31680,29522,10256,673,14881,10640,3818,3145,49109,1990
97,"Tazewell, VA",379117,23665,42428,39630,381432,4748,3742,43480,642857,31147,14080,647605,45795,120469,145704,45996,3140,34889,62243,18839,15699,281985,1990
98,Virginia,95102916,5221484,10962579,10190726,89982217,678077,507444,10316847,128880119,5148059,20840,129558196,5196148,28313411,11262568,6216884,500844,5655503,16057942,3699593,3198749,73389471,1990
99,"Virginia Beach (Independent City), VA",3878758,204546,485078,424494,6208758,9260,7711,416793,8591266,237621,21744,8600526,2746793,1948873,442895,395542,26942,245332,697325,185304,158362,2936101,1990
100,"Warren, VA",180381,11244,19428,17646,305354,1177,801,20067,434917,22281,16573,436094,145040,83811,46929,26313,2356,23082,28251,10075,7719,129048,1990
101,"Washington + Bristol, VA*",745728,43501,87192,76766,615712,14630,11043,81884,949041,44896,14958,963671,-48132,192313,155646,64423,7088,55939,125575,38194,31106,564214,1990
102,"Westmoreland, VA",74444,4923,7947,6406,133566,5470,2788,8126,230369,12107,15140,235839,67248,61506,40767,15577,1343,14895,11150,4863,3520,48399,1990
103,"Wise + Norton, VA*",516487,31159,58609,60734,375449,155,74,61526,635080,32553,14505,635235,-79512,101435,158351,43793,2565,32627,88976,20542,17977,394884,1990
104,"Wythe, VA",226664,13488,25947,22292,236737,10662,8493,24634,361665,18716,14590,372327,34707,68606,66984,25520,2578,27209,37093,12787,10209,162362,1990
105,"York + Poquoson, VA*",467996,25011,64570,46860,820109,1553,752,48441,1193582,40904,22258,1195135,400554,309127,65899,53694,3903,41656,88000,20638,16735,338340,1990
0,"Accomack, VA",322193,18314,41365,31006,275860,17316,8506,33817,469243,30283,14962,486559,-12516,119210,91489,32520,2707,38789,56868,16749,14042,226536,1991
1,"Albemarle + Charlottesville, VA*",2051672,120956,235184,206134,1563533,7577,4799,224023,2493447,211453,22666,2501024,-264116,729912,207579,110343,11194,216252,338251,80236,69042,1497169,1991
2,"Alexandria (Independent City), VA",3737394,201545,408318,395730,2568408,0,0,399410,3699758,183349,32549,3699758,-769576,905021,226329,113667,11225,183349,606183,107290,96065,2947862,1991
3,"Alleghany + Covington, VA*",308813,19635,33352,41796,237683,175,52,40533,388818,15401,15709,388993,-30597,67991,83319,24762,1413,15453,54250,11834,10421,239110,1991
4,"Amelia, VA",59071,3402,5370,4640,98584,8935,7260,5722,132086,10562,15648,141021,45235,23144,19293,9012,908,17822,7690,3162,2254,33559,1991
5,"Amherst, VA",237726,14686,29861,23968,281177,1372,919,26670,410945,20284,14236,412317,70121,72041,59099,28962,2270,21203,41845,11979,9709,174678,1991
6,"Appomattox, VA",98751,6240,11592,9844,123440,606,30,11162,185283,11588,14800,185889,35851,34054,28395,12560,1271,11618,16514,5734,4463,70619,1991
7,"Arlington, VA",7860863,381418,1029258,855588,3946222,0,0,809212,5677898,248582,32863,5677898,-3105429,1460433,271243,172773,16635,248582,1457052,189797,173162,6155229,1991
8,"Augusta, Staunton + Waynesboro, VA*",1236579,73818,144479,126358,1136891,32486,26695,136997,1703797,94253,17519,1736283,37309,368895,230497,99110,9357,120948,207658,53191,43834,907973,1991
9,"Bath, VA",61394,3784,6223,6610,47978,666,477,7089,83430,3752,17571,84096,-6327,21473,14645,4786,444,4229,9528,2870,2426,47637,1991
10,"Bedford, VA*",322733,21111,36040,32712,658117,2766,1331,37467,968152,37996,18092,970918,372851,195515,117286,53666,5051,39327,52396,18058,13007,231010,1991
11,"Bland, VA",51529,3217,6566,5100,56164,943,456,5767,84890,5879,13219,85833,10402,13362,16307,6493,943,6335,9116,2941,1998,36078,1991
12,"Botetourt, VA",130503,8549,13876,12662,296655,2714,1214,14880,422976,18592,16619,425690,181032,79093,49942,25615,2343,19806,20207,7383,5040,90490,1991
13,"Brunswick, VA",111171,6540,13021,10266,122052,10578,8655,11673,193299,9016,12690,203877,22554,38057,43768,16066,1010,17671,18154,5784,4774,75346,1991
14,"Buchanan, VA",402486,24395,46550,43476,277533,303,275,46133,456492,42286,14538,456795,-78820,75869,103393,31420,1690,42561,68288,13372,11682,291637,1991
15,"Buckingham, VA",78511,4907,8938,7120,105637,5079,4645,8467,163744,11332,12893,168823,35593,33010,30176,13094,1031,15977,12498,3995,2964,50036,1991
16,"Campbell + Lynchburg, VA*",1920867,113445,214291,213000,1284895,6129,4781,219945,2032185,99520,17914,2038314,-416027,414252,339167,113783,8395,104301,320791,78467,70072,1495775,1991
17,"Caroline, VA",113318,7121,13950,10590,201924,561,21,12416,302837,16688,15338,303398,101022,57459,44015,19781,1382,16709,19245,5609,4227,77364,1991
18,"Carroll + Galax, VA*",318995,19746,37799,32560,284711,8099,6885,36026,461930,28274,13964,470029,1742,78061,107257,33660,3256,35159,54079,18254,14998,229757,1991
19,"Charles City, VA",23597,1685,2684,2044,69337,436,-110,2707,99592,5630,15997,100028,48447,17961,12730,6253,443,5520,3706,1381,938,14371,1991
20,"Charlotte, VA",73485,4951,7887,6484,89095,6331,4762,8193,148780,11238,13105,155111,23803,32734,33282,11836,1431,16000,11129,4566,3135,46356,1991
21,"Chesapeake (Independent City), VA",1427136,83078,167718,158372,2335965,8790,4494,162264,3129075,72375,19844,3137865,1071093,530546,271354,158127,9338,76869,246904,64678,55340,1103363,1991
22,"Chesterfield, VA",2567110,144749,297727,272670,3868774,3969,2922,281084,4908823,162606,22468,4912792,1582748,781835,262183,218656,16718,165528,434062,99942,83224,1967520,1991
23,"Clarke, VA",102823,6057,9591,9286,131796,7503,4290,10700,208077,14311,18066,215580,39673,62053,21731,11933,1599,18601,14234,5277,3678,69988,1991
24,"Craig, VA",15001,1092,1813,1428,43046,597,443,1806,63424,2552,14130,64021,29851,11983,8992,4531,466,2995,2527,1115,649,9479,1991
25,"Culpeper, VA",299711,18010,32986,30064,353248,7833,4657,33042,521943,32682,18476,529776,86579,114674,61854,28673,3080,37339,48018,13528,10448,214354,1991
26,"Cumberland, VA",36656,1907,2609,2118,75799,11144,9436,2966,105232,8364,14620,116376,42109,21616,18961,7960,668,17800,3668,1796,1128,15188,1991
27,"Dickenson, VA",137342,9032,14647,12260,133272,444,414,15162,230065,30008,13022,230509,11092,34966,62271,17702,1026,30422,20777,5057,4031,86143,1991
28,"Dinwiddie, Colonial Heights + Petersburg, VA*",747591,45971,92200,78230,863640,8671,7138,85086,1414294,50213,18753,1422965,201135,297186,262139,75881,4290,57351,131315,35686,31396,558925,1991
29,"Essex, VA",83690,5328,9526,8600,77437,-239,-938,9628,140197,8761,15791,139958,3375,35929,26592,8863,835,7823,13826,4876,4041,62041,1991
30,"Fairfax, Fairfax City + Falls Church, VA*",17930783,1006586,1688701,1916316,20992961,1146,127,1964744,28181671,1171146,32535,28182817,5026922,6269183,920673,866244,90093,1171273,2646859,543015,452922,14112651,1991
31,"Fauquier, VA",465380,26366,53263,44668,821774,8203,2635,48700,1231987,58208,25099,1240190,405094,342539,75877,49411,6036,60843,75597,22119,16083,328940,1991
32,"Floyd, VA",64346,4069,5957,5028,106400,7846,6425,6583,157989,13566,13647,165835,48637,32048,27387,12152,1838,19991,8471,4230,2392,35884,1991
33,"Fluvanna, VA",63195,4288,6877,5720,142127,907,501,7148,223724,9812,17019,224631,86080,53536,28968,13199,1293,10313,9737,3710,2417,43145,1991
34,"Franklin, VA",262410,15845,28787,25764,415572,13014,9140,28727,594273,25132,14929,607287,181889,111432,80283,40679,3117,34272,41669,14718,11601,186469,1991
35,"Frederick + Winchester, VA*",1000195,59858,106419,105524,867296,10322,5857,112620,1239703,79454,17902,1250025,-20279,255202,127527,69827,7224,85311,159181,43361,36137,755703,1991
36,"Giles, VA",176558,10681,23953,19162,158267,1683,1510,20262,249652,10186,15389,251335,1971,44366,48702,16332,1379,11696,33534,7356,5977,131328,1991
37,"Gloucester, VA",165395,10734,19284,15668,380133,929,467,18568,561648,22939,18376,562577,233306,126106,56338,30615,2670,23406,27118,10035,7365,114871,1991
38,"Goochland, VA",100939,6407,10545,9728,232888,355,-91,11271,347347,15844,23996,347702,143220,91352,23462,14490,1662,15753,15409,5366,3704,69777,1991
39,"Grayson, VA",85088,5601,8947,7278,133556,5994,5193,9240,207843,15644,13146,213837,57708,39411,40870,16266,2160,20837,12586,5404,3244,51665,1991
40,"Greene, VA",51019,3502,5547,4468,119549,922,444,5736,167937,10986,15483,168859,74266,29674,19636,10906,1079,11430,7781,2913,1834,31808,1991
41,"Greensville + Emporia, VA*",187286,11068,23174,19714,137825,5939,4859,20925,213894,8094,14035,219833,-28536,39278,42730,15663,767,12953,33031,8842,8075,141302,1991
42,"Halifax, VA",331828,20020,37820,34122,318504,15290,11568,37081,494501,23071,14068,509791,23757,92584,98703,36238,3250,34639,54881,17739,14489,242308,1991
43,"Hampton (Independent City), VA",2105236,103500,318671,233862,1682854,0,0,220431,2480389,52297,18141,2480389,-201951,534003,263532,136726,6595,52297,435602,76087,69492,1617337,1991
44,"Hanover, VA",807668,48491,81337,84134,1012116,5006,2775,90558,1375398,77078,21066,1380404,295006,246876,121412,65528,6480,79853,123404,35026,28546,604411,1991
45,"Henrico, VA",3773154,220134,371675,421344,3774498,2209,1308,430806,5392071,163990,24174,5394280,432150,1198261,421521,223141,16258,165298,582347,142996,126738,3025509,1991
46,"Henry + Martinsville, VA*",998189,59576,118348,111536,772790,1197,905,115344,1243765,45702,17011,1244962,-110055,271979,200193,73184,5091,46607,174116,46856,41765,777466,1991
47,"Highland, VA",18659,1046,1549,1136,24287,4445,4163,1614,38728,3952,16656,43173,7242,12654,6232,2592,623,8115,2117,1282,659,8427,1991
48,"Isle of Wight, VA",339759,19437,37641,35242,335295,9789,7177,37058,460752,15948,18366,470541,32594,78336,56910,25620,1833,23125,55262,12010,10177,261372,1991
49,"James City + Williamsburg, VA*",830894,48652,90405,89984,681967,604,217,93644,1038744,43845,21647,1039348,-55283,252993,104388,48013,4145,44062,135397,37621,33476,651435,1991
50,"King George, VA",324800,14039,51490,32494,194035,934,455,30286,280340,10679,20298,281274,-100479,67543,19696,13857,1129,11134,67737,9499,8370,245929,1991
51,"King William, VA",125137,7719,13079,13570,145401,909,90,14504,213297,8089,19153,214206,34768,43333,25472,11184,936,8179,19864,4899,3963,97094,1991
52,"King and Queen, VA",28382,2069,3822,2580,65350,556,42,3359,98681,5580,15722,99237,40327,18903,14984,6312,485,5622,5112,1545,1060,17648,1991
53,"Lancaster, VA",105573,7255,10585,10288,89732,-35,-180,12399,238367,13563,21756,238332,-3442,106589,42011,10955,1305,13383,15729,5809,4504,76461,1991
54,"Lee, VA",120728,8328,14801,11366,157318,3908,3096,14011,290932,15834,12133,294840,50601,48232,89290,24301,2607,18930,20484,7926,5319,81314,1991
55,"Loudoun, VA",1395789,77864,149532,147032,1793790,9396,4673,151380,2378227,90293,26493,2387623,549381,495582,98251,90124,10660,94966,223048,53163,42503,1077775,1991
56,"Louisa, VA",192857,11938,21439,19390,224189,1737,1063,21633,332045,21305,15944,333782,52965,60036,49557,20934,2289,22368,31134,8194,5905,139355,1991
57,"Lunenburg, VA",67337,4140,7961,6350,88909,5875,4375,7315,146562,7120,13086,152437,28887,32707,30821,11649,994,11495,11136,4154,3160,44706,1991
58,"Madison, VA",58411,3710,5547,4484,100680,5507,3853,5952,162526,13470,13880,168033,48221,43574,23779,12106,1525,17323,7789,3900,2375,33299,1991
59,"Mathews, VA",35936,2786,3687,2944,83762,992,438,4258,157781,8888,18947,158773,52084,49336,25675,8380,896,9326,5159,2471,1575,21451,1991
60,"Mecklenburg, VA",302428,18085,34342,31222,266376,14081,10011,33696,433882,21048,15174,447963,-2356,97138,84449,29521,2518,31059,49953,16978,14460,221416,1991
61,"Middlesex, VA",56950,4037,6575,5104,82745,239,-134,6589,156858,11253,17727,157097,32384,46292,28060,8862,1089,11119,9127,3556,2467,36704,1991
62,"Montgomery + Radford, VA*",1088664,61838,152330,116976,858788,3366,1930,120326,1273320,42478,14023,1276686,-109550,270030,147868,91041,6286,44408,210818,48157,41871,833438,1991
63,"Nelson, VA",70112,4859,7120,6602,110538,1996,1017,8160,186301,10802,14465,188297,48586,41707,36052,13017,1457,11819,10421,4466,3009,47872,1991
64,"New Kent, VA",51754,3522,5242,4620,147484,-10,-202,5832,202980,10726,18762,202970,101562,35701,19785,10818,999,10524,7552,2864,1865,33678,1991
65,"Newport News (Independent City), VA",3031684,162286,435099,334130,2162078,0,0,329351,3114725,94114,17976,3114725,-540255,610006,342641,173267,8773,94114,602164,108315,99542,2335406,1991
66,"Norfolk (Independent City), VA",7358305,359190,1127280,879262,2687325,0,0,798821,4511659,134368,17668,4511659,-3872159,1245252,579082,255351,10827,134368,1566911,248341,237514,5657026,1991
67,"Northampton, VA",105090,6632,11737,9744,96921,9890,6025,11504,181228,11140,14584,191118,3335,51773,42424,13105,1077,17165,16609,5644,4567,71316,1991
68,"Northumberland, VA",70084,5095,6792,5496,84887,990,597,7843,187036,20196,17416,188026,22646,67911,35228,10796,1246,20793,9540,3565,2319,39751,1991
69,"Nottoway, VA",161590,9560,21473,21028,127695,6124,4617,20074,222842,8283,15106,228966,-13821,50677,50594,15157,1166,12900,31987,7547,6381,116703,1991
70,"Orange, VA",187223,11785,19733,18628,222611,6668,4123,21099,369494,20201,17066,376162,56487,95087,58464,22042,2315,24324,29047,9842,7527,133852,1991
71,"Page, VA",154345,9135,15931,14752,194462,15333,14194,16511,292469,16255,13998,307802,56628,62250,51090,21989,2052,30449,23307,8314,6262,100589,1991
72,"Patrick, VA",120497,7433,13498,12028,166958,5686,4509,13447,244948,12032,14220,250634,59908,39564,44112,17625,1826,16541,19512,7278,5452,84444,1991
73,"Pittsylvania + Danville, VA*",1120944,69923,125317,120082,1069283,23147,17141,129964,1640863,79917,15203,1664010,78303,302325,292402,109455,7720,97058,185358,51298,43578,838528,1991
74,"Portsmouth (Independent City), VA",1675810,79472,271244,175952,1075975,0,0,167448,1716635,41351,16536,1716635,-432387,365375,275285,103810,4083,41351,359220,57027,52944,1275239,1991
75,"Powhatan, VA",97545,5909,12424,9480,194062,2497,1548,10649,262000,10151,16510,264497,107166,46362,24073,16020,1234,11699,17164,4828,3594,68682,1991
76,"Prince Edward, VA",184030,11563,20764,18892,131537,3817,2692,21009,224298,16130,12927,228115,-31484,50823,45755,17647,1210,18822,30210,9675,8465,134998,1991
77,"Prince George + Hopewell, VA*",840857,42210,129062,93214,616453,1226,668,88817,878486,26312,17412,879712,-135587,169275,93984,50522,2265,26980,175669,27060,24795,638208,1991
78,"Prince William, Manassas + Manassas Park, VA*",2521278,141523,290486,273550,4538126,279,-411,278298,5733519,156852,22258,5733798,2295146,967929,227743,257608,19123,156441,427261,101169,82046,1937576,1991
79,"Pulaski, VA",323031,19310,42442,34362,312960,5292,3951,36491,481658,20376,14153,486950,26420,81439,92551,34407,2085,24327,59623,15516,13431,239081,1991
80,"Rappahannock, VA",35418,2424,3061,2808,72479,1376,589,3828,125840,9323,19249,127216,40889,40764,13973,6609,1188,9912,4465,2691,1503,21041,1991
81,"Richmond (Independent City), VA",6629316,375809,814637,715458,2719811,0,0,733538,4640985,335240,22945,4640985,-3175967,1223996,697178,202265,14386,335240,1172366,206134,191748,5121710,1991
82,"Richmond, VA",71606,4383,8059,7412,61757,2479,1566,8089,109500,4895,15460,111979,-1760,28325,21897,7243,591,6461,11765,3308,2717,53380,1991
83,"Roanoke (Independent City), VA",2146433,129449,230498,266956,1031194,0,0,262927,1776905,104642,18191,1776905,-852312,406543,339168,97682,5799,104642,363976,83928,78129,1677815,1991
84,"Roanoke + Salem, VA*",1476829,86963,157097,158320,1618440,5951,4620,166123,2281394,156895,21910,2287345,307734,464248,204657,104399,8795,161515,236257,57473,48678,1079057,1991
85,"Rockbridge, Buena Vista + Lexington, VA*",305974,18721,34368,31856,286282,5311,4158,34649,478802,22879,15081,484113,14957,120134,77697,32100,2813,27037,50296,15661,12848,228641,1991
86,"Rockingham + Harrisonburg, VA*",1230433,68782,136369,123194,1039620,72121,57892,130379,1443565,94785,16670,1515686,-60434,304149,171917,90921,9417,152677,197966,54601,45184,879790,1991
87,"Russell, VA",192150,12016,22207,20168,224418,8183,7262,22100,362205,18464,12812,370388,54368,56681,89289,28910,2809,25726,32291,10135,7326,134133,1991
88,"Scott, VA",107411,7330,12882,10528,185774,5521,4765,12594,304801,9619,13386,310322,90957,54615,69933,23182,2783,14384,18146,7348,4565,74881,1991
89,"Shenandoah, VA",331011,19810,35157,32644,332058,15989,12610,36132,509497,34533,16363,525486,37179,119318,74110,32115,3976,47143,51479,17318,13342,232389,1991
90,"Smyth, VA",371660,22166,47411,38116,314783,8009,6938,41224,472443,32349,14740,480452,-15653,78831,86838,32596,3161,39287,66469,17987,14826,265904,1991
91,"Southampton + Franklin, VA*",206889,11747,22649,19438,274578,25699,22041,21466,402210,11139,16869,427909,89155,82837,70494,25367,1400,33180,32368,9823,8423,141341,1991
92,"Spotsylvania + Fredericksburg, VA*",834832,50218,86949,86988,1119255,1318,700,93712,1545561,82436,19189,1546879,378135,287181,140443,80612,6960,83136,130443,39548,32588,621253,1991
93,"Stafford, VA",412113,23397,50684,44166,989157,1092,977,45480,1306853,38788,19799,1307945,622524,254779,64009,66060,4431,39765,72767,18445,14014,299581,1991
94,"Suffolk (Independent City), VA",449363,25351,50926,47782,615946,12746,8600,49242,905072,23732,17528,917818,215825,170177,131695,52363,3138,32332,74817,20345,17207,342214,1991
95,"Surry, VA",118487,6568,13374,12886,63810,5498,3842,13011,94651,2589,15978,100149,-41666,21380,14959,6268,426,6431,19817,3125,2699,92239,1991
96,"Sussex, VA",72798,4502,7574,6584,96207,10891,8183,7794,151135,4959,15749,162026,31203,31689,34130,10288,663,13142,10866,3633,2970,48790,1991
97,"Tazewell, VA",395624,25261,45561,41554,394985,3360,2375,46038,674303,36830,14605,677663,45399,121485,161193,46399,3232,39205,66338,18893,15661,290081,1991
98,Virginia,98530957,5489507,11624642,10637236,93351634,613075,445588,10808125,134428414,5862839,21431,135041489,5628802,29248011,12441844,6301217,512323,6308427,16943260,3641765,3129442,75279270,1991
99,"Virginia Beach (Independent City), VA",4146661,222552,517521,451888,6480653,7208,5705,448496,8989970,317071,22412,8997178,2782488,2007164,509361,401448,27970,322776,743465,186206,158236,3080420,1991
100,"Warren, VA",194521,12322,20793,19350,315185,898,512,21997,457522,25111,16942,458420,142661,88713,54522,27058,2552,25623,30468,10063,7511,138430,1991
101,"Washington + Bristol, VA*",788153,46721,94836,80836,645591,15271,11846,87139,1001161,53420,15675,1016432,-55423,202539,168302,64844,7166,65266,135254,38221,31055,587633,1991
102,"Westmoreland, VA",75086,5127,8533,6678,138468,4724,2064,8466,242361,11957,15508,247085,71848,62318,46299,15933,1349,14021,11872,4880,3531,49193,1991
103,"Wise + Norton, VA*",539538,33125,61175,61292,393554,276,193,63771,673678,46450,15304,673954,-82213,107832,172568,44038,2612,46643,91821,20375,17763,401074,1991
104,"Wythe, VA",236874,14312,28658,23994,239852,9779,7665,26309,372649,16672,14835,382428,29287,69695,72881,25779,2513,24337,40655,12877,10364,171882,1991
105,"York + Poquoson, VA*",487914,26686,68508,49604,887815,1391,615,51488,1288664,44531,23218,1290055,451389,329719,72521,55562,4004,45146,93310,20454,16450,349458,1991
0,"Accomack, VA",345548,19134,45484,32614,298871,25746,17124,35441,501218,33622,15865,526964,-11236,124428,103665,33215,2771,50746,61791,16877,14106,233011,1992
1,"Albemarle + Charlottesville, VA*",2170229,126764,269882,219144,1642031,7157,4695,236336,2664473,210007,23917,2671630,-291862,792468,237131,111705,10955,214702,379454,80616,69661,1576073,1992
2,"Alexandria (Independent City), VA",3848613,206302,432731,409506,2742445,0,0,411055,3919832,202667,34064,3919832,-695113,929727,247660,115074,11033,202667,637484,103728,92695,3008462,1992
3,"Alleghany + Covington, VA*",324683,20489,37639,41974,251144,295,172,41476,407522,16645,16614,407817,-32063,66736,89937,24547,1415,16817,58626,11836,10421,249240,1992
4,"Amelia, VA",60359,3527,6002,4774,106197,8479,6914,5914,144081,11194,16392,152560,51752,24362,22001,9307,964,18108,8389,3139,2175,33862,1992
5,"Amherst, VA",245107,15049,33957,24592,298897,1754,1319,27345,434506,19499,14896,436260,81135,71608,65755,29287,2269,20818,46253,12071,9802,178036,1992
6,"Appomattox, VA",103016,6472,13398,10258,131109,88,-489,11601,198520,11557,15746,198608,39694,35425,32074,12613,1226,11068,18527,5764,4538,73421,1992
7,"Arlington, VA",8665370,418367,1128313,956058,4228786,0,0,896396,6052240,279797,34512,6052240,-3540188,1519134,304320,175365,16037,279797,1606342,192541,176504,6779231,1992
8,"Augusta, Staunton + Waynesboro, VA*",1296595,76677,161627,131006,1198458,35051,29681,142180,1793781,100798,18276,1828832,44043,369954,260420,100067,9115,130479,227130,52582,43467,938986,1992
9,"Bath, VA",66807,4056,7378,7124,53002,901,735,7618,91624,3798,19280,92525,-6187,22443,17080,4799,416,4533,10940,2961,2545,51334,1992
10,"Bedford, VA*",346294,22460,40733,34394,709294,4434,3141,39657,1043040,41200,18895,1047474,402657,203739,134441,55438,5119,44341,57930,18322,13203,244023,1992
11,"Bland, VA",58381,3595,7749,5880,60332,1230,761,6535,91011,5774,13951,92241,8486,13189,18720,6612,941,6535,10689,3028,2087,41157,1992
12,"Botetourt, VA",140666,9166,16355,13442,325941,2954,1548,15887,460846,20614,17908,463800,201162,81982,55877,25899,2429,22162,23076,7614,5185,95428,1992
13,"Brunswick, VA",113695,6771,15192,10798,126287,8536,6707,12170,203598,8066,13068,212134,24762,37166,48681,16233,1016,14773,20591,5939,4923,78331,1992
14,"Buchanan, VA",392221,23601,48912,42426,272144,529,511,44814,466752,34252,14971,467281,-75263,76877,118260,31212,1723,34763,70125,12938,11215,287333,1992
15,"Buckingham, VA",82182,5150,10152,7362,111330,5156,4794,8831,174772,12339,13659,179928,37979,33526,35072,13173,1020,17133,13833,3971,2951,51216,1992
16,"Campbell + Lynchburg, VA*",2022224,117934,244078,220394,1347713,6086,4801,228131,2139210,106618,18566,2145296,-446380,421672,375911,115550,8294,111419,354275,78247,69953,1556530,1992
17,"Caroline, VA",117648,7244,15985,10910,213850,2120,1586,12699,319222,15724,16056,321342,108901,58348,49144,20014,1414,17310,21440,5760,4346,78898,1992
18,"Carroll + Galax, VA*",341912,21058,43941,34774,309200,9057,7923,38445,503686,28163,15091,512743,5733,81705,121838,33976,3254,36086,61328,18671,15417,244498,1992
19,"Charles City, VA",27281,1856,3384,2402,72659,1222,659,3057,105066,5523,16799,106288,48435,19116,14513,6327,440,6182,4585,1434,994,16514,1992
20,"Charlotte, VA",78672,5290,9096,6750,95968,6496,4988,8665,159052,13531,13874,165548,25961,31688,37892,11932,1378,18519,12471,4588,3210,47682,1992
21,"Chesapeake (Independent City), VA",1590592,91871,199752,175378,2557140,9039,4680,179560,3402972,78385,20788,3412011,1146108,547083,307788,164133,9514,83065,287441,68340,58826,1220086,1992
22,"Chesterfield, VA",2744047,152876,339791,291086,4081793,2973,1883,298419,5221489,156583,23229,5224462,1636165,838198,304471,224914,16921,158466,485334,102114,85193,2100247,1992
23,"Clarke, VA",103431,6101,10487,9550,137843,6831,3665,10876,217557,13749,18829,224388,45288,62041,24504,11917,1577,17414,15262,5132,3555,70755,1992
24,"Craig, VA",15769,1146,2036,1480,47106,710,566,1886,68372,2638,15294,69082,33223,11624,10352,4517,437,3204,2776,1100,663,9789,1992
25,"Culpeper, VA",304408,18275,36649,30570,358007,6386,3235,33560,537532,33566,18686,543918,87159,115918,69993,29109,3182,36801,51934,13315,10133,215673,1992
26,"Cumberland, VA",39348,2026,3152,2418,81975,11666,10010,3235,113258,8411,15390,124924,45862,21361,21588,8117,670,18421,4361,1836,1166,16566,1992
27,"Dickenson, VA",135712,8848,16528,13046,131110,278,254,15371,238057,20406,13467,238335,10769,36886,70339,17698,894,20660,23051,5010,4116,92001,1992
28,"Dinwiddie, Colonial Heights + Petersburg, VA*",789595,48703,105313,83192,893717,7743,6264,90299,1485947,46897,19527,1493690,194421,304011,295962,76492,4157,53161,146909,36205,32048,589525,1992
29,"Essex, VA",92408,5659,10895,9202,85917,2523,1839,10260,150532,9059,16851,153055,3769,37730,29408,9083,883,10898,15496,5042,4159,66014,1992
30,"Fairfax, Fairfax City + Falls Church, VA*",19197865,1065729,1880793,2036798,22514949,567,-188,2084128,30057409,1348264,34018,30057976,5401212,6485316,1057711,883600,85956,1348076,2899192,541762,455806,14950597,1992
31,"Fauquier, VA",478068,27302,57816,46378,859671,4036,-1529,50491,1312139,66599,26181,1316175,432094,371503,85001,50272,6115,65070,81005,22099,15984,331993,1992
32,"Floyd, VA",62197,4018,6060,4852,108848,7517,6064,6444,164432,13452,13851,171949,53095,32307,30794,12414,1905,19516,8486,4092,2187,34195,1992
33,"Fluvanna, VA",70587,4807,8091,6258,156447,866,502,7936,248859,11486,18092,249725,93796,59092,34186,13803,1352,11988,11220,3877,2525,47379,1992
34,"Franklin, VA",289684,17454,33831,28638,459723,14334,10642,31773,652252,25358,16157,666586,201812,116059,90804,41257,3280,36000,48150,15203,11923,205534,1992
35,"Frederick + Winchester, VA*",1082152,63992,126927,113860,925070,7984,3767,120922,1323989,84868,18729,1331973,-36160,260112,146791,71120,7375,88635,183857,44734,37359,809660,1992
36,"Giles, VA",187580,11292,26846,19920,166792,1402,1245,21252,262102,11491,16054,263504,464,43587,53125,16414,1423,12736,36806,7526,6103,138038,1992
37,"Gloucester, VA",181828,11686,22955,17210,403389,1296,874,20291,590303,24309,19041,591599,241852,126211,61999,31070,2584,25183,31560,10406,7822,125085,1992
38,"Goochland, VA",112929,7120,12602,10466,275626,731,300,12353,395081,20276,26677,395812,175050,93881,26305,14837,1741,20576,17835,5648,3907,74518,1992
39,"Grayson, VA",91361,5944,10400,7864,141865,6510,5776,9876,219502,15833,13758,226012,60380,38671,45476,16428,2150,21609,14332,5532,3382,55420,1992
40,"Greene, VA",56006,3804,6687,4956,132705,1055,544,6282,185390,11323,16300,186445,82981,30773,22967,11438,1222,11867,9165,3171,1949,34974,1992
41,"Greensville + Emporia, VA*",198035,11511,26646,20666,144767,7856,6801,21844,224302,7018,13774,232158,-31424,39479,47912,16855,780,13819,36979,8902,8122,147237,1992
42,"Halifax, VA",360057,21588,43519,36882,343863,17384,13615,40029,531570,24366,14975,548954,23835,94232,110859,36658,3160,37981,61960,17966,14806,260116,1992
43,"Hampton (Independent City), VA",2185991,101601,340295,248194,1769773,0,0,225698,2622429,53615,18918,2622429,-190520,557520,295136,138622,6551,53615,464392,75446,68895,1667984,1992
44,"Hanover, VA",880147,52513,94130,89484,1098452,5335,3243,97255,1482750,93895,22109,1488085,315560,251745,137888,67308,6538,97138,138872,35979,29441,644137,1992
45,"Henrico, VA",4084304,236321,430154,447562,4052507,2508,1636,460102,5737202,195074,25243,5739710,428305,1213305,473898,227382,15873,196710,653935,141821,125948,3233659,1992
46,"Henry + Martinsville, VA*",1068039,63536,131727,118302,831097,1197,916,122687,1320928,50148,18059,1322125,-114255,273235,217793,73213,5021,51064,190878,46983,41962,826097,1992
47,"Highland, VA",19219,1118,1724,1162,24991,4123,3855,1699,41175,4495,17376,45298,7471,12916,7391,2607,628,8350,2305,1264,636,8564,1992
48,"Isle of Wight, VA",364683,20773,41874,37896,360118,10503,7877,39721,494525,22335,19390,505028,35156,81599,63311,26046,1754,30212,60822,12203,10449,273649,1992
49,"James City + Williamsburg, VA*",871337,50817,101025,93666,726079,854,514,97650,1117926,47950,22740,1118780,-47608,275961,116740,49199,4101,48464,147858,38301,34200,675015,1992
50,"King George, VA",330430,14576,53282,33754,204404,1698,1194,31453,299500,13318,21360,301198,-94573,74474,22320,14101,1220,14512,70159,9675,8455,245759,1992
51,"King William, VA",139401,8364,15415,14790,158707,2838,2019,15759,227440,7992,19900,230278,35065,43355,28216,11572,953,10011,22810,4946,3993,106580,1992
52,"King and Queen, VA",31864,1996,4261,2780,69752,3120,2603,3386,103292,5229,16792,106412,41274,20167,16493,6337,536,7832,5651,1627,1091,18381,1992
53,"Lancaster, VA",101340,7030,10760,9510,89976,738,605,11785,250454,14359,22825,251192,421,112494,48722,11005,1267,14964,15515,5541,4274,70861,1992
54,"Lee, VA",124654,8470,16511,11798,162858,5839,5049,14369,304375,13303,12774,310214,52573,46894,100462,24285,2728,18352,22410,7967,5239,83892,1992
55,"Loudoun, VA",1499095,82688,173512,157668,2018058,6953,2315,161522,2651743,90775,28193,2658696,680485,527236,113402,94304,9524,93090,252346,52980,43456,1153659,1992
56,"Louisa, VA",206095,12683,24588,20254,245077,1467,819,22810,363984,24554,17014,365451,61792,61616,58758,21479,3424,25373,34715,9407,5983,146007,1992
57,"Lunenburg, VA",68393,4305,8987,6550,92280,4343,2865,7580,156158,7295,13684,160501,31467,33255,34966,11729,989,10160,12262,4194,3205,45971,1992
58,"Madison, VA",61822,3941,6550,4964,105599,4980,3383,6423,175392,13635,15023,180372,50200,46168,28605,12006,1540,17018,9032,3993,2453,35772,1992
59,"Mathews, VA",37583,2938,4061,3018,90974,1051,535,4447,168121,9849,20118,169172,57838,49997,28201,8409,826,10384,5570,2326,1500,21629,1992
60,"Mecklenburg, VA",316437,18934,38898,32976,279654,12617,8636,35422,458204,20853,15781,470821,-1361,96201,94966,29835,2493,29489,55386,16997,14504,231562,1992
61,"Middlesex, VA",60744,4228,7513,5446,88075,940,651,6951,166664,11012,18729,167604,34282,48501,31028,8949,1055,11663,10236,3497,2442,38845,1992
62,"Montgomery + Radford, VA*",1146166,65171,171915,121894,906407,3249,1910,126118,1341318,49482,14637,1344567,-113641,274498,163662,91861,6168,51392,232862,47580,41412,861912,1992
63,"Nelson, VA",72566,5112,8081,6688,120882,1163,196,8456,209044,12716,16126,210207,56772,46402,42923,13035,1428,12912,11425,4535,3107,48229,1992
64,"New Kent, VA",53730,3634,5721,4564,158151,896,710,5916,216544,12005,19765,217440,110337,37947,21342,11001,987,12715,8003,2773,1786,33012,1992
65,"Newport News (Independent City), VA",3214301,170419,469367,358378,2244982,0,0,349608,3274460,91938,18342,3274460,-619711,646677,382801,178526,8301,91938,648556,108959,100658,2473807,1992
66,"Norfolk (Independent City), VA",7700557,370905,1179728,945180,2775489,0,0,843495,4693078,160267,18178,4693078,-4081573,1274467,643122,258174,9994,160267,1652318,246217,236223,5887972,1992
67,"Northampton, VA",106325,6658,12426,9924,98314,11191,7298,11620,184133,10949,14930,195324,3609,50845,46165,13083,1098,18247,17388,5472,4374,70690,1992
68,"Northumberland, VA",102645,7286,8526,6494,114389,2319,1942,10533,222993,42331,20399,225312,22277,71125,39798,11045,1212,44273,11773,3814,2602,46599,1992
69,"Nottoway, VA",167502,9810,24252,20604,134305,6728,5277,20112,234489,8710,15856,241217,-13085,50132,56780,15213,1228,13987,34554,7645,6417,118961,1992
70,"Orange, VA",192412,12245,21905,19216,233594,4867,2358,21853,392227,21684,17746,397094,63035,97276,66224,22377,2332,24042,31513,9719,7387,136857,1992
71,"Page, VA",169553,9832,18718,15972,211874,18136,17108,17818,316228,16615,15030,334364,60139,64101,58389,22247,1997,33723,26704,8608,6611,109126,1992
72,"Patrick, VA",125157,7761,15066,12528,175285,4811,3670,14025,257173,12833,14760,261984,64153,38568,48131,17750,1788,16503,21330,7169,5381,87324,1992
73,"Pittsylvania + Danville, VA*",1209409,74357,142883,129122,1148807,25451,19611,138918,1744668,79988,16147,1770119,78316,302644,318668,109627,7650,99599,207444,51810,44160,902366,1992
74,"Portsmouth (Independent City), VA",1744927,82711,289906,186228,1120180,0,0,175825,1795172,49886,17155,1795172,-448922,369076,305916,104642,3875,49886,383020,56320,52445,1312021,1992
75,"Powhatan, VA",107642,6592,14803,10284,215860,1633,940,11734,290944,13241,17579,292577,119952,49188,27529,16644,1380,14181,19945,5126,3746,73516,1992
76,"Prince Edward, VA",196218,12240,24046,20224,138260,3338,2307,22352,240188,16127,13584,243526,-35606,52590,52676,17928,1131,18434,34158,9816,8685,143626,1992
77,"Prince George + Hopewell, VA*",896230,44721,138722,102838,656586,1896,1387,96140,942023,27077,18025,943919,-143504,179519,107814,52366,2164,28464,190141,27465,25301,677625,1992
78,"Prince William, Manassas + Manassas Park, VA*",2689460,149737,324987,291632,4809652,1191,593,295553,6092507,174408,22955,6093698,2415745,1019320,264726,265466,18723,175001,470803,102878,84155,2043656,1992
79,"Pulaski, VA",345858,20454,50097,36900,333472,3901,2742,38904,514809,20270,15036,518710,26518,82673,102565,34499,2076,23012,68547,15870,13794,254299,1992
80,"Rappahannock, VA",38519,2641,3473,3060,74452,1257,593,4171,130085,10324,19879,131342,40104,40971,15919,6607,1214,10917,5003,2724,1510,22599,1992
81,"Richmond (Independent City), VA",6853470,384976,891011,738004,2774993,0,0,753978,4815278,333106,23783,4815278,-3324499,1268300,771985,202468,13326,333106,1260013,203067,189741,5260351,1992
82,"Richmond, VA",74658,4512,8768,7648,64155,3406,2469,8336,115172,5065,16148,118578,-2167,29859,24564,7343,581,7534,12592,3280,2699,54532,1992
83,"Roanoke (Independent City), VA",2287424,136325,262272,277888,1084504,0,0,275269,1825461,105823,18711,1825461,-927651,370429,370528,97561,5478,105823,401216,84450,78972,1780385,1992
84,"Roanoke + Salem, VA*",1575994,92025,180582,166208,1717990,3998,2714,175129,2421706,165187,23164,2425704,317125,481288,226426,104717,8901,167901,263686,58034,49133,1144407,1992
85,"Rockbridge, Buena Vista + Lexington, VA*",315296,19365,38318,32834,295124,2568,1487,35782,503283,23355,15622,505851,15610,122568,88159,32381,2907,24842,54735,15508,12601,235719,1992
86,"Rockingham + Harrisonburg, VA*",1357912,74594,158855,134286,1142216,90527,77119,141737,1551723,100102,17642,1642250,-73959,308897,191137,93087,9532,177221,225998,56747,47215,954693,1992
87,"Russell, VA",206758,12867,25255,21496,237783,8608,7765,23615,383303,19497,13482,391911,54640,54522,99606,29069,2893,27262,36003,10434,7541,143493,1992
88,"Scott, VA",114818,7788,14600,11274,199138,6301,5548,13425,322712,9223,14032,329013,97745,52245,77630,23447,2752,14771,20237,7465,4713,79810,1992
89,"Shenandoah, VA",357810,21225,40664,35336,357155,15998,12810,38893,540543,36568,17278,556541,38238,117499,81887,32211,3902,49378,58332,17442,13540,250100,1992
90,"Smyth, VA",396433,23400,55183,40826,333739,6956,6004,43813,504055,31359,15536,511011,-18881,79527,97745,32893,3067,37363,75596,18174,15107,283474,1992
91,"Southampton + Franklin, VA*",218446,12638,25862,20954,287868,23305,19707,23115,427560,11727,17532,450865,92537,80831,82166,25717,1433,31434,36339,10011,8578,150673,1992
92,"Spotsylvania + Fredericksburg, VA*",886727,52630,101177,92234,1204941,1533,994,98747,1672896,81367,20066,1674429,416961,310744,158744,83445,7243,82361,147294,40843,33600,657072,1992
93,"Stafford, VA",449841,25345,57240,48732,1084988,980,904,49711,1433231,42348,20581,1434211,684858,272895,76328,69685,4427,43252,81606,18919,14492,324983,1992
94,"Suffolk (Independent City), VA",468512,26191,57010,48960,640476,15492,11446,50671,943050,26825,18256,958542,222635,173891,144175,52506,3026,38271,81490,20412,17386,348751,1992
95,"Surry, VA",120657,6425,14849,12656,69201,7881,6127,12753,101562,2709,16973,109443,-38703,22703,17539,6448,404,8836,21177,2965,2561,90644,1992
96,"Sussex, VA",80007,4892,8999,7358,100706,11991,9090,8571,158321,5113,16574,170312,29270,31322,38284,10276,636,14203,12678,3642,3006,53126,1992
97,"Tazewell, VA",414719,26250,51835,43646,410194,3551,2621,48073,712209,33481,15410,715760,43548,122698,182868,46448,3261,36102,73658,19363,16102,304959,1992
98,Virginia,104802966,5782177,12881639,11322742,99391051,658695,497587,11443548,143009903,6315499,22398,143668598,6031633,30284087,13993460,6414307,503502,6813086,18543010,3657380,3153878,79446870,1992
99,"Virginia Beach (Independent City), VA",4424124,234687,563676,490936,6841444,7797,6351,480155,9557179,340943,23173,9564976,2897475,2146807,576725,412769,27199,347294,809144,187823,160624,3267686,1992
100,"Warren, VA",194507,12318,22614,19048,329706,1022,639,21842,480837,25514,17329,481859,157041,88568,63585,27806,2391,26153,32138,9754,7363,136216,1992
101,"Washington + Bristol, VA*",835457,48866,108186,84724,689970,20219,17040,91228,1063576,52436,16580,1083795,-54259,203065,190760,65368,7110,69476,150548,38379,31269,615433,1992
102,"Westmoreland, VA",76393,5212,9281,6850,143180,5502,2903,8637,252369,11532,15889,257871,75424,64324,50367,16230,1291,14435,12706,4750,3459,49252,1992
103,"Wise + Norton, VA*",556362,33829,67955,62968,405208,348,267,65313,703173,38942,15970,703521,-85841,102354,195959,44054,2509,39209,99439,20393,17884,417714,1992
104,"Wythe, VA",252190,15194,32810,25476,256216,9436,7422,27932,398064,17956,15700,407500,31958,69409,81875,25955,2612,25378,45548,13126,10514,181264,1992
105,"York + Poquoson, VA*",522534,28791,74984,53644,976803,1167,424,55613,1411197,49059,24583,1412364,509882,353316,82245,57453,4347,49483,101806,21113,16766,371245,1992
0,"Accomack, VA",350026,20077,46992,33800,304848,20387,11779,36977,520738,33030,15959,541125,-8201,127451,108826,33907,2848,44809,63892,16884,14036,241325,1993
1,"Albemarle + Charlottesville, VA*",2320910,134068,293286,232988,1739407,6656,4096,250562,2847268,220966,25133,2853924,-330941,856316,258201,113555,11181,225062,409780,83467,72286,1686068,1993
2,"Alexandria (Independent City), VA",4060682,219350,447402,432386,2836374,0,0,435543,4076996,224806,34956,4076996,-788765,982453,258169,116633,11354,224806,663595,106048,94694,3172281,1993
3,"Alleghany + Covington, VA*",342811,21849,40046,43660,265466,319,160,43679,425230,19701,17287,425549,-33666,68594,91489,24616,1425,19861,61876,12125,10700,261074,1993
4,"Amelia, VA",66774,3949,6487,5100,115084,8913,6946,6499,155343,13829,17050,164256,54809,25222,23950,9634,1025,20775,9037,3269,2244,36962,1993
5,"Amherst, VA",272288,16731,37949,27698,325492,641,172,30580,468603,19769,15863,469244,83784,73844,69908,29581,2283,19941,51798,12733,10450,200549,1993
6,"Appomattox, VA",103446,6597,13662,10138,139620,-274,-826,11666,207139,12933,16223,206865,47840,33434,33811,12751,1313,12107,18731,5660,4347,72608,1993
7,"Arlington, VA",8803225,433123,1105430,976250,4443490,0,0,921248,6369889,304700,35817,6369889,-3438487,1609168,317231,177845,16191,304700,1593555,196494,180303,6904970,1993
8,"Augusta, Staunton + Waynesboro, VA*",1358296,80100,170669,137962,1259232,32461,26749,149081,1879663,110745,18901,1912124,50017,379880,273012,101163,9342,137494,239650,53648,44306,981152,1993
9,"Bath, VA",71951,4397,7983,7816,57878,806,626,8305,99826,3683,20702,100632,-5768,24739,18015,4861,428,4309,11891,3036,2608,55751,1993
10,"Bedford, VA*",376016,24345,44597,37078,772018,1999,682,42884,1130352,48051,19844,1132351,438886,216520,143813,57062,5365,48733,63136,19215,13850,264147,1993
11,"Bland, VA",61494,3844,8166,6242,62466,825,382,6965,94179,6477,14212,95004,7937,13386,19152,6685,932,6859,11287,3010,2078,43348,1993
12,"Botetourt, VA",155583,10252,18251,14710,358513,1556,194,17607,501894,24930,19036,503450,220537,85974,58963,26447,2422,25124,25606,7907,5485,104853,1993
13,"Brunswick, VA",119427,7382,16646,11488,132418,5932,3991,13126,218614,9251,13735,224546,26117,37971,54157,16348,1033,13242,22390,6167,5134,83795,1993
14,"Buchanan, VA",360715,21827,49180,42414,255270,265,248,43034,455757,31644,14826,456022,-62411,77314,123438,30759,1719,31892,70387,12557,10838,258436,1993
15,"Buckingham, VA",89064,5572,11094,7818,118193,5394,4862,9481,185471,13611,14288,190865,38610,35948,36724,13358,1162,18473,15003,4198,3036,55588,1993
16,"Campbell + Lynchburg, VA*",2153518,126536,260976,235988,1425833,2756,1414,244530,2239933,121686,19418,2242689,-483155,440917,375939,115496,8141,123100,378970,79745,71604,1651448,1993
17,"Caroline, VA",121884,7671,16787,11364,231968,803,185,13353,345379,16633,16966,346182,123437,62228,51986,20404,1419,16818,22469,5848,4429,82597,1993
18,"Carroll + Galax, VA*",361807,22615,47677,37004,329077,6776,5653,41117,529120,31653,15577,535896,8387,83859,122960,34404,3380,37306,66179,18826,15446,258322,1993
19,"Charles City, VA",29484,1985,4081,2646,73518,586,-42,3308,108964,5402,16924,109550,47342,20405,15627,6473,461,5360,5404,1518,1057,18720,1993
20,"Charlotte, VA",79570,5549,9500,6792,98905,3547,1902,8945,170485,16424,14459,174032,28280,32752,42375,12036,1453,18326,12896,4611,3158,48348,1993
21,"Chesapeake (Independent City), VA",1757038,101900,220640,191262,2755685,8314,3482,197531,3663342,99002,21444,3671656,1196178,584897,331074,171218,9810,102484,316271,72983,63173,1338283,1993
22,"Chesterfield, VA",2855622,159649,352841,303952,4277973,2721,1556,311625,5492594,167494,23875,5495315,1733976,877143,340199,230170,13779,169050,504817,101618,87839,2181755,1993
23,"Clarke, VA",109073,6587,11321,10112,144241,5156,2194,11643,227391,14789,19440,232547,46811,62958,25348,11962,1550,16983,16377,5214,3664,75713,1993
24,"Craig, VA",16244,1182,2163,1566,50028,552,382,1965,72050,2648,15664,72602,35749,11843,10731,4635,436,3030,2946,1098,662,10268,1993
25,"Culpeper, VA",321990,19565,39375,32486,380959,3452,244,35808,574311,36231,19610,577763,94777,124009,72795,29462,3169,36475,55618,13618,10449,229897,1993
26,"Cumberland, VA",41972,2168,3456,2562,85332,11903,10321,3449,117957,8715,15885,129860,46809,21759,22769,8175,709,19036,4737,1905,1196,18199,1993
27,"Dickenson, VA",139896,9103,18185,15392,133149,292,267,16799,242244,16483,13765,242536,10052,37079,72308,17620,899,16750,25881,5092,4193,97265,1993
28,"Dinwiddie, Colonial Heights + Petersburg, VA*",840153,52171,113630,87990,907776,4788,3176,96166,1522879,50078,19949,1527667,163789,308855,311036,76578,4140,53254,157625,37118,32978,629274,1993
29,"Essex, VA",93566,5966,11659,9568,87742,-297,-1004,10750,159438,9545,17033,159141,4926,39164,32235,9343,837,8541,16443,5000,4163,68582,1993
30,"Fairfax, Fairfax City + Falls Church, VA*",20487525,1138306,1981162,2146800,23651657,916,70,2211706,31776715,1644756,35452,31777631,5375838,7005773,1120201,896359,87530,1644826,3054562,556538,469008,15788137,1993
31,"Fauquier, VA",493177,28622,57864,46742,908690,3718,-1932,51993,1394270,75379,27768,1397988,467506,398748,90550,50345,6358,73447,81235,22337,15979,338495,1993
32,"Floyd, VA",65506,4349,6609,5206,114567,6565,4747,6952,173432,14912,14397,179997,56013,32695,32735,12502,1938,19659,9212,4260,2322,36635,1993
33,"Fluvanna, VA",74000,5150,8730,6644,174177,331,1,8472,277567,12385,19313,277898,108649,64773,38948,14389,1412,12386,12052,4015,2603,49562,1993
34,"Franklin, VA",315319,19365,37477,31456,494420,11701,7890,35093,694821,29235,16836,706522,214194,117061,95041,41965,3145,37125,53205,15515,12370,224989,1993
35,"Frederick + Winchester, VA*",1160432,68786,135806,121314,989618,6289,1832,129443,1413672,100049,19543,1419961,-41371,278775,151568,72657,7324,101881,196463,45929,38605,862088,1993
36,"Giles, VA",199301,12159,28742,21050,175479,1202,1048,22684,271810,15143,16633,273012,-1138,43069,54464,16414,1436,16191,39267,7588,6152,143843,1993
37,"Gloucester, VA",193897,12574,25001,17992,413824,456,37,21570,615050,27963,19249,615506,241497,133910,67772,31976,2713,28000,33997,10794,8081,131900,1993
38,"Goochland, VA",123194,7715,13965,11330,273644,325,-163,13380,413901,21903,27392,414226,163830,112204,28378,15122,1809,21740,19630,5885,4076,81824,1993
39,"Grayson, VA",95926,6430,11372,8470,149706,5026,4196,10665,230411,17394,14232,235437,64445,39409,46322,16543,2222,21590,15607,5655,3433,58729,1993
40,"Greene, VA",64287,4298,8151,5814,147744,450,-9,7205,202129,12963,16587,202579,90662,32365,22470,12213,1207,12954,11058,3460,2253,40275,1993
41,"Greensville + Emporia, VA*",201696,11866,27556,21024,146613,7860,6755,22378,229596,6798,14043,237456,-32705,40498,50345,16909,734,13553,38068,8775,8041,150075,1993
42,"Halifax, VA",372341,23179,46439,39292,354802,8288,4299,42825,556139,27654,15203,564427,25286,93821,115804,37126,3223,31953,66085,18267,15044,274303,1993
43,"Hampton (Independent City), VA",2249345,106498,334893,258366,1808252,0,0,235681,2716741,60521,19193,2716741,-205412,582771,325718,141551,6354,60521,464076,75929,69575,1724748,1993
44,"Hanover, VA",981785,58171,108121,101682,1185630,4607,2194,109012,1594236,90358,23161,1598843,312857,265483,147730,69031,6622,92552,158962,38872,32250,730271,1993
45,"Henrico, VA",4359150,252999,458211,475738,4216032,2886,1962,490868,6049223,215575,26013,6052109,347750,1324430,511647,232655,15476,217537,696080,145604,130128,3445533,1993
46,"Henry + Martinsville, VA*",1086723,65281,135975,120780,854182,1841,1476,125671,1354963,58177,18413,1356804,-106870,277476,225146,73687,4841,59653,196365,46281,41440,830705,1993
47,"Highland, VA",20104,1209,1879,1232,25829,3674,3367,1825,43931,5137,18359,47605,7550,14143,7633,2593,656,8504,2495,1318,662,9105,1993
48,"Isle of Wight, VA",364646,20872,43961,38854,369207,8808,6078,40299,516230,19395,19809,525038,44860,87582,68249,26505,1771,25473,63388,12627,10856,275785,1993
49,"James City + Williamsburg, VA*",913372,53289,106797,97582,750820,351,36,102080,1175585,53856,23365,1175936,-60472,301858,123258,50328,4208,53892,155588,38846,34638,703892,1993
50,"King George, VA",347386,15694,54063,36070,234224,1054,576,33729,332322,15854,22895,333376,-79433,75196,23956,14561,1324,16430,72098,9917,8593,258858,1993
51,"King William, VA",129266,7971,14611,13866,168601,701,-150,14904,242484,8459,20501,243185,54239,44297,30287,11862,914,8309,21544,4777,3863,99413,1993
52,"King and Queen, VA",31882,2068,4294,2876,70841,1497,953,3506,106866,6276,17244,108363,42465,19943,17579,6284,534,7229,5732,1627,1093,18921,1993
53,"Lancaster, VA",103263,7328,11501,10064,90811,8,-144,12360,261010,11713,23551,261018,-92,118538,51669,11083,1270,11569,16533,5609,4339,75161,1993
54,"Lee, VA",134685,9388,18706,13522,171258,3304,2527,16149,321204,13091,13385,324508,52722,46822,106428,24245,2608,15618,25467,8111,5503,93600,1993
55,"Loudoun, VA",1680028,92570,192973,176866,2270945,6325,1859,181003,2953035,99462,29266,2959360,771920,567208,121207,101118,10105,101321,281406,57312,47207,1297301,1993
56,"Louisa, VA",214844,13368,26039,20898,268644,492,-128,23817,393185,28583,17906,393677,77617,64580,60453,21986,3574,28455,36488,9582,6008,149901,1993
57,"Lunenburg, VA",68834,4610,9362,6514,94038,2891,1354,7867,161173,8694,14054,164064,33071,33184,36842,11674,1022,10048,12619,4221,3199,46167,1993
58,"Madison, VA",64461,4240,6922,5212,112090,3552,1962,6846,187266,15293,15741,190818,54475,48748,29980,12122,1599,17255,9528,4065,2466,37678,1993
59,"Mathews, VA",39358,3176,4277,3148,99574,784,156,4750,181296,10644,21321,182080,64966,52966,29540,8540,919,10800,5851,2418,1499,22707,1993
60,"Mecklenburg, VA",336926,20640,41849,35740,295632,9156,4682,38510,487604,23575,16397,496760,-2784,99845,101283,30295,2560,28257,59719,17391,14831,248950,1993
61,"Middlesex, VA",62963,4495,8001,5694,91373,131,-264,7342,178933,11522,19732,179064,35752,54147,33544,9075,963,11258,10848,3458,2495,40857,1993
62,"Montgomery + Radford, VA*",1165943,66541,175506,122620,939811,2976,1648,127851,1396825,59766,15100,1399801,-98281,286305,173685,92701,6200,61414,236816,48055,41855,867713,1993
63,"Nelson, VA",77832,5583,8675,7090,135222,723,-278,9128,226726,14480,17257,227449,66518,48620,43607,13180,1483,14202,12220,4652,3169,51410,1993
64,"New Kent, VA",56083,3862,6231,4844,166806,42,-169,6284,232113,12054,20756,232155,117007,42025,23324,11185,995,11885,8653,2854,1859,35545,1993
65,"Newport News (Independent City), VA",3235656,172919,487753,358232,2264525,0,0,352035,3327560,101304,18698,3327560,-619096,654264,408771,177965,8771,101304,666869,107687,98916,2467483,1993
66,"Norfolk (Independent City), VA",7758958,380288,1137875,962708,2786783,0,0,861642,4798336,188708,18779,4798336,-4110533,1341081,670472,255514,10296,188708,1619229,242997,232701,5951021,1993
67,"Northampton, VA",114502,7116,13585,10484,104741,11476,7276,12358,192375,12031,15553,203851,2597,52380,46730,13107,1149,19307,18827,5623,4474,76368,1993
68,"Northumberland, VA",76873,5599,8729,6570,93355,-89,-494,8884,212563,18338,19008,212474,25366,77010,42109,11178,1234,17844,12014,3801,2567,47015,1993
69,"Nottoway, VA",166527,9967,24359,19732,138079,6685,5280,19833,248144,10195,16585,254829,-8615,54137,62613,15365,1256,15475,34225,7469,6213,116827,1993
70,"Orange, VA",214104,13696,24897,21324,255801,4310,1734,24358,428697,24990,19076,433007,66055,106315,70891,22699,2290,26724,35559,10086,7796,151821,1993
71,"Page, VA",190296,10982,20993,17862,233300,21452,20333,19913,335448,19213,15968,356900,62917,63734,59866,22351,2097,39546,29924,9280,7183,120826,1993
72,"Patrick, VA",137603,8691,17026,14004,186513,3063,1815,15693,271638,15225,15356,274701,64603,38364,49824,17889,1836,17040,24028,7542,5706,96535,1993
73,"Pittsylvania + Danville, VA*",1269273,78124,152093,136868,1205068,17614,11600,146558,1825697,88642,16756,1843311,82353,309105,329138,110008,7490,100242,220527,53171,45681,948504,1993
74,"Portsmouth (Independent City), VA",1747093,85085,282801,190600,1119315,0,0,180385,1852041,39664,17648,1852041,-447393,404586,328140,104941,3921,39664,378101,55121,51200,1329328,1993
75,"Powhatan, VA",116528,7219,15642,10616,241868,956,262,12527,322997,18153,18817,323953,137867,52318,29767,17216,1801,18415,20950,5586,3785,77163,1993
76,"Prince Edward, VA",203176,12646,25716,20722,145375,2767,1769,23007,250980,17450,13827,253747,-34794,53560,54812,18351,1176,19219,36077,9991,8815,147880,1993
77,"Prince George + Hopewell, VA*",904366,46319,135738,104526,674290,-197,-719,98582,972392,30591,18588,972195,-131494,184578,113327,52303,2119,29872,188001,27240,25121,686493,1993
78,"Prince William, Manassas + Manassas Park, VA*",2865566,159886,338658,306962,5033541,348,-403,313367,6416525,213221,23545,6416873,2481342,1096534,286798,272542,19175,212818,492139,108149,88974,2160609,1993
79,"Pulaski, VA",378615,22565,55271,40768,347498,2545,1400,42949,535597,22565,15608,538142,11832,84531,106113,34479,2215,23965,75655,16553,14338,278995,1993
80,"Rappahannock, VA",41589,2852,3671,3134,77487,1598,955,4419,136677,12231,20641,138275,40317,44541,16247,6699,1279,13186,5238,2821,1542,23165,1993
81,"Richmond (Independent City), VA",7019312,394871,911460,761678,2840266,0,0,775710,4978507,323437,24551,4978507,-3403336,1324896,813345,202785,13515,323437,1292299,203217,189702,5403576,1993
82,"Richmond, VA",76746,4752,9778,7892,65434,2355,1371,8698,120192,5590,16511,122547,-2614,29918,27195,7422,638,6961,13724,3519,2881,56061,1993
83,"Roanoke (Independent City), VA",2376851,142716,276036,289634,1119293,0,0,287533,1875817,92364,19132,1875817,-970025,372769,383755,98048,5372,92364,420853,85314,79942,1863634,1993
84,"Roanoke + Salem, VA*",1702764,98923,198524,178172,1815791,3369,2163,188009,2574702,190364,24426,2578071,301036,518548,243732,105548,8931,192527,287610,59916,50985,1222627,1993
85,"Rockbridge, Buena Vista + Lexington, VA*",324313,20223,39115,33580,305176,1516,416,37013,520133,25912,16013,521649,17876,124065,92408,32577,2919,26328,55905,15541,12622,242080,1993
86,"Rockingham + Harrisonburg, VA*",1453145,79887,173947,143708,1215617,92932,79065,151741,1651430,107874,18298,1744362,-85787,326995,201750,95333,9523,186939,245801,58861,49338,1020405,1993
87,"Russell, VA",222447,14155,28086,23762,246495,5488,4601,26036,400734,23378,13825,406222,50084,53022,106705,29383,2854,27979,39967,10792,7938,154501,1993
88,"Scott, VA",116104,8327,15178,11606,197585,3839,3104,14130,325976,9848,13973,329815,95611,50569,81661,23604,2823,12952,20981,7543,4720,82171,1993
89,"Shenandoah, VA",385655,22976,45341,37320,386005,16648,13411,41636,573860,43844,18143,590508,41986,121782,82721,32548,3805,57255,64001,17618,13813,264399,1993
90,"Smyth, VA",410216,24500,59185,42512,344379,4571,3553,45756,524415,34035,16028,528986,-20081,81953,102654,33004,3127,37588,80441,18415,15288,292187,1993
91,"Southampton + Franklin, VA*",216713,13108,26773,20928,288816,18041,14377,23572,440197,12847,17833,458238,95675,85569,83853,25696,1582,27224,37237,10059,8477,152252,1993
92,"Spotsylvania + Fredericksburg, VA*",970232,57403,111028,100252,1296315,640,78,107529,1795522,91789,20560,1796162,433612,328302,171545,87364,7420,91867,161154,42808,35388,717211,1993
93,"Stafford, VA",490335,27887,61126,51682,1181490,687,595,53728,1559824,53602,21620,1560511,744883,298030,80991,72179,4403,54197,86967,20040,15637,349171,1993
94,"Suffolk (Independent City), VA",511481,28912,64219,53704,659205,9304,4813,55764,986404,31409,18693,995708,203488,182425,154078,53267,3082,36222,91071,21518,18436,384188,1993
95,"Surry, VA",117411,6390,15350,12328,69252,5836,4090,12554,105094,2866,17029,110930,-35605,24083,17595,6514,418,6956,21514,2945,2527,88941,1993
96,"Sussex, VA",83509,5454,9727,7920,105645,9720,6888,9414,168509,5278,17497,178229,31550,31720,40864,10186,604,12166,13687,3669,3065,57656,1993
97,"Tazewell, VA",425187,27346,54363,45016,417028,3051,2114,49854,731765,35230,15792,734816,41695,125158,192630,46531,3270,37344,76871,19554,16284,310972,1993
98,Virginia,109727435,6104023,13342244,11845060,104044728,533069,365444,12026553,150440231,7109467,23192,150973300,6343846,32128916,14799656,6509630,507975,7474911,19264774,3730015,3222040,82987750,1993
99,"Virginia Beach (Independent City), VA",4699232,251431,573945,514356,7055896,7394,6001,508609,9966691,418384,23764,9974085,2865273,2296400,621789,419718,27761,424385,831123,192631,164870,3443724,1993
100,"Warren, VA",198834,12806,22819,18964,352396,706,331,22288,511845,29207,18101,512551,175850,95384,64771,28316,2388,29538,32301,9832,7444,136995,1993
101,"Washington + Bristol, VA*",864619,51053,115691,88748,717864,16853,13615,95427,1113214,56841,17082,1130067,-51328,212531,199672,66155,7173,70456,160065,38868,31695,634098,1993
102,"Westmoreland, VA",77734,5567,9681,7078,148058,3471,518,9106,263584,12418,16498,267055,79430,66308,52689,16187,1368,12936,13220,4803,3435,51578,1993
103,"Wise + Norton, VA*",576963,34952,73995,67926,420630,298,214,68915,728936,40279,16618,729234,-87418,102813,205791,43883,2408,40493,107958,20789,18381,428512,1993
104,"Wythe, VA",267546,16546,35262,27092,270673,6702,4788,30092,420055,21248,16306,426757,33219,69753,86331,26171,2672,26036,48808,13654,10982,192702,1993
105,"York + Poquoson, VA*",549356,31122,74956,55466,1035162,961,271,58855,1509645,64974,24910,1510606,544661,383535,91909,60642,4559,65245,102689,21836,17277,381422,1993
0,"Accomack, VA",382995,21998,49370,35760,335446,25234,17330,39878,554370,39308,16767,579604,-7671,130166,113992,34568,2927,56638,67250,16865,13938,259107,1994
1,"Albemarle + Charlottesville, VA*",2430033,141248,306137,242302,1805196,5435,3003,262399,2972342,237040,25851,2977777,-362438,905847,266734,115190,11249,240043,427288,84943,73694,1762702,1994
2,"Alexandria (Independent City), VA",4279836,234256,465764,465518,3044988,0,0,467015,4401787,254264,37713,4401787,-767833,1083574,273225,116717,12241,254264,698523,107665,95424,3327049,1994
3,"Alleghany + Covington, VA*",343985,22141,38762,42378,270178,664,481,43330,434755,21201,17891,435419,-30477,69948,95293,24338,1485,21682,59951,11908,10423,262352,1994
4,"Amelia, VA",71588,4219,6952,5448,125166,10283,8085,6943,167737,13591,18337,178020,60521,27780,25074,9708,1101,21676,9676,3359,2258,40236,1994
5,"Amherst, VA",278713,17302,38355,28016,343427,922,453,31310,493230,19776,16425,494152,96024,77555,73170,30085,2233,20229,52363,12397,10164,206121,1994
6,"Appomattox, VA",111393,7064,14003,10578,154355,1115,622,12353,223678,14579,17565,224793,55315,34755,35683,12798,1391,15201,19292,5699,4308,76900,1994
7,"Arlington, VA",9096218,456870,1138570,1023832,4619972,0,0,968786,6669641,309740,36938,6669641,-3507460,1720492,329177,180563,15805,309740,1650486,196978,181173,7135992,1994
8,"Augusta, Staunton + Waynesboro, VA*",1423446,84463,178685,141246,1323219,35838,30276,155086,1969252,118983,19607,2005090,54859,395002,286869,102263,9540,149259,249308,54075,44535,1024879,1994
9,"Bath, VA",73102,4518,7987,7992,59538,716,539,8514,103387,4112,21220,104103,-5050,26878,17687,4906,480,4651,11983,3082,2602,56468,1994
10,"Bedford, VA*",404433,27387,47471,39248,827788,2609,1376,47011,1199902,51963,20459,1202511,470366,228469,146254,58776,5553,53339,67095,19831,14278,283999,1994
11,"Bland, VA",64401,4040,8864,6200,67038,981,596,7140,99590,7288,14847,100571,9777,13535,19998,6774,996,7884,11964,3141,2145,44553,1994
12,"Botetourt, VA",174661,11625,20650,16178,390501,1783,586,19714,545953,27787,20224,547736,235554,91425,65810,27083,2549,28373,28739,8316,5767,117549,1994
13,"Brunswick, VA",126910,7861,17342,11888,141834,7362,5462,13805,231587,10033,14633,238949,28729,40538,56577,16330,1052,15495,23286,6071,5019,88129,1994
14,"Buchanan, VA",359027,22333,48162,42932,252522,154,138,43799,473582,26707,15648,473736,-62706,84426,136788,30275,1695,26845,69628,12105,10410,262554,1994
15,"Buckingham, VA",100367,6230,12266,8758,128091,6022,5362,10609,202514,15521,14675,208536,38333,41063,39382,14210,1204,20883,16645,4407,3203,62839,1994
16,"Campbell + Lynchburg, VA*",2264046,134446,271982,242718,1485489,4178,2892,255805,2332065,127343,20128,2336243,-522752,450799,399955,116069,8274,130235,393341,82265,73991,1740470,1994
17,"Caroline, VA",128996,8151,17323,11592,255424,2693,2042,13947,368878,18239,18066,371571,140375,61971,54176,20567,1541,20281,23119,6055,4514,85596,1994
18,"Carroll + Galax, VA*",382115,24060,49490,38868,350388,5886,4858,43494,562207,31345,16364,568093,11767,88989,128716,34715,3565,36203,68924,19404,15839,276988,1994
19,"Charles City, VA",32346,2159,4418,2888,79861,859,219,3603,116605,5547,18033,117464,51118,21448,16155,6514,481,5766,5862,1578,1097,20718,1994
20,"Charlotte, VA",85422,5877,9959,7074,105825,5064,3413,9414,176744,16670,14910,181808,29817,33569,42414,12194,1518,20083,13496,4730,3212,51843,1994
21,"Chesapeake (Independent City), VA",1925508,112856,242469,208494,2921358,9928,5082,217103,3889146,112194,21836,3899074,1212953,627662,350054,178560,10506,117276,346716,78332,67826,1461516,1994
22,"Chesterfield, VA",3065721,173832,384230,320378,4551149,2932,1795,334021,5863126,198464,24977,5866058,1819449,952137,362772,234854,14493,200259,544419,107002,92509,2321043,1994
23,"Clarke, VA",114924,7141,11515,10466,153200,3996,1500,12374,240963,16565,20461,244959,50650,66757,25002,11972,1597,18065,16748,5344,3747,80111,1994
24,"Craig, VA",17459,1276,2278,1662,54254,422,238,2107,78303,2967,16822,78725,38902,12645,11826,4680,463,3205,3109,1116,653,11145,1994
25,"Culpeper, VA",348079,21354,41249,33920,413756,3868,890,38314,611673,41347,20732,615541,103991,126438,75347,29691,3250,42237,58209,14082,10832,247633,1994
26,"Cumberland, VA",42066,2288,3700,2680,88497,10353,8990,3628,124817,8558,16410,135170,50059,23356,23317,8237,767,17548,5040,2004,1237,19478,1994
27,"Dickenson, VA",126465,8612,16433,13154,130749,307,278,15189,247861,17641,14161,248168,19473,37643,79776,17525,907,17919,23010,4880,3973,85536,1994
28,"Dinwiddie, Colonial Heights + Petersburg, VA*",892676,54998,120287,92496,944058,7270,5672,101246,1585935,51664,20788,1593205,152628,325960,323187,76642,4243,57336,166535,37899,33656,668805,1994
29,"Essex, VA",103371,6494,12360,10154,98024,2108,1442,11571,169485,10476,18166,171593,6224,40329,33240,9446,847,11918,17437,5155,4308,74016,1994
30,"Fairfax, Fairfax City + Falls Church, VA*",21702575,1222631,2138051,2357148,24398075,1390,531,2401205,33386164,1603276,36702,33387554,5096705,7728923,1260556,909686,90045,1603807,3316625,577059,487014,16782143,1994
31,"Fauquier, VA",520676,30844,58775,48154,949246,7596,2355,54921,1480698,81456,29526,1488294,483491,445692,93356,50406,6563,83811,82852,22533,15970,354013,1994
32,"Floyd, VA",70623,4728,7159,5582,123342,6732,4718,7519,187586,15710,15314,194318,60238,34334,36642,12689,2004,20428,9950,4503,2499,40245,1994
33,"Fluvanna, VA",79954,5712,9257,7172,192003,582,308,9298,302535,13855,20320,303117,121347,69845,41269,14917,1590,14163,12843,4214,2624,52948,1994
34,"Franklin, VA",343182,21271,40366,33816,523133,13322,9705,38179,741869,27444,17723,755191,218130,123899,108159,42610,3268,37149,57274,16235,12967,248759,1994
35,"Frederick + Winchester, VA*",1252711,75272,144776,127760,1065273,5680,1412,139152,1519752,110811,20464,1525432,-48286,296609,163550,74541,7248,112223,208656,47673,40425,931832,1994
36,"Giles, VA",202012,12594,28686,20788,182241,669,525,22988,282140,15665,17287,282809,3217,42723,57845,16360,1446,16190,39080,7479,6033,146742,1994
37,"Gloucester, VA",212601,13774,27145,19328,434124,1852,1469,23438,649148,32181,20265,651000,244961,143168,73708,32125,2837,33650,36809,11285,8448,142142,1994
38,"Goochland, VA",140725,8825,15898,12788,295291,777,275,15219,457248,25504,29381,458025,169785,130003,32731,15589,1914,25779,22292,6240,4326,92654,1994
39,"Grayson, VA",102429,6890,12146,9010,159791,5246,4370,11395,247612,17333,15149,252858,68757,40598,52469,16691,2267,21703,16651,5758,3491,64075,1994
40,"Greene, VA",69401,4668,8486,6196,161707,677,309,7766,221154,13658,17579,221831,100072,36041,24083,12619,1242,13967,11584,3561,2319,43850,1994
41,"Greensville + Emporia, VA*",219870,12907,29238,22140,157736,11580,10528,23977,242225,7191,15087,253805,-38157,42951,53118,16823,750,17719,40308,9016,8266,161843,1994
42,"Halifax, VA",395021,24369,47617,40166,376575,13698,9843,44452,581217,29840,15867,594915,26006,97154,121186,37495,3313,39683,67700,18080,14767,287638,1994
43,"Hampton (Independent City), VA",2283736,116879,339706,258032,1855766,0,0,245895,2810478,59771,19681,2810478,-182075,612217,342495,142802,6466,59771,468722,76152,69686,1755243,1994
44,"Hanover, VA",1042111,62527,114221,105854,1296315,8624,6114,115454,1727454,99562,24305,1736078,369658,287833,151930,71430,6941,105676,167148,40197,33256,769287,1994
45,"Henrico, VA",4717958,276434,502710,512692,4454156,3375,2485,532780,6384012,216164,26879,6387387,268978,1387918,545313,237635,15506,218649,759056,153660,138154,3740253,1994
46,"Henry + Martinsville, VA*",1091173,66762,134398,118014,869056,2680,2264,125769,1386644,64010,18815,1389324,-96348,285222,235046,73841,4987,66274,193405,46329,41342,831494,1994
47,"Highland, VA",20013,1222,1984,1310,25653,3303,2985,1877,45675,4696,19162,48978,7517,15090,8235,2556,697,7681,2639,1373,676,9693,1994
48,"Isle of Wight, VA",398954,23109,46993,40368,399738,10670,8094,43293,551411,20472,20884,562081,44077,90981,71362,26914,1867,28566,67177,13246,11379,303211,1994
49,"James City + Williamsburg, VA*",962618,56701,111887,102918,789423,913,653,108160,1261450,61187,24443,1262363,-65035,339659,133281,51645,4549,61840,163346,39910,35361,737432,1994
50,"King George, VA",371753,17351,57338,39506,244750,1394,974,37104,350706,16295,22908,352100,-89899,81421,25929,15370,1345,17269,77091,10188,8843,277393,1994
51,"King William, VA",142289,8674,15276,14484,186357,3851,3045,15916,259458,8851,21917,263309,59984,46274,30678,12014,965,11896,22518,5012,4047,107875,1994
52,"King and Queen, VA",36031,2476,4493,2896,77759,3311,2782,3924,114241,7344,18419,117552,45652,21818,17975,6382,580,10126,5941,1710,1130,19964,1994
53,"Lancaster, VA",115033,8078,12620,11012,99950,1177,1019,13584,273726,12852,24644,274903,-1499,121290,53663,11155,1298,13871,18126,5805,4507,83036,1994
54,"Lee, VA",147461,10264,20309,14892,184124,2950,2223,17710,338460,13966,14057,341410,54373,47702,109584,24288,2558,16189,27755,8233,5675,103517,1994
55,"Loudoun, VA",1928211,108188,217761,199434,2553330,5714,1791,207905,3312825,112686,30520,3318539,833024,630038,135171,108732,11057,114477,317478,62365,51308,1496256,1994
56,"Louisa, VA",226189,14304,26258,21070,296691,1272,729,24839,425125,34354,19094,426397,95341,69051,60655,22332,4070,35083,36793,10048,5978,154313,1994
57,"Lunenburg, VA",74986,4810,9867,6746,101642,5506,4039,8183,170146,8906,15000,175652,34839,34699,39311,11710,1036,12945,13240,4228,3192,48801,1994
58,"Madison, VA",73592,4846,7786,6166,121745,3246,1793,7929,198365,15207,16565,201611,56082,49121,30745,12171,1670,17000,10869,4436,2766,45723,1994
59,"Mathews, VA",41515,3326,4491,3302,106014,1053,378,4977,193026,10798,22259,194079,69476,55400,32665,8719,985,11176,6142,2499,1514,24197,1994
60,"Mecklenburg, VA",362163,22266,44335,37118,317818,11935,7373,40825,515074,26536,17122,527009,-3520,104521,104670,30779,2671,33909,62894,18044,15373,265360,1994
61,"Middlesex, VA",68645,4849,8537,5954,98877,1638,1171,7826,189847,11871,20820,191485,38058,57218,35390,9197,965,13042,11514,3571,2606,44089,1994
62,"Montgomery + Radford, VA*",1236668,70771,184042,127172,996319,3624,2417,134357,1471918,66987,15680,1475542,-105992,301417,177806,94105,5905,69404,247628,48698,42793,919636,1994
63,"Nelson, VA",84827,6103,9278,7598,147486,1126,176,9902,244200,15604,18448,245326,72561,53329,44511,13298,1527,15780,13077,4831,3304,55970,1994
64,"New Kent, VA",62441,4287,6864,5342,182758,1056,839,6958,249586,12555,22031,250642,127275,43002,24882,11377,1077,13394,9535,3100,2023,39512,1994
65,"Newport News (Independent City), VA",3356452,182307,481197,394232,2298666,0,0,379423,3436746,106139,19159,3436746,-678363,697276,440804,179384,8450,106139,678313,108114,99664,2572000,1994
66,"Norfolk (Independent City), VA",7872350,393505,1151491,937150,2784601,0,0,862080,4864220,183328,19542,4864220,-4225669,1381118,698501,248916,9629,183328,1620066,236032,226403,6068956,1994
67,"Northampton, VA",121241,7365,13953,10694,111259,15165,11065,12712,198987,11816,16346,214152,2730,52645,50248,13101,1178,22881,19300,5774,4596,79060,1994
68,"Northumberland, VA",78936,5677,8838,6394,99626,2593,2200,8874,220249,18202,19714,222842,29564,79787,43429,11304,1359,20402,12035,3903,2544,46499,1994
69,"Nottoway, VA",164793,10111,23710,19150,141723,5733,4499,19686,252008,11157,16675,257741,-3384,51742,64276,15457,1306,15656,33285,7304,5998,115852,1994
70,"Orange, VA",218014,14258,25529,21578,269166,4720,2310,25047,448042,24632,19434,452762,76199,110717,72879,23298,2457,26942,36318,10186,7729,154754,1994
71,"Page, VA",197060,11648,21753,18192,243912,20274,19158,20744,353787,20668,16674,374061,67596,65589,64560,22434,2139,39826,30849,9287,7148,126385,1994
72,"Patrick, VA",145169,9318,17784,14532,192945,3482,2221,16584,284962,14725,15964,288444,64360,42562,52937,18068,1912,16946,25050,7689,5777,103173,1994
73,"Pittsylvania + Danville, VA*",1313683,81012,160708,137174,1250950,22925,17256,149599,1893019,91779,17300,1915944,86866,320636,344358,110750,7587,109035,229295,53356,45769,975353,1994
74,"Portsmouth (Independent City), VA",1693950,85905,268301,183402,1119614,0,0,177606,1850521,41863,17686,1850521,-396730,386281,344626,104634,3863,41863,360002,52357,48494,1292085,1994
75,"Powhatan, VA",129283,8028,17122,11602,274454,1912,1277,13829,359156,20115,20125,361068,159000,55475,31139,17941,2092,21392,22923,6109,4017,84968,1994
76,"Prince Edward, VA",216304,13456,27468,21754,156530,3659,2779,24333,263387,18049,14357,267046,-35441,56223,54293,18600,1204,20828,38345,10287,9083,157131,1994
77,"Prince George + Hopewell, VA*",929646,48391,139639,103430,700876,2177,1686,100106,1017746,29742,19418,1019923,-128664,197849,121198,52525,2206,31428,191354,27787,25581,706864,1994
78,"Prince William, Manassas + Manassas Park, VA*",3063235,172104,364325,326298,5268480,1207,377,335253,6779333,230486,24322,6780540,2540498,1199305,312755,278786,20592,230863,527474,113898,93306,2304898,1994
79,"Pulaski, VA",415229,25180,57139,42352,379135,2056,1021,46356,575084,25838,16749,577140,10262,85593,112412,34458,2174,26859,78315,17429,15255,310055,1994
80,"Rappahannock, VA",46085,3206,3863,3348,82103,1744,1178,4880,146653,14419,22212,148397,40898,48368,17926,6681,1315,15597,5537,2845,1530,24951,1994
81,"Richmond (Independent City), VA",7306917,408090,1011109,780358,2934564,0,0,798269,5156108,323438,25512,5156108,-3574084,1403240,818304,202105,13871,323438,1401288,203550,189679,5582191,1994
82,"Richmond, VA",85707,5240,11056,8434,71755,3430,2497,9457,125468,6428,15590,128898,-4495,29726,27417,8268,639,8925,15273,3682,3043,61509,1994
83,"Roanoke (Independent City), VA",2424597,146440,284966,290580,1156019,0,0,291730,1950905,96137,19916,1950905,-976848,389396,405490,97959,5350,96137,430256,85884,80534,1898204,1994
84,"Roanoke + Salem, VA*",1817519,106513,210941,187144,1880433,2834,1812,200085,2682827,200202,25136,2685661,262999,547347,257881,106844,9032,202014,304513,63512,54480,1310992,1994
85,"Rockbridge, Buena Vista + Lexington, VA*",347518,21918,41391,35900,325539,2164,1140,39868,550952,26868,16884,553116,17889,134842,92735,32759,2870,28008,59341,15845,12975,260169,1994
86,"Rockingham + Harrisonburg, VA*",1546028,86340,184197,151222,1287702,91001,77962,161951,1745662,112974,18812,1836663,-96375,340232,208729,97631,9726,190936,259808,60901,51175,1095284,1994
87,"Russell, VA",228990,14805,29063,24410,252634,4473,3600,27010,422418,21413,14443,426891,50654,53611,120646,29557,2872,25013,41268,11000,8128,162709,1994
88,"Scott, VA",123406,8851,15997,11890,202413,4380,3709,14796,336200,10877,14471,340580,93803,50478,87689,23536,2828,14586,21942,7772,4944,86878,1994
89,"Shenandoah, VA",409567,24545,48328,38718,412333,19062,16063,43904,603193,43220,19062,622255,46670,126377,83545,32644,3911,59283,67687,18290,14379,282597,1994
90,"Smyth, VA",418641,25453,58470,42392,351856,4708,3700,46649,537833,31873,16380,542541,-20136,81409,109276,33122,3102,35573,79666,18433,15331,303402,1994
91,"Southampton + Franklin, VA*",242193,13899,28650,22034,317440,28062,24673,24916,468004,14906,19292,496066,100163,89703,88923,25713,1640,39579,39667,10216,8576,162947,1994
92,"Spotsylvania + Fredericksburg, VA*",1069471,63878,120894,109288,1414185,1231,693,118522,1961073,99786,21573,1962304,463236,371181,176938,90962,7788,100479,175538,45546,37758,793454,1994
93,"Stafford, VA",560345,32046,70386,57458,1284532,1013,910,60775,1690578,60144,22291,1691591,784962,317337,89722,75886,4836,61054,99115,22256,17420,400176,1994
94,"Suffolk (Independent City), VA",559743,33847,69385,56960,712856,16084,11594,62327,1063434,35645,20053,1079518,215440,197532,169130,53834,3199,47239,97865,22135,18936,414639,1994
95,"Surry, VA",117457,6426,14429,12170,74449,7061,5495,12511,112853,2855,18414,119914,-30497,26761,18704,6512,434,8350,20514,2781,2347,88593,1994
96,"Sussex, VA",88382,5260,10271,8032,115102,10912,8412,9276,175460,5534,18391,186372,35996,31862,39408,10134,608,13946,14287,3715,3107,60149,1994
97,"Tazewell, VA",443158,28782,57203,46198,434439,4156,3283,51881,752201,35662,16342,756357,43162,130510,191408,46283,3263,38945,80302,19843,16580,323911,1994
98,Virginia,115317751,6514979,14030966,12408862,108867340,633578,474106,12719410,158249193,7355421,24098,158882771,6268999,34342626,15672805,6593139,521775,7829527,20235397,3813122,3291347,87252827,1994
99,"Virginia Beach (Independent City), VA",4887847,275809,599151,525476,7226228,7743,6530,538547,10290724,417136,24447,10298467,2876928,2390193,682046,421257,28493,423666,861889,195997,167504,3602292,1994
100,"Warren, VA",213076,13827,24335,19884,379937,870,534,23769,555530,33369,19283,556400,190630,102623,73840,28854,2451,33903,34277,10195,7744,144896,1994
101,"Washington + Bristol, VA*",905476,53938,122503,91460,749257,16401,13350,99668,1170568,54903,17895,1186969,-56551,224555,213157,66329,6754,68253,168233,39112,32358,668990,1994
102,"Westmoreland, VA",84679,5892,10168,7368,161554,5943,2924,9576,279355,13460,17367,285298,86451,66990,56754,16428,1469,16384,13852,4946,3477,54443,1994
103,"Wise + Norton, VA*",599125,36827,76110,70280,435453,252,170,71967,746690,43069,17060,746942,-91705,104468,207021,43782,2341,43239,111250,20894,18553,444636,1994
104,"Wythe, VA",290181,18034,38415,29090,291146,6139,4483,32579,449307,22673,17100,455446,33544,74544,89756,26635,2681,27156,52960,14136,11455,210065,1994
105,"York + Poquoson, VA*",535849,31037,74941,54088,1075919,811,233,58081,1593660,54380,25505,1594471,598151,418226,100326,62515,4992,54613,101985,22165,17173,379251,1994
0,"Accomack, VA",381860,22566,46652,35128,338917,23181,15187,40130,574237,45516,17057,597418,-2813,137173,121328,35024,2940,60703,64216,16869,13929,256941,1995
1,"Albemarle + Charlottesville, VA*",2535656,146513,311690,251082,1859492,6430,3874,272054,3177929,251644,27285,3184359,-404110,1031273,293594,116709,12169,255518,437231,86990,74821,1842907,1995
2,"Alexandria (Independent City), VA",4224591,235469,431396,467648,3179264,0,0,469293,4578471,247453,38829,4578471,-576034,1101789,297418,117915,13797,247453,665220,107035,93238,3311918,1995
3,"Alleghany + Covington, VA*",374556,24191,41872,45622,291417,451,227,47002,466439,19237,19288,466890,-36137,74415,101058,24206,1566,19464,64683,12685,11119,290409,1995
4,"Amelia, VA",73186,4268,6802,5516,133726,11521,8866,7026,181483,13774,19368,193004,67566,31037,28241,9965,1129,22640,9560,3373,2244,40986,1995
5,"Amherst, VA",283394,17879,37157,27940,357729,850,339,31849,516013,22861,17009,516863,106184,79554,79580,30387,2434,23200,51127,12514,10080,209067,1995
6,"Appomattox, VA",114609,7391,13618,11012,160114,372,-105,12897,234050,14844,18098,234422,58402,37290,37018,12953,1439,14739,19124,5705,4266,80746,1995
7,"Arlington, VA",9598046,486892,1142076,1074164,4871754,0,0,1023974,7053140,397849,38809,7053140,-3702318,1827051,354335,181741,17082,397849,1679158,200066,182984,7521039,1995
8,"Augusta, Staunton + Waynesboro, VA*",1453533,87501,171931,142962,1354069,31638,25647,158982,2066801,126653,20236,2098439,59518,433583,310787,103697,9888,152300,243412,54791,44903,1057821,1995
9,"Bath, VA",70719,4463,7374,7590,59784,691,498,8258,104280,4754,21189,104971,-2677,26738,18449,4954,527,5252,11169,2984,2457,54298,1995
10,"Bedford, VA*",461302,31048,51016,45040,866412,810,-463,53568,1298033,57693,21403,1298843,458678,270887,161544,60684,5711,57230,73536,21308,15597,330536,1995
11,"Bland, VA",60664,3939,8132,5788,66718,505,137,6833,104244,6866,15256,104749,12887,16105,21926,6866,1022,7003,11026,2982,1960,42635,1995
12,"Botetourt, VA",195643,12936,22391,18600,418487,973,-184,22236,599348,27148,21552,600321,245080,109758,72076,27855,2642,26964,31691,8871,6229,136988,1995
13,"Brunswick, VA",129804,8254,17127,12084,147467,6678,4624,14296,246188,11934,15495,252866,31959,43970,61429,16319,1123,16558,23169,6138,5015,90077,1995
14,"Buchanan, VA",356277,22367,46630,43300,251910,16,0,44017,480464,29846,16090,480480,-60350,84786,143784,29862,1698,29846,68280,11706,10008,258151,1995
15,"Buckingham, VA",103770,6517,12343,9206,131337,5530,4676,11120,207755,16131,14525,213285,38687,38212,43736,14684,1218,20807,16946,4512,3294,66017,1995
16,"Campbell + Lynchburg, VA*",2279874,136970,258374,240786,1515084,2260,895,257363,2390868,127300,20704,2393128,-507427,451423,426621,115588,9101,128195,378767,82690,73589,1772912,1995
17,"Caroline, VA",130587,8391,16698,11618,269984,2134,1385,14200,400285,19885,19156,402419,153597,72991,59444,21008,1535,21270,22507,5952,4417,86810,1995
18,"Carroll + Galax, VA*",399317,25555,49223,40756,363427,4753,3717,45933,598022,32625,17164,602775,10043,100988,138360,35119,3632,36342,69601,19915,16283,293374,1995
19,"Charles City, VA",39703,2515,4978,3466,81750,1972,1258,4248,121374,6694,18694,123346,46295,23291,18305,6598,502,7952,6711,1758,1256,25040,1995
20,"Charlotte, VA",89064,6271,10105,7542,109008,3956,2129,10042,188007,17232,15644,191963,29986,35910,47045,12271,1544,19361,13876,4853,3309,55827,1995
21,"Chesapeake (Independent City), VA",2048263,120327,247841,220596,3034886,10041,4660,230625,4095353,119005,22309,4105394,1217248,685272,385236,184024,11549,123665,358139,82604,71055,1566459,1995
22,"Chesterfield, VA",3349415,191150,389585,346178,4781145,2946,1716,364239,6264492,230421,26075,6267438,1795969,1082659,403634,240360,14652,232137,562674,112382,97730,2554604,1995
23,"Clarke, VA",125257,7792,11999,11522,162843,3844,1552,13553,257787,16927,21370,261631,51139,71023,27765,12243,1755,18479,17760,5811,4056,89018,1995
24,"Craig, VA",18183,1353,2226,1716,59170,450,235,2211,85742,3083,17819,86192,43198,14283,12739,4837,533,3318,3084,1199,666,11781,1995
25,"Culpeper, VA",383825,23537,43504,37196,431751,2855,-205,42135,653688,44240,20898,656543,90061,143589,81203,31416,3454,44035,62102,15431,11977,277688,1995
26,"Cumberland, VA",41466,2354,3688,2712,91947,8977,7687,3710,131211,8837,16779,140188,54191,23977,24264,8355,796,16524,5044,2062,1266,19898,1995
27,"Dickenson, VA",107811,7767,13786,10946,121726,307,269,13240,245179,15871,14076,245486,27155,38300,85460,17440,955,16140,19259,4564,3609,72412,1995
28,"Dinwiddie, Colonial Heights + Petersburg, VA*",922662,57788,119635,94598,966503,5772,4019,105087,1622099,59608,21299,1627871,148928,318630,342738,76431,4749,63627,166934,38511,33762,692101,1995
29,"Essex, VA",103067,6668,11964,10038,100362,788,96,11687,180085,11287,18796,180873,8982,43277,37234,9623,917,11383,16983,5150,4233,74701,1995
30,"Fairfax, Fairfax City + Falls Church, VA*",23294647,1316467,2152719,2513326,25716536,1462,498,2573130,35389638,2028945,38391,35391100,4995019,8291984,1382580,921869,94588,2029443,3409382,593212,498624,17855822,1995
31,"Fauquier, VA",550275,32799,58010,50880,964826,5997,623,58239,1537147,88630,30607,1543144,472790,475714,102604,50418,6662,89253,83450,23105,16443,377572,1995
32,"Floyd, VA",70585,4895,6956,5720,126689,5169,2745,7755,199422,16336,15882,204591,63859,39562,38340,12882,2059,19081,9816,4614,2555,41688,1995
33,"Fluvanna, VA",84619,6054,9340,7532,216886,579,332,9820,337494,15721,21438,338073,142087,75239,45948,15770,1640,16053,13106,4401,2761,55460,1995
34,"Franklin, VA",336076,21386,37534,32836,552571,10535,6746,37804,804300,30034,18721,814835,254299,143993,118271,43525,3421,36780,53952,16161,12740,245344,1995
35,"Frederick + Winchester, VA*",1324353,79594,145920,133164,1126256,9221,4684,146176,1627994,116520,21517,1637215,-51921,331400,179559,76090,7741,121204,212502,49441,41700,990647,1995
36,"Giles, VA",207961,13165,26789,20512,190271,2023,1882,23421,295955,17601,18134,297978,5731,45971,61736,16432,1491,19483,37045,7462,5971,151433,1995
37,"Gloucester, VA",223329,14518,27979,20694,443917,951,569,24865,676794,31684,20727,677745,245453,155287,78541,32698,2915,32253,38326,11706,8791,152750,1995
38,"Goochland, VA",159475,9854,17640,14980,329354,544,-25,17344,497250,25492,31204,497794,187223,132174,36266,15953,1890,25467,25130,6713,4823,108878,1995
39,"Grayson, VA",92841,6645,10627,7924,162153,3255,2254,10607,259288,18981,15403,262543,79919,46243,54147,17045,2388,21235,14589,5535,3147,57017,1995
40,"Greene, VA",75208,5010,8768,6664,172082,544,230,8342,233742,14666,18385,234286,105216,34404,27800,12743,1328,14896,12100,3825,2497,48212,1995
41,"Greensville + Emporia, VA*",228894,13913,29800,23378,159706,7605,6494,25602,256955,7986,15570,264560,-43586,47238,57616,16992,807,14480,41489,9542,8735,172925,1995
42,"Halifax, VA",399010,25109,46181,40066,381829,13559,9431,45142,605354,32035,16442,618913,27961,106907,130177,37643,3475,41466,66214,18133,14658,291330,1995
43,"Hampton (Independent City), VA",2332627,121886,329757,259070,1924189,0,0,251421,2948746,71008,20559,2948746,-157017,652705,371852,143427,6975,71008,459292,76238,69263,1802327,1995
44,"Hanover, VA",1139241,68447,117073,113804,1391790,7224,4350,125349,1864486,116263,25142,1871710,377898,315437,164483,74446,7170,120613,173975,42506,35336,844653,1995
45,"Henrico, VA",5038644,295773,512212,544066,4637600,4040,3086,567806,6731877,200741,27588,6735917,166762,1515364,582953,244162,16503,203827,784245,161304,144801,4050572,1995
46,"Henry + Martinsville, VA*",1090461,67403,126536,116462,876634,3205,2696,125634,1404468,71476,19017,1407673,-88193,279145,251894,74023,5223,74172,184767,45769,40546,831522,1995
47,"Highland, VA",20351,1308,1908,1314,25375,2628,2265,1965,47886,5647,19686,50514,6989,16289,8850,2566,689,7912,2565,1337,648,9874,1995
48,"Isle of Wight, VA",437336,25727,48595,42680,419873,8076,5370,47067,585557,28342,21498,593633,29604,96914,76846,27614,2020,33712,69935,14100,12080,333689,1995
49,"James City + Williamsburg, VA*",1015501,60001,113385,108194,833943,668,435,114098,1381576,70009,25943,1382244,-67460,405040,143261,53281,4761,70444,167482,41990,37229,777575,1995
50,"King George, VA",406859,19217,59706,43960,239502,908,508,41197,356404,15387,22704,357312,-126160,89273,28537,15738,1363,15895,81686,10427,9064,309278,1995
51,"King William, VA",159634,9737,16543,16294,197880,3036,2187,17884,279361,8659,23262,282397,56130,51528,32989,12140,1036,10846,24690,5326,4290,124098,1995
52,"King and Queen, VA",36082,2561,4319,2940,80398,2788,2223,4031,118036,6943,18698,120824,48347,21025,19401,6462,580,9166,5789,1695,1115,21127,1995
53,"Lancaster, VA",114895,8326,12252,11222,100280,544,361,13937,288742,11563,25490,289286,-678,132125,56881,11349,1425,11924,17863,5916,4491,85108,1995
54,"Lee, VA",151555,10800,21100,15424,187228,2447,1710,18512,355658,12971,14730,358105,54185,53233,117644,24312,2581,14681,28812,8464,5883,108062,1995
55,"Loudoun, VA",2127558,119757,227467,216608,2809118,5639,1859,228061,3664602,141161,31403,3670241,909621,709094,152029,116877,12153,143020,335771,67650,55497,1648767,1995
56,"Louisa, VA",235500,15061,25082,20924,318021,511,-11,25523,457375,45176,20034,457886,108044,72196,67669,22855,4206,45165,35544,10001,5795,154791,1995
57,"Lunenburg, VA",73862,4873,9477,6556,103660,5360,3815,8151,178278,9155,15449,183638,37949,36644,43334,11887,1043,12970,12755,4125,3082,48137,1995
58,"Madison, VA",76104,5109,7867,6636,128155,1967,507,8427,212447,15317,17601,214414,60478,52505,33754,12182,1632,15824,11185,4547,2915,49095,1995
59,"Mathews, VA",42454,3470,4421,3380,113691,1198,403,5160,208694,10762,23862,209892,76397,61187,35014,8796,944,11165,6111,2500,1556,25178,1995
60,"Mecklenburg, VA",379661,23571,44429,38662,333102,12933,7804,42902,543238,27035,17775,556171,-3657,108748,114321,31289,2735,34839,63760,18229,15494,281062,1995
61,"Middlesex, VA",71035,5056,8835,6270,102802,1539,954,8191,200279,11140,21657,201818,39958,61382,37634,9319,1017,12094,11970,3841,2824,46971,1995
62,"Montgomery + Radford, VA*",1256403,72691,179162,126938,1026401,2408,1198,136160,1547911,77389,16389,1550319,-93842,331171,192747,94593,6762,78587,242631,50071,43309,935185,1995
63,"Nelson, VA",86286,6230,8852,7716,159926,1735,737,10088,262525,15768,19787,264260,83728,57947,46387,13355,1616,16505,12710,4994,3378,57071,1995
64,"New Kent, VA",70471,4811,7525,6312,192843,347,102,7967,265280,13079,22499,265627,130339,44304,28480,11806,1164,13181,10681,3440,2276,46609,1995
65,"Newport News (Independent City), VA",3448044,186864,501927,415592,2333652,0,0,394660,3555217,123035,19810,3555217,-719732,746992,474573,179469,9316,123035,709723,109261,99945,2615286,1995
66,"Norfolk (Independent City), VA",7971357,401828,1137152,914802,2824416,0,0,859229,4959038,187377,20272,4959038,-4287712,1399547,735075,244623,10955,187377,1594553,239388,228433,6189427,1995
67,"Northampton, VA",121066,7395,13974,10796,110159,14678,10231,12793,204534,11499,16680,219212,1886,54390,54663,13142,1195,21730,19372,5832,4637,79964,1995
68,"Northumberland, VA",83334,6073,8435,6568,105782,2454,2034,9357,226414,20951,20011,228868,31805,73643,49443,11437,1282,22985,11719,3806,2524,48630,1995
69,"Nottoway, VA",168258,10435,23742,18674,146737,5632,4440,19772,260990,11725,17228,266622,-1749,54605,65280,15476,1307,16165,33079,7510,6203,119014,1995
70,"Orange, VA",222189,14657,24973,21628,282399,4945,2445,25471,484465,26733,20586,489410,85681,126051,80960,23774,2564,29178,35787,10349,7785,157224,1995
71,"Page, VA",199202,12119,20877,18016,248150,18306,17081,21127,371000,23891,17199,389306,70075,71348,69808,22636,2223,40972,29885,9387,7164,128345,1995
72,"Patrick, VA",153635,9978,17402,14972,200115,3783,2385,17464,301431,18166,16623,305214,63944,46534,58565,18361,1943,20551,24888,7851,5908,108196,1995
73,"Pittsylvania + Danville, VA*",1358678,85177,157855,141712,1288610,20115,14198,156033,1987062,91106,18116,2007177,85965,348234,370333,110797,8017,105304,228711,54831,46814,1024663,1995
74,"Portsmouth (Independent City), VA",1664440,86243,254251,179150,1128811,0,0,175818,1892117,41641,18351,1892117,-359811,403012,360294,103105,4183,41641,343826,51818,47635,1278973,1995
75,"Powhatan, VA",137307,8517,17340,12318,297068,1402,762,14676,388321,22305,20812,389723,174437,58206,34449,18726,4245,23067,23499,8377,4132,90741,1995
76,"Prince Edward, VA",222437,13842,27341,22362,161044,3620,2766,25023,271871,17605,14576,275491,-36370,55959,58488,18900,1408,20371,38522,10690,9282,163544,1995
77,"Prince George + Hopewell, VA*",962154,50730,138271,103296,725519,1283,771,102378,1076125,37990,20420,1077408,-134257,219922,131967,52762,2328,38761,189919,28039,25711,733474,1995
78,"Prince William, Manassas + Manassas Park, VA*",3207936,179524,366170,336398,5494479,1135,134,347723,7159140,261556,25198,7160275,2634266,1309059,356737,284163,21530,261690,534369,117660,96130,2411877,1995
79,"Pulaski, VA",448929,27686,56192,44470,396712,1118,86,49921,608910,28907,17696,610028,-2296,91563,121753,34473,2318,28993,78427,18500,16182,341509,1995
80,"Rappahannock, VA",47514,3307,3934,3478,83619,1369,817,5046,148625,14887,22248,149994,41151,47615,18760,6742,1393,15704,5673,2929,1536,26137,1995
81,"Richmond (Independent City), VA",7379407,418867,951012,774630,3037293,0,0,806182,5217453,388957,26427,5217453,-3535932,1291383,888777,197430,15089,388957,1338327,199431,184342,5652123,1995
82,"Richmond, VA",86536,5453,10914,8450,72266,2553,1565,9678,130545,6982,15649,133098,-4592,32134,28698,8505,662,8547,15139,3715,3053,62850,1995
83,"Roanoke (Independent City), VA",2473126,151630,276121,297172,1187876,0,0,300216,1947657,96706,19955,1947657,-985034,337323,422458,97604,5851,96706,424707,86325,80474,1951713,1995
84,"Roanoke + Salem, VA*",1985724,116143,220343,207252,1960928,2350,1407,219769,2878882,189562,26898,2881232,194973,643091,277213,107117,9554,190969,323969,67181,57627,1470786,1995
85,"Rockbridge, Buena Vista + Lexington, VA*",360025,22954,41239,36918,337408,1861,809,41413,577987,31932,17647,579848,18796,142417,100023,32859,2918,32741,59698,16132,13214,267586,1995
86,"Rockingham + Harrisonburg, VA*",1597873,90536,180453,154982,1323383,84165,70558,168027,1823882,121332,19078,1908047,-106463,357725,226939,100011,10140,191890,257944,62815,52675,1148039,1995
87,"Russell, VA",241817,15891,30041,26070,259288,1990,1049,28926,446474,21988,15049,448464,46397,61583,127593,29801,2957,23037,43076,11598,8641,175704,1995
88,"Scott, VA",124204,9341,15571,11942,209535,2713,2043,15312,355061,11090,15211,357774,100643,54688,93551,23521,2892,13133,21542,7901,5009,89529,1995
89,"Shenandoah, VA",407039,24632,45598,37648,420056,20787,17713,43456,620765,43603,19394,641552,56473,128639,92857,33080,4061,61316,64422,18448,14387,281301,1995
90,"Smyth, VA",429478,26704,56439,43168,359466,1822,727,48288,562272,33565,16931,564094,-21724,87926,116702,33317,3157,34292,78023,18801,15644,317163,1995
91,"Southampton + Franklin, VA*",249325,14888,29123,22774,329567,22856,19380,26275,495696,18810,19746,518552,106517,94856,94129,26261,1664,38190,40510,10411,8747,170625,1995
92,"Spotsylvania + Fredericksburg, VA*",1132020,67529,120919,113672,1492552,814,241,124365,2105949,116798,22287,2106763,484897,413616,200595,94529,8247,117039,177755,47216,38969,837226,1995
93,"Stafford, VA",616142,35112,75251,61338,1362057,645,518,65781,1802371,67672,23007,1803016,811696,337842,103117,78369,5107,68190,105920,24339,19232,442032,1995
94,"Suffolk (Independent City), VA",566321,34913,68104,56930,753732,13107,8126,63378,1136878,40550,20774,1149985,250789,212197,184056,55358,3495,48676,96569,22764,19269,421076,1995
95,"Surry, VA",118330,6638,13686,12486,77735,6110,4548,12881,118846,3067,18961,124956,-27714,26682,20539,6590,459,7615,19929,2752,2293,90786,1995
96,"Sussex, VA",94174,5688,10443,8542,122361,11533,9091,9959,186292,5947,19479,197825,38146,34222,41242,10156,690,15038,14714,3944,3254,64422,1995
97,"Tazewell, VA",454871,30212,55741,47116,445619,2693,1797,53770,774794,38681,16813,777487,44518,129614,202254,46244,3441,40478,79299,20183,16742,335094,1995
98,Virginia,120285825,6853455,13908905,12820702,113397526,555433,387471,13263806,166447890,8309268,25035,167003323,6375507,36631248,16974549,6670693,554342,8696739,20319256,3902673,3348331,91269830,1995
99,"Virginia Beach (Independent City), VA",5015999,285032,584530,523992,7322795,6072,4909,547028,10627833,470392,25205,10633905,2853824,2556021,755089,421893,30327,475301,846526,198393,168066,3694172,1995
100,"Warren, VA",222032,14426,24644,20528,399087,965,635,24690,591285,34500,20125,592250,201745,114388,78775,29428,2532,35135,34908,10464,7932,151989,1995
101,"Washington + Bristol, VA*",933774,57044,117361,92762,770503,10421,7259,103425,1245676,64412,18717,1256097,-59846,257746,227848,67111,6939,71671,163742,40932,33993,698361,1995
102,"Westmoreland, VA",86603,6214,10002,7568,169725,5997,2579,9998,296706,13756,18178,302703,93120,72423,60555,16652,1513,16335,13786,5016,3503,56482,1995
103,"Wise + Norton, VA*",587725,36445,74714,70730,425199,634,550,71810,759742,34872,17305,760376,-90716,112060,223117,43940,2530,35422,110079,20892,18362,442224,1995
104,"Wythe, VA",302699,19217,38770,30452,301102,3477,1905,34443,472946,23049,17806,476423,32846,79152,96169,26757,2927,24954,53996,14543,11616,223749,1995
105,"York + Poquoson, VA*",538204,31715,71471,53888,1107051,682,154,58659,1628812,54831,25500,1629494,627506,408234,114209,63901,4921,54985,98415,22518,17597,384804,1995
0,"Accomack, VA",380922,22364,46041,34720,342040,22054,14684,39724,592846,45149,17234,614900,842,145180,127680,35679,3043,59833,63401,16715,13672,257688,1996
1,"Albemarle + Charlottesville, VA*",2692176,155069,324237,266830,1963996,5125,2671,288484,3357387,258183,28420,3362512,-439696,1087116,311400,118316,12561,260854,457652,89308,76747,1973670,1996
2,"Alexandria (Independent City), VA",4314160,241351,423190,480350,3365330,0,0,481526,4851367,290847,41027,4851367,-467304,1169431,316606,118248,14606,290847,663365,107238,92632,3359948,1996
3,"Alleghany + Covington, VA*",393584,25349,41868,47838,305728,1022,773,49268,487081,19960,20297,488103,-38588,79018,103357,24048,1618,20733,65787,13093,11475,307064,1996
4,"Amelia, VA",78500,4430,6979,5952,144961,12973,10126,7406,194792,13765,20288,207765,73867,32477,30327,10241,1173,23891,9955,3433,2260,44654,1996
5,"Amherst, VA",287091,17946,36632,28040,375348,716,200,31966,545672,23640,17755,546388,120223,85749,85291,30774,2497,23840,50652,12490,9993,212599,1996
6,"Appomattox, VA",118952,7554,13748,11330,170107,349,-75,13219,249503,16439,19090,249852,64374,39959,39786,13088,1503,16364,19413,5709,4206,83175,1996
7,"Arlington, VA",10251434,521478,1181129,1148198,5125358,0,0,1095577,7415823,447326,40568,7415823,-4030499,1924020,366445,182801,17837,447326,1755228,201790,183953,8048880,1996
8,"Augusta, Staunton + Waynesboro, VA*",1522996,90755,175611,148818,1419366,31698,25839,165164,2174016,130288,21008,2205714,61534,460166,326182,104994,9945,156127,250020,56133,46188,1116849,1996
9,"Bath, VA",70573,4433,6869,7514,61161,853,665,8190,108482,4863,21880,109335,-1222,28904,19270,4997,561,5528,10626,2846,2285,54419,1996
10,"Bedford, VA*",467695,31298,49555,45798,945246,864,-333,54197,1417520,55094,22760,1418384,531748,299348,173790,62320,5841,54761,72454,21464,15623,340480,1996
11,"Bland, VA",61556,3935,8047,5696,68924,554,227,6783,108462,7738,15852,109016,14151,16792,23300,6877,1005,7965,10895,2951,1946,42696,1996
12,"Botetourt, VA",222970,14349,24983,21196,460573,544,-457,24947,660124,30364,23304,660668,262550,123404,76691,28350,2837,29907,35581,9651,6814,157482,1996
13,"Brunswick, VA",128738,8245,17424,12184,148904,3576,1568,14337,256431,12490,15536,260007,34503,46765,64338,16736,1102,14058,23516,6020,4918,91164,1996
14,"Buchanan, VA",362732,22423,49262,44806,256832,33,17,44826,496184,30254,17015,496217,-61074,88530,150855,29163,1665,30271,71665,11565,9900,260796,1996
15,"Buckingham, VA",107920,6540,12850,9700,136649,7084,6115,11390,213295,15109,14786,220379,40119,37437,46293,14905,1209,21224,17700,4546,3337,68996,1996
16,"Campbell + Lynchburg, VA*",2367801,141243,261493,249296,1513825,1648,328,265891,2422115,121761,20950,2423763,-588085,468145,441793,115690,9512,122089,386141,84112,74600,1859571,1996
17,"Caroline, VA",143691,8855,16957,12198,285869,5485,4711,14954,422082,24810,20012,427567,157132,79372,62326,21366,1578,29521,23056,6031,4453,91114,1996
18,"Carroll + Galax, VA*",410357,26004,49717,41954,375885,2858,1912,46981,622496,34678,17654,625354,12509,103489,145980,35423,3630,36590,70694,20030,16400,303073,1996
19,"Charles City, VA",45814,2805,5545,3996,86793,3070,2352,4803,127568,7062,19645,130638,45782,24707,19138,6650,511,9414,7543,1868,1357,28857,1996
20,"Charlotte, VA",93675,6457,10498,7968,113589,3148,1309,10441,196001,17980,16297,199149,30355,36872,48688,12220,1576,19289,14482,4960,3384,59904,1996
21,"Chesapeake (Independent City), VA",2202929,128282,261800,234812,3221832,11835,6486,245688,4376098,135049,23407,4387933,1264591,755211,410890,187459,12065,141535,379206,85785,73720,1682188,1996
22,"Chesterfield, VA",3548725,201541,407872,366222,4968168,2722,1528,384652,6559991,213217,26815,6562713,1804095,1155655,438890,244741,14783,214745,590983,116988,102205,2742997,1996
23,"Clarke, VA",128652,7999,12204,11936,173813,2078,203,13967,278159,17209,22780,280237,59128,77179,29245,12302,1624,17412,18172,5677,4053,93068,1996
24,"Craig, VA",19212,1406,2294,1814,61371,259,31,2313,89657,3562,18313,89916,44472,15285,13260,4910,529,3593,3201,1191,662,12418,1996
25,"Culpeper, VA",397438,24125,43510,38630,462437,3580,739,43440,699503,44949,22028,703083,108439,151770,88876,31917,3389,45688,62825,15328,11939,288925,1996
26,"Cumberland, VA",40132,2419,3928,2894,94864,5610,4517,3866,140444,8636,17064,146054,58598,25559,25631,8559,811,13153,5375,2089,1278,21604,1996
27,"Dickenson, VA",105324,7466,13913,10678,120051,282,235,12805,246568,14641,14398,246850,27532,38558,88241,17145,879,14876,19252,4401,3522,71196,1996
28,"Dinwiddie, Colonial Heights + Petersburg, VA*",959728,59262,120861,97292,1005887,7490,5760,107908,1683240,66721,22201,1690730,154067,328317,356526,76155,4917,72481,169507,38654,33737,717740,1996
29,"Essex, VA",107016,6716,11469,10120,107211,2947,2299,11776,186344,11744,19385,189291,11971,43599,38481,9765,952,14043,16529,5090,4138,76444,1996
30,"Fairfax, Fairfax City + Falls Church, VA*",25390451,1433075,2248280,2770140,26963962,1540,571,2818145,37264882,2168211,39741,37266422,4391656,8830123,1472337,937734,98676,2168782,3633350,615759,517083,19588319,1996
31,"Fauquier, VA",573368,34081,57226,51616,1065496,7632,2644,59889,1648408,98637,32595,1656040,552017,481994,108550,50807,7380,101281,83034,23907,16527,389053,1996
32,"Floyd, VA",72590,4976,7077,5926,132055,4232,1656,7939,210457,16954,16411,214689,67404,42241,40393,13082,2056,18610,10040,4640,2584,43940,1996
33,"Fluvanna, VA",90699,6346,9632,8204,227572,656,458,10448,357808,16647,21722,358464,147321,81420,49472,16502,1718,17105,13734,4545,2827,59860,1996
34,"Franklin, VA",351078,22151,37849,34220,590586,10001,6410,39261,863060,31693,19707,873061,278769,155591,126884,44303,3686,38103,54959,16670,12984,258016,1996
35,"Frederick + Winchester, VA*",1422518,85420,146692,140202,1210582,4703,370,155521,1746670,145923,22599,1751373,-56415,349360,191431,77498,7897,146293,216793,51431,43534,1059432,1996
36,"Giles, VA",215320,13543,27213,20548,196699,1009,875,23817,306754,19347,18758,307763,5196,47218,63846,16407,1460,20222,37487,7377,5917,157611,1996
37,"Gloucester, VA",232870,14780,28437,21638,462026,2753,2398,25599,705201,30828,21439,707954,254755,161409,84519,33022,3044,33226,39256,11913,8869,160388,1996
38,"Goochland, VA",176293,10636,18977,16532,342889,1418,841,18902,525060,27712,32285,526478,185498,144310,39279,16307,1942,28553,27243,7057,5115,120497,1996
39,"Grayson, VA",93241,6556,10771,7890,165505,2620,1582,10501,268768,19623,15694,271388,82765,48343,57540,17292,2410,21205,14716,5456,3046,57320,1996
40,"Greene, VA",83331,5450,9762,7376,192128,1032,798,9138,257240,15252,19718,258272,117935,36342,29802,13098,1347,16050,13450,4141,2794,53831,1996
41,"Greensville + Emporia, VA*",239711,14419,30906,24324,164594,7153,6100,26581,266321,8924,15871,273474,-48536,48096,60784,17231,818,15024,43068,9753,8935,181619,1996
42,"Halifax, VA",402199,25095,45622,40414,388022,11870,7878,45302,622960,31737,16950,634830,31125,109753,137055,37453,3523,39615,65829,17871,14348,296755,1996
43,"Hampton (Independent City), VA",2385371,125064,326464,265386,1984002,0,0,257757,3045946,75621,21221,3045946,-143612,667946,393998,143536,7143,75621,459157,76359,69216,1850593,1996
44,"Hanover, VA",1206882,71627,122059,120362,1494407,10665,7717,131808,2006518,109952,26319,2017183,419333,341236,181540,76645,6569,117669,182240,42613,36044,906973,1996
45,"Henrico, VA",5437871,317899,532823,578148,4895243,5167,4250,606973,7162444,219058,28814,7167611,64345,1650788,621580,248758,17185,223308,821897,167285,150100,4392666,1996
46,"Henry + Martinsville, VA*",1114152,69093,127180,118780,898862,2759,2204,128483,1434398,71687,19469,1437157,-86807,275625,262670,73819,5344,73891,186570,46178,40834,853691,1996
47,"Highland, VA",20114,1284,1939,1342,25003,2203,1829,1955,49494,5484,20194,51697,6844,17225,9469,2560,723,7313,2610,1376,653,10191,1996
48,"Isle of Wight, VA",442764,25818,46629,42132,439867,11485,8941,46884,615326,27795,22330,626811,43987,104312,82632,28070,2073,36736,67695,14217,12144,338333,1996
49,"James City + Williamsburg, VA*",1083413,63551,117558,114640,915203,870,689,120871,1520779,83083,27836,1521649,-47339,450885,155561,54665,5083,83772,174878,42788,37705,824763,1996
50,"King George, VA",441897,20697,63999,47896,253946,1642,1294,44645,379278,17046,24334,380920,-143306,96227,30747,15654,1415,18340,87947,10496,9081,335610,1996
51,"King William, VA",150822,9220,14695,14622,207316,5102,4294,16531,291866,9823,24108,296968,73025,54854,34798,12318,1060,14117,22006,5102,4042,114699,1996
52,"King and Queen, VA",39231,2611,4093,2894,87952,5061,4517,4058,125246,7721,20206,130307,52779,21923,20432,6449,599,12238,5540,1668,1069,21453,1996
53,"Lancaster, VA",118519,8333,11811,11348,105007,1979,1794,14007,290882,12086,25584,292861,495,128693,59161,11447,1485,13880,17485,5900,4415,87154,1996
54,"Lee, VA",168513,11620,23433,18434,198022,-8,-703,20837,375616,12739,15611,375608,50346,56353,121233,24061,2557,12036,32650,8604,6047,123827,1996
55,"Loudoun, VA",2357344,131621,247604,238972,3184376,4807,1515,251107,4127779,166273,33050,4132586,1078139,776741,171469,125042,14057,167788,367090,73599,59542,1822466,1996
56,"Louisa, VA",245637,15538,24377,21400,339859,582,134,26238,487883,51459,20846,488465,120460,77223,71383,23432,4499,51593,35077,10056,5557,158967,1996
57,"Lunenburg, VA",82747,5342,11282,7646,111860,3641,2164,9165,193331,8853,15015,196972,38278,40211,44901,13118,1062,11017,15105,4373,3311,56625,1996
58,"Madison, VA",80674,5247,8078,7032,135983,2607,1271,8763,223337,15569,18455,225944,64072,55006,34955,12243,1610,16840,11594,4608,2998,52240,1996
59,"Mathews, VA",45355,3552,4560,3578,121956,1256,430,5341,223772,11782,25011,225028,81942,66283,36789,8997,1004,12212,6349,2568,1564,26794,1996
60,"Mecklenburg, VA",379322,23505,44838,38244,336780,9154,3960,42627,563415,29537,18234,572569,85,115026,120763,31402,2799,33497,63960,18130,15331,281865,1996
61,"Middlesex, VA",74295,5147,9087,6636,106608,1847,1203,8465,209838,10765,22503,211685,40778,64668,40409,9407,1044,11968,12405,3897,2853,49922,1996
62,"Montgomery + Radford, VA*",1303673,74984,180935,130838,1058385,2448,1350,140403,1600562,81370,16867,1603010,-104885,341904,202721,95036,6821,82720,246354,50861,44040,974599,1996
63,"Nelson, VA",91552,6537,8744,7986,171272,1203,254,10530,281299,19709,20681,282502,90250,61534,49696,13660,1733,19963,12737,5093,3360,58852,1996
64,"New Kent, VA",69594,4662,7313,6170,201764,971,720,7747,277048,12732,22740,278019,139917,47185,29070,12226,1211,13452,10398,3533,2322,45744,1996
65,"Newport News (Independent City), VA",3528108,192196,481026,437778,2366380,0,0,411085,3624502,131100,20232,3624502,-750643,758714,499408,179147,9653,131100,699915,110603,100950,2697093,1996
66,"Norfolk (Independent City), VA",8106566,412360,1116467,919944,2876398,0,0,872332,5081133,198074,20809,5081133,-4357836,1437768,766967,244176,11287,198074,1576439,239021,227734,6332053,1996
67,"Northampton, VA",126804,7681,14231,11102,114401,16079,11761,13232,214000,12045,17495,230079,829,56400,59278,13151,1203,23806,19782,5831,4628,83216,1996
68,"Northumberland, VA",89968,6216,8971,6916,114136,4407,4002,9674,243739,21511,21324,248146,33842,81396,52614,11637,1413,25513,12429,4131,2718,52026,1996
69,"Nottoway, VA",171321,10612,23297,18946,153491,5720,4686,20085,273517,12815,18016,279237,2255,57630,68116,15499,1392,17501,32770,7382,5990,121050,1996
70,"Orange, VA",226131,14714,25465,21994,296980,5681,3322,25711,512041,25075,21203,517722,96560,135112,85630,24417,2641,28397,36462,10587,7946,161272,1996
71,"Page, VA",208316,12453,21496,18902,259509,18965,17735,21904,388831,23238,17849,407796,73097,74978,73309,22847,2292,40973,30947,9574,7282,136396,1996
72,"Patrick, VA",153684,9981,17250,14912,202465,2082,676,17437,312807,18862,16845,314889,66218,51028,61396,18693,2011,19538,24706,7868,5857,109440,1996
73,"Pittsylvania + Danville, VA*",1358227,84869,150044,142050,1299612,17310,11699,155894,2028518,89220,18468,2045828,97279,358977,387239,110779,8128,100919,221069,54855,46727,1036239,1996
74,"Portsmouth (Independent City), VA",1710537,89431,256217,184780,1152269,0,0,181821,1947618,44786,19029,1947618,-376447,412192,383157,102350,4391,44786,348607,52185,47794,1317144,1996
75,"Powhatan, VA",154084,9404,18676,13610,334158,1461,873,16209,434166,26605,22283,435627,196283,63582,37887,19550,4375,27478,25481,8780,4405,101125,1996
76,"Prince Edward, VA",231573,14399,27588,23098,169054,4231,3483,25948,284387,19816,15147,288618,-36571,58166,61398,19054,1454,23299,39137,10690,9236,169137,1996
77,"Prince George + Hopewell, VA*",994353,52119,137791,105978,744390,2599,2115,105108,1108882,38555,20965,1111481,-144855,228329,138762,53016,2390,40670,190780,28322,25932,762903,1996
78,"Prince William, Manassas + Manassas Park, VA*",3455698,193014,382909,361818,5699764,2160,1093,373923,7451034,281417,25430,7453194,2617989,1363676,389754,293082,22443,282510,563818,122650,100207,2609370,1996
79,"Pulaski, VA",447534,27496,54166,43064,406118,1288,361,49028,627548,29936,18154,628836,7612,94762,127956,34639,2367,30297,75698,18447,16080,341539,1996
80,"Rappahannock, VA",53126,3586,4111,3750,88919,1396,912,5461,155834,17680,23314,157230,41254,49194,19117,6744,1525,18592,5986,3128,1603,28548,1996
81,"Richmond (Independent City), VA",7581988,430212,923108,786044,3186058,0,0,823234,5335107,429793,27223,5335107,-3572696,1234488,914561,195978,15801,429793,1316130,198554,182753,5836065,1996
82,"Richmond, VA",89957,5476,11004,8622,75173,4212,3267,9787,135351,6306,16187,139563,-4997,33556,30834,8622,674,9573,15315,3755,3081,65069,1996
83,"Roanoke (Independent City), VA",2555508,156503,276739,304802,1223547,0,0,308904,2011573,102821,20689,2011573,-1023057,353116,434910,97230,6245,102821,429140,87208,80963,2023547,1996
84,"Roanoke + Salem, VA*",2060411,119842,221088,212490,2002635,1190,417,226087,3001964,202945,27776,3003154,168311,709995,290524,108122,9638,203362,327333,68766,59128,1529716,1996
85,"Rockbridge, Buena Vista + Lexington, VA*",387232,24255,43857,39556,361698,1924,941,44033,619584,33643,18875,621508,18499,154739,105071,32928,3002,34584,63635,16521,13519,289013,1996
86,"Rockingham + Harrisonburg, VA*",1645536,92804,183426,156482,1364554,81773,68930,171045,1903626,128525,19341,1985399,-109937,380638,240207,102652,10376,197455,261667,63643,53267,1186414,1996
87,"Russell, VA",261252,16870,32087,28606,272617,720,-228,31173,471809,22777,15823,472529,42538,64415,135497,29864,2871,22549,46390,11725,8854,192313,1996
88,"Scott, VA",123139,9253,15107,11882,215331,675,45,15194,367273,12067,15700,367948,107386,55553,97064,23436,2908,12112,21048,7677,4769,89979,1996
89,"Shenandoah, VA",422137,25304,44909,38648,441019,21122,18251,44628,661511,47018,20608,682633,63510,139707,101907,33124,4191,65269,64233,18475,14284,292635,1996
90,"Smyth, VA",418902,26030,52420,41912,354299,1692,593,46986,567277,35876,17133,568969,-17617,92365,122305,33209,3230,36469,73376,18373,15143,309057,1996
91,"Southampton + Franklin, VA*",260805,15206,29915,23392,339049,25641,22433,26902,510158,19362,20037,535799,105146,98129,98621,26741,1732,41795,41611,10456,8724,177399,1996
92,"Spotsylvania + Fredericksburg, VA*",1215194,71925,127704,121590,1599979,1346,796,132720,2265549,122252,23105,2266895,517505,452255,214661,98111,8643,123048,188499,49470,40827,903647,1996
93,"Stafford, VA",660420,37237,79667,65412,1463208,844,705,69943,1941105,68094,23684,1941949,872731,366350,112391,81994,5427,68799,112373,25720,20293,479248,1996
94,"Suffolk (Independent City), VA",599757,36457,70994,60046,807206,12780,7849,66480,1221132,44285,21530,1233912,273929,232484,194222,57310,3778,52134,101017,23439,19661,446606,1996
95,"Surry, VA",120168,6643,13414,12490,83161,7275,5881,12888,122873,3483,19806,130148,-24119,26311,20676,6571,462,9364,19659,2758,2296,91145,1996
96,"Sussex, VA",100711,5878,10727,8982,132123,13398,11270,10369,198875,6187,20883,212273,41781,36597,43553,10165,676,17457,15218,3905,3229,68036,1996
97,"Tazewell, VA",463884,30326,56774,48074,458450,2262,1420,54363,804215,39536,17547,806477,48929,138520,209507,45960,3444,40956,80811,20355,16911,342117,1996
98,Virginia,126802379,7204350,14128915,13494548,118775640,561034,400844,13951624,174781324,8899145,25973,175342358,5924885,38627134,17939584,6750884,574082,9299989,20876189,3983418,3409336,96626201,1996
99,"Virginia Beach (Independent City), VA",5371056,303817,604401,557132,7623221,7265,6279,582383,11091192,530346,26359,11098457,2834548,2659666,815570,421044,31679,536625,882967,206358,174679,3951464,1996
100,"Warren, VA",244670,15533,26329,22614,427366,1103,805,26840,627485,36384,20850,628588,209536,122364,78858,30148,2586,37189,37636,11005,8419,169845,1996
101,"Washington + Bristol, VA*",980722,59532,117253,94054,791209,9574,6583,106559,1300252,72004,19412,1309826,-82954,278926,239691,67475,6848,78587,164280,40981,34133,737855,1996
102,"Westmoreland, VA",91161,6300,10047,7668,181309,6487,3047,10134,315382,16336,19357,321869,100282,77186,63374,16628,1532,19383,13881,5095,3563,57897,1996
103,"Wise + Norton, VA*",562955,34818,72355,67530,414581,567,482,68583,760959,33173,17449,761526,-79791,116175,230770,43644,2547,33655,106120,20173,17626,423180,1996
104,"Wythe, VA",306145,19272,38418,30418,303530,2746,1407,34481,484076,25133,18069,486822,31866,82440,100852,26943,3054,26540,53627,14905,11851,225978,1996
105,"York + Poquoson, VA*",546735,32747,69036,55164,1118366,542,115,60329,1665542,54904,25599,1666084,631960,423193,124525,65084,4981,55019,96618,23067,18086,395098,1996
0,"Accomack, VA",381920,22489,45227,34756,348997,21563,14348,39867,612714,46184,17490,634277,6944,151201,134079,36266,3168,60532,62605,16443,13275,258783,1997
1,"Albemarle + Charlottesville, VA*",2897830,166992,336852,280876,2115092,4467,1966,307430,3613856,338331,30186,3618323,-475308,1179125,324106,119866,13068,340297,477290,91449,78381,2080243,1997
2,"Alexandria (Independent City), VA",4411781,246193,434091,505946,3535759,0,0,499166,5199507,244705,43355,5199507,-376856,1334708,329040,119930,15001,244705,687064,107053,92052,3480012,1997
3,"Alleghany + Covington, VA*",411191,26402,42278,49424,319951,148,-138,51114,507147,22771,21223,507295,-40126,82839,104505,23903,1578,22633,66990,13091,11513,321568,1997
4,"Amelia, VA",86006,4977,7401,6574,158756,10858,7579,8264,213111,18232,21062,223969,81014,32955,32258,10634,1281,25811,10688,3693,2412,49507,1997
5,"Amherst, VA",302631,18929,37341,29370,398151,-534,-1069,33614,577010,27650,18600,576476,129134,90127,88198,30994,2574,26581,52026,12739,10165,224024,1997
6,"Appomattox, VA",129813,8191,14169,12362,183924,44,-346,14372,269504,18694,20302,269548,68483,43261,42363,13277,1565,18348,20350,5843,4278,91115,1997
7,"Arlington, VA",10862058,559967,1201374,1225770,5461400,0,0,1172852,7903130,441939,42773,7903130,-4227806,2072585,369145,184768,18206,441939,1814259,202212,184006,8605860,1997
8,"Augusta, Staunton + Waynesboro, VA*",1631109,97834,182139,160258,1516155,14924,8790,177963,2318519,145277,22016,2333443,63009,479485,337803,105988,9861,154067,262268,58271,48410,1214774,1997
9,"Bath, VA",73934,4690,6535,7870,65179,166,-36,8625,115500,6489,23287,115666,-130,30297,20190,4967,547,6453,10470,2842,2295,57011,1997
10,"Bedford, VA*",510134,34038,50875,48634,1048912,-253,-1449,58355,1563129,71653,24785,1562876,597133,330173,183791,63058,6217,70204,75192,22411,16194,364738,1997
11,"Bland, VA",64047,4067,8107,5862,72536,539,258,6998,113153,7826,16444,113692,15487,17670,23486,6914,1008,8084,11038,2944,1936,44925,1997
12,"Botetourt, VA",246905,15749,26184,22896,501118,-24,-956,27197,718811,38390,24829,718787,281410,137485,80184,28949,2994,37434,37632,10256,7262,171839,1997
13,"Brunswick, VA",141439,8863,17902,12958,163639,5427,3318,15342,272902,17229,16673,278329,37542,48211,66479,16693,1174,20547,24381,6140,4966,96511,1997
14,"Buchanan, VA",383230,23278,55441,47044,273540,-85,-101,46800,523707,35290,18322,523622,-62890,92723,157359,28579,1659,35189,78963,11906,10247,269078,1997
15,"Buckingham, VA",110326,6879,13027,10066,140229,3465,2313,11912,224574,18098,15010,228039,41815,39079,48731,15192,1297,20411,18060,4651,3354,71855,1997
16,"Campbell + Lynchburg, VA*",2478045,147722,263003,256864,1548983,1255,-97,276154,2452988,142613,21007,2454243,-652908,453671,451589,116827,9613,142516,391435,84147,74534,1944094,1997
17,"Caroline, VA",157597,9772,17571,13268,311065,3358,2497,16406,451673,31752,21068,455031,169874,78617,65349,21598,1708,34249,24205,6292,4584,99143,1997
18,"Carroll + Galax, VA*",433391,27427,49747,43634,402061,2508,1588,49244,656690,42787,18489,659198,17914,106063,151074,35654,3712,44375,71564,20178,16466,317452,1997
19,"Charles City, VA",41308,2661,5352,3852,90920,1263,474,4587,134328,6380,20204,135591,54199,24795,19876,6711,542,6854,7278,1780,1238,27176,1997
20,"Charlotte, VA",102146,6890,11230,8954,121653,3387,1432,11367,207982,16931,17214,211369,30874,38838,50878,12279,1678,18363,15707,5386,3708,68076,1997
21,"Chesapeake (Independent City), VA",2416359,140215,282212,258192,3432524,9176,3336,269311,4660064,158426,24441,4669240,1285476,808281,428435,191040,12570,161762,411308,92541,79971,1843289,1997
22,"Chesterfield, VA",3783512,216672,411622,385152,5364383,2210,937,409248,7046850,274779,28283,7049060,1990119,1220514,464163,249235,17075,275716,604198,120829,103754,2903598,1997
23,"Clarke, VA",136893,8516,12662,12606,193122,885,-702,14819,303670,19553,24403,304555,71048,81650,29783,12480,1574,18851,18965,5714,4140,99077,1997
24,"Craig, VA",20635,1499,2365,1906,65321,39,-218,2452,95359,4527,19226,95398,47138,16126,13951,4962,574,4309,3318,1268,694,13008,1997
25,"Culpeper, VA",435610,26372,46576,42508,505956,1706,-1155,47626,754296,47091,23345,756002,117972,158570,91476,32384,3364,45936,67830,16196,12832,321844,1997
26,"Cumberland, VA",42855,2628,4234,3256,101546,4324,3341,4256,152092,9393,18154,156416,62947,28007,26863,8616,900,12734,5862,2249,1349,24259,1997
27,"Dickenson, VA",115167,7943,15880,12014,130286,136,95,13950,264107,14756,15552,264243,29069,42046,91911,16991,920,14851,21887,4529,3609,78429,1997
28,"Dinwiddie, Colonial Heights + Petersburg, VA*",1011631,62350,125033,101954,1048339,4035,2176,113327,1765929,77695,23320,1769964,150035,353522,368103,75900,5040,79871,176010,39483,34443,755750,1997
29,"Essex, VA",109736,6914,11414,10436,113296,1770,1102,12132,194167,12560,20098,195937,15692,43450,39191,9749,936,13662,16632,5138,4202,79442,1997
30,"Fairfax, Fairfax City + Falls Church, VA*",27858011,1574898,2376043,3077750,28967676,1811,750,3113773,39951199,2198793,41837,39953010,4223438,9455053,1530281,954976,103722,2199543,3914918,643773,540051,21743550,1997
31,"Fauquier, VA",581028,34733,56011,53772,1189588,6635,1630,61619,1825156,90962,35253,1831791,670179,530278,111925,51961,7486,92592,82897,24000,16514,405539,1997
32,"Floyd, VA",76581,5141,7332,6236,141441,4534,1559,8259,224438,17759,17247,228972,73119,45823,41708,13276,2106,19318,10450,4757,2651,46813,1997
33,"Fluvanna, VA",104053,7179,10560,9376,249697,162,10,11867,386324,20957,22260,386486,157511,83492,53297,17362,1962,20967,15248,5085,3123,67838,1997
34,"Franklin, VA",377881,23932,39297,36716,639123,6081,2389,42290,936855,38838,20920,942936,303532,172271,131542,45073,3858,41227,57655,17388,13530,278999,1997
35,"Frederick + Winchester, VA*",1496427,89527,148955,147970,1278359,5044,486,163512,1828279,145185,23238,1833323,-54556,354772,200192,78892,7965,145671,222940,52657,44692,1127816,1997
36,"Giles, VA",216834,13704,26120,20254,205873,-76,-198,23831,322255,21342,19753,322179,12870,50662,65644,16310,1483,21144,36247,7492,6009,159443,1997
37,"Gloucester, VA",244762,15544,29247,22924,495881,486,150,27006,751721,35011,22351,752207,278125,167467,88859,33654,3129,35161,40709,12117,8988,168892,1997
38,"Goochland, VA",194030,11689,19925,18122,366748,496,-146,20750,574471,33869,34866,574967,193468,166841,41378,16491,2169,33723,28986,7440,5271,131321,1997
39,"Grayson, VA",101854,7049,11061,8462,178453,2098,962,11280,286242,23978,16463,288340,87879,49530,60357,17514,2429,24940,15292,5571,3142,61622,1997
40,"Greene, VA",90397,5934,10606,8086,208447,-139,-303,9977,280499,16371,20674,280360,128027,40113,31800,13561,1327,16068,14649,4380,3053,59680,1997
41,"Greensville + Emporia, VA*",252067,15298,31963,25480,171201,4172,3073,28038,279643,12596,16515,283815,-52828,49249,63365,17185,834,15669,44703,10023,9189,191695,1997
42,"Halifax, VA",421371,25894,45848,41832,406716,16032,11843,46810,644035,33034,17741,660067,32155,109870,143481,37205,3596,44877,66764,17997,14401,309730,1997
43,"Hampton (Independent City), VA",2531719,133452,340656,280754,2110813,0,0,273829,3218554,98108,22105,3218554,-147077,705943,401798,145600,7159,98108,481033,78909,71750,1952578,1997
44,"Hanover, VA",1313058,78147,127478,128882,1679854,7073,3794,142588,2239888,135560,28430,2246961,509384,372248,194859,79036,6517,139354,191919,43949,37432,981785,1997
45,"Henrico, VA",6062511,353653,575488,628358,5306978,4627,3661,667832,7618406,301407,30323,7623033,-87701,1671384,644671,251392,17702,305068,889667,176478,158776,4867776,1997
46,"Henry + Martinsville, VA*",1172683,73063,126243,123002,950920,3100,2466,134564,1519175,85168,20593,1522275,-87199,301179,270176,73923,5267,87634,187744,46090,40823,897305,1997
47,"Highland, VA",20382,1341,1985,1430,25122,1285,874,2056,52621,5951,21000,53906,6796,19017,9767,2567,741,6825,2700,1408,667,10857,1997
48,"Isle of Wight, VA",482698,28424,48280,44994,473282,7937,5305,50921,661456,34328,23605,669393,41505,108727,87384,28358,2156,39633,70777,14785,12629,372288,1997
49,"James City + Williamsburg, VA*",1165537,68388,120835,120054,1012920,557,414,128415,1725879,114223,30889,1726436,-24202,545294,168222,55891,5495,114637,180862,44194,38699,870038,1997
50,"King George, VA",492162,23345,70591,53892,271173,928,613,50291,408533,22420,25442,409461,-170698,106091,32197,16094,1523,23033,97537,10816,9293,371592,1997
51,"King William, VA",159297,9949,15259,15410,225818,1740,906,17654,315701,11929,25448,317441,84175,56017,35606,12474,1180,12835,22964,5399,4219,123498,1997
52,"King and Queen, VA",39986,2864,4135,3070,92489,1787,1219,4399,135292,9981,20852,137079,56902,22899,21691,6574,650,11200,5670,1715,1065,23116,1997
53,"Lancaster, VA",125974,8867,12150,12128,111899,332,122,14931,309034,14628,27042,309366,856,136071,61396,11440,1509,14750,18214,6005,4496,93010,1997
54,"Lee, VA",174369,11922,22969,18386,208223,926,260,21115,388905,18068,16280,389831,54969,56662,124946,23945,2509,18328,32162,8425,5916,123879,1997
55,"Loudoun, VA",2757764,155499,264084,287936,3749273,1903,-1132,299467,4801496,168869,35484,4803399,1290976,871946,182180,135369,15217,167737,408052,81315,66098,2181975,1997
56,"Louisa, VA",256336,16147,23883,21870,383745,137,-273,27082,541729,59247,22625,541866,154491,82964,75157,23950,5043,58974,34818,10727,5684,162544,1997
57,"Lunenburg, VA",88205,5621,11095,7902,120632,4488,2968,9572,203475,11581,15744,207963,41999,41356,45975,13209,1095,14549,15046,4285,3190,58610,1997
58,"Madison, VA",86932,5706,8490,7662,147372,649,-649,9537,242088,18869,19610,242737,69977,59040,36325,12378,1664,18220,12321,4768,3104,56391,1997
59,"Mathews, VA",49786,3783,4824,3838,134140,1027,76,5702,238958,14334,26459,239985,90056,68187,37658,9070,1091,14410,6743,2716,1625,28633,1997
60,"Mecklenburg, VA",411475,25171,46138,40726,366013,12116,6425,45534,594692,35115,19140,606808,72,114957,125838,31703,2891,41540,66501,18644,15753,303434,1997
61,"Middlesex, VA",82425,5655,9337,7154,116531,1593,832,9232,226343,14332,23711,227936,43338,69157,42248,9613,1205,15164,12914,4220,3015,54347,1997
62,"Montgomery + Radford, VA*",1398631,80370,188123,139828,1131630,2122,1056,150284,1717347,93923,17942,1719469,-116717,376793,211046,95833,6615,94979,258037,51626,45011,1045615,1997
63,"Nelson, VA",99964,7018,9016,8530,189282,1228,255,11283,305023,23792,22141,306251,100601,64326,52643,13832,1879,24047,13281,5415,3536,62636,1997
64,"New Kent, VA",78882,5217,8025,7002,230474,433,162,8718,310338,15394,24430,310771,160310,50052,30245,12721,1322,15556,11526,4045,2723,51800,1997
65,"Newport News (Independent City), VA",3684907,200553,491732,457816,2414740,0,0,429461,3703830,155000,20735,3703830,-840706,778603,510487,178630,9416,155000,720640,114002,104586,2809267,1997
66,"Norfolk (Independent City), VA",8115498,417629,1082880,915412,2940623,0,0,875335,5210193,218088,21791,5210193,-4299540,1503060,766510,239095,10250,218088,1540586,230217,219967,6356824,1997
67,"Northampton, VA",147305,8410,14863,12112,131577,24898,20269,14466,228533,15982,19334,253431,-1262,60247,61607,13108,1263,36251,20919,6086,4823,90135,1997
68,"Northumberland, VA",95691,6655,9150,7098,123226,2598,2167,10204,268061,26776,22889,270659,37739,91507,55926,11825,1517,28943,12699,4384,2867,54049,1997
69,"Nottoway, VA",177445,11062,23655,19488,162210,4106,3145,20806,287486,16562,18904,291592,5571,60498,68884,15425,1415,19707,33399,7399,5984,124339,1997
70,"Orange, VA",240903,15670,25786,23132,322134,4985,2607,27236,551341,30454,22487,556326,108467,143149,91043,24740,2749,33061,37352,10924,8175,170490,1997
71,"Page, VA",219169,13095,21849,19596,275922,18366,17070,22893,410090,26891,18727,428456,79646,76277,76257,22879,2282,43961,31647,9707,7425,143561,1997
72,"Patrick, VA",166847,10778,17712,15684,216986,2109,600,18620,334215,23421,17696,336324,68759,55197,64141,19006,2018,24021,25554,8039,6021,117272,1997
73,"Pittsylvania + Danville, VA*",1448487,90163,151483,148124,1386016,17204,11511,164225,2136359,115828,19454,2153563,101754,364506,403041,110698,8205,127339,225545,55568,47363,1095603,1997
74,"Portsmouth (Independent City), VA",1805193,95164,265577,195312,1209271,0,0,192820,2007541,53621,19865,2007541,-403102,409942,388328,101060,4363,53621,363233,51637,47274,1388339,1997
75,"Powhatan, VA",163870,9958,20268,15126,371109,617,42,17521,479298,23807,23765,479915,224760,68114,40692,20194,4524,23849,27831,9272,4748,112190,1997
76,"Prince Edward, VA",239039,15021,27564,24026,176102,2490,1804,27034,295263,22339,15443,297753,-35903,57633,64018,19281,1556,24143,39577,10616,9060,175319,1997
77,"Prince George + Hopewell, VA*",1026655,54025,139620,108370,771971,758,266,108210,1143533,46557,21545,1144291,-146474,228579,143741,53111,2480,46823,193805,28168,25688,786027,1997
78,"Prince William, Manassas + Manassas Park, VA*",3797051,211803,409868,396222,6255419,1697,469,409914,8060285,319013,26971,8061982,2868282,1394840,411723,298916,23089,319482,607979,126607,103518,2869590,1997
79,"Pulaski, VA",496043,30481,55432,45984,445730,511,-383,53473,677362,34989,19479,677873,3160,99421,132722,34800,2317,34606,78424,18562,16245,383013,1997
80,"Rappahannock, VA",53408,3625,4359,4194,89447,284,-164,5722,161469,14986,24070,161753,41761,52422,19884,6720,1634,14822,6456,3325,1691,32130,1997
81,"Richmond (Independent City), VA",8049425,456182,956505,823846,3324657,0,0,868105,5603309,483131,28262,5603309,-3856663,1363801,914851,198265,14431,483131,1368428,199505,185074,6197866,1997
82,"Richmond, VA",93453,5793,11236,9006,77986,2110,1133,10296,140584,8011,16387,142694,-5171,33751,30957,8708,713,9144,15739,3847,3134,68570,1997
83,"Roanoke (Independent City), VA",2670773,163404,277272,315590,1269285,0,0,321199,2064112,125899,21290,2064112,-1080289,348924,445903,96953,5631,125899,435067,85948,80317,2109807,1997
84,"Roanoke + Salem, VA*",2117619,122981,223211,218470,2045277,600,-68,232216,3087796,197552,28424,3088396,159874,743647,299472,108656,10008,197484,332446,69125,59117,1587689,1997
85,"Rockbridge, Buena Vista + Lexington, VA*",409612,25606,45227,41852,383332,339,-644,46532,648589,38285,19358,648928,20252,156212,109384,33523,3094,37641,66153,17093,13999,305818,1997
86,"Rockingham + Harrisonburg, VA*",1755777,99623,190353,166412,1449574,67300,54171,182829,2027673,149260,20102,2094973,-123374,398832,246567,104218,10027,203431,273559,65073,55046,1278787,1997
87,"Russell, VA",285277,18145,33492,30360,295587,1627,672,33325,506210,28842,16940,507837,43635,71270,140980,29978,2923,29514,48672,11889,8966,207091,1997
88,"Scott, VA",126475,9480,14721,11970,221559,482,-95,15465,380777,15766,16286,381259,110549,58961,100739,23410,2914,15671,20706,7613,4699,90098,1997
89,"Shenandoah, VA",426007,26008,45302,40032,452323,11720,8863,46024,693296,45326,20896,705016,72340,145977,106716,33740,4404,54189,65318,19026,14622,306500,1997
90,"Smyth, VA",449548,27917,52402,44226,379056,958,-174,50030,599658,47246,18100,600616,-20462,94658,126902,33183,3292,47072,74515,18812,15520,327961,1997
91,"Southampton + Franklin, VA*",269351,16382,31374,25194,350877,13159,9926,28979,548474,24464,20894,561633,110505,107513,103243,26880,1715,34390,43971,10648,8933,190990,1997
92,"Spotsylvania + Fredericksburg, VA*",1338917,79058,136757,132754,1778458,254,-308,145435,2479150,147650,24364,2479404,584976,473063,227883,101767,8904,147342,203134,52029,43125,988441,1997
93,"Stafford, VA",733485,41242,85651,71088,1639606,152,1,76786,2141393,87189,25809,2141545,982907,386785,115154,82976,5826,87190,121195,27318,21492,525100,1997
94,"Suffolk (Independent City), VA",642054,39206,75118,64960,857989,5701,296,71686,1300604,49822,22012,1306305,287621,246885,201431,59345,3846,50118,107598,24352,20506,484338,1997
95,"Surry, VA",123575,7138,13217,13450,89046,2554,1197,13863,132919,4796,20268,135473,-20666,25891,20536,6684,487,5993,19942,2843,2356,97640,1997
96,"Sussex, VA",106007,6592,11984,10382,134567,5838,3822,11783,209748,7351,21078,215586,40343,35155,45864,10228,645,11173,17175,4291,3646,77659,1997
97,"Tazewell, VA",499076,32254,59801,51052,492313,2682,1858,57780,853647,48725,18728,856329,51017,145560,218456,45724,3329,50583,85327,20813,17484,363166,1997
98,Virginia,135741537,7731647,14604051,14433260,127275501,416602,251651,14948277,186428939,9898562,27360,186845541,6482241,41006449,18563591,6829183,590236,10150213,21820681,4081751,3491515,103770643,1997
99,"Virginia Beach (Independent City), VA",5861199,330676,641291,605940,7982225,5460,4539,633646,11593910,601585,27491,11599370,2754672,2769920,847225,421938,32966,606124,944261,212680,179714,4310814,1997
100,"Warren, VA",268975,16941,27503,24354,470552,274,-4,29118,681765,44298,22507,682039,230695,130994,80493,30304,2684,44294,39680,11631,8947,185001,1997
101,"Washington + Bristol, VA*",1011832,61497,116192,96736,832653,7611,4604,109865,1383451,85189,20580,1391062,-69314,308160,250249,67593,6874,89793,164560,41379,34505,757479,1997
102,"Westmoreland, VA",100549,6918,10339,8288,199042,5334,1512,11062,338711,21570,20782,344045,109555,80255,64748,16555,1587,23082,14483,5245,3658,62984,1997
103,"Wise + Norton, VA*",615911,37393,81398,74196,452175,85,0,74491,812363,40074,18776,812448,-89245,122080,238193,43271,2452,40074,118496,20751,18299,457341,1997
104,"Wythe, VA",322498,20336,38815,31836,321516,1123,-73,36254,510220,30319,18839,511343,35272,84760,105067,27143,3055,30246,54733,14958,11903,237519,1997
105,"York + Poquoson, VA*",591320,35540,73196,58520,1212784,535,178,64800,1783202,67975,27101,1783737,686264,437595,133358,65817,5451,68153,102456,24081,18630,420711,1997
0,"Accomack, VA",417106,23902,49712,37410,382765,20651,12501,42607,660435,56213,18378,681086,8266,157103,141218,37059,3203,68714,68417,16661,13458,279975,1998
1,"Albemarle + Charlottesville, VA*",3158608,179065,368435,307428,2311247,3777,926,332779,3916439,351575,32311,3920216,-514582,1279611,329358,121329,15211,352501,522149,95709,80498,2283958,1998
2,"Alexandria (Independent City), VA",4804672,264514,471274,551482,3989828,0,0,540255,5663895,331864,46369,5663895,-274589,1336918,337149,122148,15304,331864,747015,109740,94436,3725793,1998
3,"Alleghany + Covington, VA*",404565,25709,40624,47990,319171,-2,-287,49704,512900,29723,21633,512898,-35690,85922,107805,23709,1607,29436,64619,12637,11030,310510,1998
4,"Amelia, VA",95497,5376,8548,7260,172556,10787,7422,9006,229256,19889,22043,240043,86065,34262,33225,10890,1467,27311,12178,4117,2650,56008,1998
5,"Amherst, VA",327210,20075,39548,31186,419789,-292,-912,35668,605193,34370,19388,604901,128247,90946,94166,31199,2764,33458,55141,13026,10262,238611,1998
6,"Appomattox, VA",138863,8553,14407,12600,199343,239,-143,14853,286707,24414,21309,286946,75333,42671,44932,13466,1866,24271,20707,6118,4252,93885,1998
7,"Arlington, VA",11126371,571566,1219591,1265618,6048928,0,0,1204375,8550382,487221,45799,8550382,-3873068,2117044,384410,186693,17977,487221,1852400,198196,180219,8786750,1998
8,"Augusta, Staunton + Waynesboro, VA*",1762456,103342,193441,166864,1648764,19742,13074,186774,2477381,203399,23364,2497123,73082,496945,351414,106879,10710,216473,276873,59935,49225,1269110,1998
9,"Bath, VA",74457,4656,6579,8018,66491,324,74,8665,116947,5849,23333,117271,699,31736,19044,5026,566,5923,10588,2842,2276,57946,1998
10,"Bedford, VA*",580787,37463,55496,52330,1128294,1602,172,63628,1684540,108142,26036,1686142,611135,358845,199003,64763,7050,108314,81661,23884,16834,390812,1998
11,"Bland, VA",65968,4139,8281,6026,75253,312,-71,7152,115971,7973,16799,116283,16437,16561,24469,6922,1035,7902,11294,2896,1861,46772,1998
12,"Botetourt, VA",276954,17116,28529,24754,564984,442,-682,29493,796747,50658,27026,797189,317523,147788,84417,29497,4400,49976,40906,11790,7390,186072,1998
13,"Brunswick, VA",158033,9691,20796,15056,178788,3195,1009,17219,292042,19320,16939,295237,37974,50760,65689,17429,1215,20329,28324,6576,5361,109380,1998
14,"Buchanan, VA",362308,22113,48661,43146,268139,-89,-105,43686,526705,46829,18731,526616,-50483,92450,166027,28114,2011,46724,70234,11398,9387,245350,1998
15,"Buckingham, VA",118213,7208,13653,10504,151523,2554,1498,12460,238150,23016,15718,240704,45770,38805,50376,15314,2169,24514,18905,5457,3288,74794,1998
16,"Campbell + Lynchburg, VA*",2589236,152301,276087,268214,1652760,2093,602,286408,2590047,137360,22299,2592140,-650068,474647,464733,116247,7268,137962,410194,82539,75271,2041080,1998
17,"Caroline, VA",172128,10564,18520,13898,325578,-742,-1805,17513,474929,45402,21626,474187,170963,81469,67140,21927,2738,43597,25469,7414,4676,103062,1998
18,"Carroll + Galax, VA*",455887,28311,51464,44800,426663,2238,1164,50711,681162,55132,19133,683400,21487,102702,154035,35718,4454,56296,73864,20855,16401,325727,1998
19,"Charles City, VA",51936,3241,6642,4830,98561,560,-258,5656,146849,8875,21448,147409,52281,27926,20922,6873,629,8617,9057,2122,1493,34262,1998
20,"Charlotte, VA",115377,7576,12243,10016,134550,2881,794,12584,224112,20440,18231,226993,31757,40831,51612,12451,1750,21234,17251,5520,3770,76892,1998
21,"Chesapeake (Independent City), VA",2651799,151653,309561,281840,3630625,7270,969,292573,4948526,186784,25571,4955796,1271399,876895,448276,193805,12674,187753,450481,95415,82741,2013565,1998
22,"Chesterfield, VA",4201774,237113,444879,416550,5805094,2469,1044,445388,7593417,396416,30069,7595886,2048708,1292207,498585,252618,17880,397460,653154,124127,106247,3151160,1998
23,"Clarke, VA",145140,8810,13182,13130,205760,990,-1005,15375,323940,22883,26128,324930,75995,88045,31125,12436,1665,21878,19747,5808,4143,103515,1998
24,"Craig, VA",23267,1591,2381,1914,71537,345,65,2548,102552,7263,20679,102897,50818,15822,15538,4976,773,7328,3338,1373,600,12601,1998
25,"Culpeper, VA",471548,27998,50058,45566,527441,833,-2774,50781,778400,56576,23575,779233,106674,160484,91308,33053,3855,53802,72841,16717,12862,344905,1998
26,"Cumberland, VA",46414,2658,4726,3514,111619,5653,4608,4415,162107,9162,19055,167760,69620,27651,28490,8804,874,13770,6483,2271,1397,26161,1998
27,"Dickenson, VA",123008,8314,16500,12688,137518,-1092,-1132,14658,278628,20633,16639,277536,29168,43287,96731,16680,1084,19501,22844,4654,3570,80663,1998
28,"Dinwiddie, Colonial Heights + Petersburg, VA*",1081249,65430,134896,109244,1091591,3314,1409,120052,1835611,79158,24200,1838925,130394,372281,375053,75990,5255,80567,189518,40231,34976,811164,1998
29,"Essex, VA",114036,7107,12577,10960,119694,-682,-1394,12587,200448,14430,20577,199766,18245,42396,37676,9708,916,13036,18057,5200,4284,82943,1998
30,"Fairfax, Fairfax City + Falls Church, VA*",31351772,1748197,2675029,3442714,32053077,2471,1170,3469554,43682740,2624009,45119,43685211,4170859,9990982,1641152,968213,108199,2625179,4396386,672175,563976,24330207,1998
31,"Fauquier, VA",613349,36071,57278,55778,1247496,7340,1702,63960,1932642,103252,36703,1939982,698107,574838,117648,52856,7657,104954,85167,24368,16711,423228,1998
32,"Floyd, VA",87873,5615,8057,6806,157803,4607,1137,9018,242078,23713,18440,246685,78948,46809,42073,13378,2369,24850,11460,5143,2774,51563,1998
33,"Fluvanna, VA",115859,7648,13165,10848,269202,266,36,13072,408776,19013,22284,409042,166415,85577,54263,18356,1487,19049,18589,5012,3525,78221,1998
34,"Franklin, VA",418199,25787,43521,41008,673521,7860,4006,46291,983372,37591,21612,991232,301613,179414,138297,45865,3431,41597,64025,17789,14358,312577,1998
35,"Frederick + Winchester, VA*",1632825,95484,166126,159698,1424431,4895,84,175333,2017941,172033,25172,2022836,-33061,386432,211973,80360,8056,172117,245975,54732,46676,1214733,1998
36,"Giles, VA",218406,13635,25500,20114,213850,221,98,23692,333180,22729,20292,333401,19136,51217,68334,16430,1410,22827,35557,7384,5974,160022,1998
37,"Gloucester, VA",259785,16076,31296,24042,533914,193,-185,28097,810094,39452,23729,810287,302226,186048,90325,34147,3310,39267,43317,12498,9188,177201,1998
38,"Goochland, VA",248178,14532,23345,24330,396363,417,-310,26697,621245,38891,37063,621662,174882,179517,45782,16773,4557,38581,35510,10623,6066,174087,1998
39,"Grayson, VA",102565,6879,10696,8196,187788,2306,962,10977,296762,26282,16947,299068,96200,49412,61868,17647,1985,27244,14794,4979,2994,60527,1998
40,"Greene, VA",112671,7097,12285,10276,225963,602,393,12235,300660,17940,21168,301262,125527,43100,32199,14232,1287,18333,17423,4442,3155,76915,1998
41,"Greensville + Emporia, VA*",269608,16011,34232,26656,183189,5425,4334,29339,290470,17120,17457,295895,-57080,50287,62419,16950,839,21454,47560,10039,9200,200594,1998
42,"Halifax, VA",446674,27204,49077,44474,429419,11196,6945,49441,676685,40430,18503,687881,32186,112134,146328,37177,3516,47375,71314,18120,14604,327985,1998
43,"Hampton (Independent City), VA",2772970,145245,368556,311994,2259616,0,0,301242,3386002,108112,23478,3386002,-212112,721875,404511,144218,7243,108112,524553,81594,74351,2140305,1998
44,"Hanover, VA",1379717,81035,138554,135492,1806161,4210,154,148781,2400906,135945,29307,2405116,575225,395554,203401,82067,7285,136099,206300,45337,38052,1037318,1998
45,"Henrico, VA",6566347,378368,630587,671376,5820795,3256,2139,714056,8347642,333190,32948,8350898,-31496,1853234,676869,253458,16028,335329,966275,179160,163132,5264743,1998
46,"Henry + Martinsville, VA*",1189463,73662,128636,123662,972585,2849,2195,135493,1562573,90900,21258,1565422,-81385,310277,282560,73638,5026,93095,190467,45364,40338,905901,1998
47,"Highland, VA",20723,1274,2020,1440,25608,1974,1534,1994,50438,5518,20906,52412,6879,17605,9199,2507,721,7052,2740,1388,667,10931,1998
48,"Isle of Wight, VA",551263,31957,56807,47510,512787,5123,2397,55712,711817,53620,24804,716940,17236,115539,88614,28904,2989,56017,80562,15802,12813,414684,1998
49,"James City + Williamsburg, VA*",1270156,73095,132206,127610,1142324,338,114,136900,1884420,145366,32827,1884758,9068,569619,172815,57414,6639,145480,196011,46939,40300,928665,1998
50,"King George, VA",519315,24482,74416,57252,287262,-213,-530,53108,429761,26802,26398,429548,-178945,108213,34073,16272,3075,26272,103042,12508,9433,390001,1998
51,"King William, VA",151552,9601,15388,14806,230926,-1440,-2632,17004,323465,12820,25133,322025,96378,55356,35743,12813,880,10188,22791,4975,4095,118573,1998
52,"King and Queen, VA",40901,3000,4367,3248,94970,-873,-1534,4624,141172,11779,21290,140299,58693,23100,22229,6590,876,10245,5991,1979,1103,24665,1998
53,"Lancaster, VA",140521,9596,13504,13070,124870,-506,-704,16131,329618,20422,28546,329112,480,138638,65604,11529,1547,19718,20039,6195,4648,100764,1998
54,"Lee, VA",189029,12395,22861,18358,224019,4061,3371,21574,408858,29490,17407,412919,56564,57425,131475,23722,3202,32861,32040,8925,5723,124128,1998
55,"Loudoun, VA",4293972,246058,339532,378082,4294598,2844,-807,435099,5477957,220640,37507,5480801,435725,983677,202526,146126,16076,219833,528573,89803,73727,3545566,1998
56,"Louisa, VA",286454,17370,24947,23880,420585,324,-294,29310,579242,74187,23490,579566,163441,84186,74795,24673,5016,73893,36887,10845,5829,175674,1998
57,"Lunenburg, VA",91766,5692,11392,8164,128623,4491,2852,9774,213101,12860,16513,217592,46631,43264,45705,13177,1112,15712,15474,4242,3130,60580,1998
58,"Madison, VA",99917,6256,9508,8604,165279,936,-521,10558,260624,23337,20931,261560,75920,59246,37035,12496,2331,22816,13810,5649,3318,63291,1998
59,"Mathews, VA",51840,3778,5286,4072,142449,1069,57,5814,254274,14000,28146,255343,96423,75070,37824,9072,1024,14057,7322,2702,1678,30461,1998
60,"Mecklenburg, VA",431611,25974,49026,42420,387539,10431,4520,47184,623486,40715,19898,633917,3112,117675,128703,31858,2878,45235,70236,18759,15881,316140,1998
61,"Middlesex, VA",85131,5749,10257,7666,121115,714,-131,9582,237997,12551,24683,238711,45566,73578,44018,9671,1079,12420,14090,4186,3107,58621,1998
62,"Montgomery + Radford, VA*",1476464,83879,193046,145362,1199656,3154,1817,156560,1786900,119053,18310,1790054,-120248,369446,220952,97764,6585,120870,265727,51919,45334,1089867,1998
63,"Nelson, VA",106219,7199,9627,9188,208394,1523,393,11793,325941,24995,23392,327464,113968,65821,53249,13999,1559,25388,14221,5094,3535,66610,1998
64,"New Kent, VA",82459,5328,9018,7764,246763,-130,-456,9210,330486,12630,25199,330356,173514,53401,30192,13110,1007,12174,12900,4000,2993,57385,1998
65,"Newport News (Independent City), VA",3910512,209734,526141,490436,2550655,0,0,454952,3900586,156621,21791,3900586,-904905,837773,512158,178999,8965,156621,771359,116196,107231,2982532,1998
66,"Norfolk (Independent City), VA",8266916,424423,1095241,913156,3134824,0,0,881001,5379822,288713,22938,5379822,-4251091,1486182,758816,234533,10020,288713,1551819,223466,213446,6426384,1998
67,"Northampton, VA",155816,8877,15821,12994,138643,23681,18005,15374,240840,18932,20205,264521,-1799,62516,63362,13092,1258,36937,22318,6157,4899,96561,1998
68,"Northumberland, VA",95004,6589,9635,7312,127056,-470,-904,10245,280694,26983,23422,280224,42297,96829,56339,11964,1406,26079,13291,4172,2766,55634,1998
69,"Nottoway, VA",195872,11881,25014,21300,179829,5929,4902,22531,301915,19821,19758,307844,6488,59405,68610,15581,1399,24723,35664,7603,6204,135485,1998
70,"Orange, VA",256010,16330,27782,24632,351911,3846,505,28646,592371,34229,23684,596217,124547,151044,93262,25174,2526,34734,40098,10767,8241,181178,1998
71,"Page, VA",238229,13568,23408,20508,301628,24831,23371,23822,435721,30735,19933,460552,87221,78689,80235,23105,2353,54106,33662,9821,7468,150461,1998
72,"Patrick, VA",172967,10927,18448,15900,224596,2950,885,18877,340571,26318,17827,343521,70506,52597,66328,19270,1920,27203,26398,7916,5996,119366,1998
73,"Pittsylvania + Danville, VA*",1499161,91566,161154,153022,1439614,18274,12143,168077,2217612,116722,20237,2235886,108530,379009,417263,110487,7872,128865,237665,55435,47563,1132631,1998
74,"Portsmouth (Independent City), VA",1877856,98784,276158,202260,1256011,0,0,199914,2074038,60180,20556,2074038,-421931,431118,386909,100896,4355,60180,377288,51618,47263,1440388,1998
75,"Powhatan, VA",175306,10393,21839,16186,406749,940,288,18486,524548,25050,25014,525488,249929,74528,44211,21008,4572,25338,29932,9562,4990,120036,1998
76,"Prince Edward, VA",248915,15434,29152,25078,184267,2607,1884,27973,308841,23038,15814,311448,-36675,61166,66015,19694,1626,24922,41691,10680,9054,182302,1998
77,"Prince George + Hopewell, VA*",1040443,54408,141164,108746,804138,-455,-976,108781,1205725,51766,22311,1205270,-127524,250057,151075,54021,2515,50790,195537,27579,25064,794116,1998
78,"Prince William, Manassas + Manassas Park, VA*",4119005,226412,431099,436302,6651161,1803,363,444563,8592959,400145,27986,8594762,2976719,1501321,442280,307105,22834,400508,649250,129579,106745,3069247,1998
79,"Pulaski, VA",538732,32452,61019,47414,480295,1511,393,56159,719378,38158,20672,720889,-2278,103966,136628,34872,2171,38551,84726,18439,16268,415455,1998
80,"Rappahannock, VA",58514,3802,4633,4660,95630,371,-196,6132,170201,16662,25169,170572,43248,54176,20766,6777,1680,16466,6963,3368,1688,35085,1998
81,"Richmond (Independent City), VA",8471383,473791,997552,851446,3471405,0,0,899514,5803932,620107,29084,5803932,-4100464,1442747,889780,199559,15207,620107,1423275,198342,183135,6428001,1998
82,"Richmond, VA",95145,5941,12018,9384,78987,-526,-1503,10633,145388,8563,16508,144862,-5525,35794,30081,8775,736,7060,16710,3907,3171,71375,1998
83,"Roanoke (Independent City), VA",2898908,173658,305745,339556,1378841,0,0,343436,2203350,139245,22960,2203350,-1176631,368253,456256,95964,5908,139245,475523,87927,82019,2284140,1998
84,"Roanoke + Salem, VA*",2266311,129071,238474,227326,2200873,764,-34,242734,3269514,254910,29876,3270278,177296,755281,314124,109460,11833,254876,352137,72182,60349,1659298,1998
85,"Rockbridge, Buena Vista + Lexington, VA*",439788,26889,48358,44248,411268,1372,235,49013,685467,45044,20321,686839,20493,163231,112340,33800,3008,45279,70482,17219,14211,324027,1998
86,"Rockingham + Harrisonburg, VA*",1884737,103934,206759,175830,1556000,85225,70838,191849,2145570,156613,21143,2230795,-136888,418031,256764,105512,9556,227451,294674,65511,55955,1362612,1998
87,"Russell, VA",288098,17972,34482,30128,300410,1719,638,33036,514116,34342,17186,515835,45348,74160,141265,30014,3136,34980,49546,12100,8964,203572,1998
88,"Scott, VA",133596,9598,15188,12068,228280,2586,1892,15632,390316,19853,16800,392902,110316,61968,102654,23387,2841,21745,21222,7469,4628,90629,1998
89,"Shenandoah, VA",457506,27341,48989,42558,492442,11569,8695,48620,744650,51840,22081,756219,83556,151610,112167,34248,4162,60535,70268,18967,14805,326703,1998
90,"Smyth, VA",485013,29273,56588,47160,408014,2751,1548,52853,632939,55194,19180,635690,-24146,96499,131177,33144,3495,56742,80168,19381,15886,348103,1998
91,"Southampton + Franklin, VA*",299970,17850,38382,29448,379850,10106,6737,32574,580384,20852,22347,590490,112454,108309,102331,26424,1734,27589,53106,11150,9416,219275,1998
92,"Spotsylvania + Fredericksburg, VA*",1470584,84984,154065,145288,1885654,30,-664,157628,2632292,169491,25518,2632322,572698,499597,247071,103155,8531,168827,226709,53741,45210,1075048,1998
93,"Stafford, VA",830991,45656,100813,80376,1716814,-179,-358,85844,2254022,83807,26109,2253843,971667,414534,122495,86325,4497,83449,141001,28299,23802,606541,1998
94,"Suffolk (Independent City), VA",684584,40885,81290,67972,940547,6142,-237,74871,1414481,63583,23445,1420623,330834,270884,209192,60595,3871,63346,115276,24476,20605,505962,1998
95,"Surry, VA",113443,6593,12511,12896,85539,971,-513,13041,130808,4890,19405,131779,-14863,25298,20942,6791,518,4377,18959,2722,2204,90107,1998
96,"Sussex, VA",110121,6889,14047,10900,135992,2421,346,12339,214726,8017,21262,217147,38210,36494,44661,10213,659,8363,19497,4398,3739,82261,1998
97,"Tazewell, VA",516989,32855,62502,52760,507798,1805,903,59235,875921,56343,19319,877726,50044,142242,227686,45433,2946,57246,88882,20237,17291,370861,1998
98,Virginia,147511278,8294384,15705931,15501786,137677406,410302,225716,16045277,199662198,11713421,28992,200072500,6211405,43181734,19213360,6900918,607371,11939137,23456824,4167798,3560427,112115317,1998
99,"Virginia Beach (Independent City), VA",6354671,351779,702870,649820,8412273,3447,2379,676689,12274553,713821,29209,12278000,2734291,2975368,890359,420351,32121,716200,1027780,217961,185840,4610691,1998
100,"Warren, VA",304726,18539,31887,28100,505463,429,136,32589,725413,44861,23821,725842,233326,136316,84063,30471,2721,44997,45937,12431,9710,213792,1998
101,"Washington + Bristol, VA*",1062122,63529,123110,102002,868375,7142,3670,114530,1451442,82852,21423,1458584,-79217,326273,263936,68084,6626,86522,174111,41260,34634,801489,1998
102,"Westmoreland, VA",104320,7048,10885,8708,210601,3884,-304,11402,355252,23043,21566,359136,117683,83834,64701,16653,1572,22739,15239,5166,3594,66342,1998
103,"Wise + Norton, VA*",630534,37750,84995,78430,461013,58,-32,76965,830212,34552,19225,830270,-92556,120571,248686,43187,1885,34520,124210,20224,18339,471804,1998
104,"Wythe, VA",335550,20763,41267,33266,336073,1030,-399,37396,527087,30171,19430,528117,37919,85167,106877,27180,2575,29772,57900,14288,11713,247878,1998
105,"York + Poquoson, VA*",632509,37832,75007,61414,1300093,432,11,68539,1896798,84998,28560,1897230,736123,456321,140816,66430,7110,85009,105714,26185,19075,441786,1998
0,"Accomack, VA",442117,25494,53154,39650,412128,18564,10049,45319,695326,64233,18979,713890,15330,153421,148341,37614,3273,74282,72979,16883,13610,294856,1999
1,"Albemarle + Charlottesville, VA*",3361342,190543,394885,327062,2458270,3881,877,354074,4121739,384572,33566,4125620,-548998,1321622,345728,122911,15663,385449,558416,97826,82163,2417477,1999
2,"Alexandria (Independent City), VA",4963490,274343,480411,568494,4405084,0,0,558590,6131177,324616,48789,6131177,184,1376026,350067,125668,10434,324616,764658,106954,96520,3874216,1999
3,"Alleghany + Covington, VA*",408871,25893,44409,48426,323942,-411,-675,50106,517983,27809,21930,517572,-34823,81269,112361,23601,1658,27134,68622,12554,10896,313115,1999
4,"Amelia, VA",99126,5694,9403,7702,185451,9039,5855,9545,247686,21576,23052,256725,95870,34508,36766,11137,1567,27431,13254,4213,2646,58441,1999
5,"Amherst, VA",340272,20934,41940,32704,452748,-499,-1158,37286,644814,33018,20319,644315,149762,91062,100505,31710,2888,31860,58292,13073,10185,250120,1999
6,"Appomattox, VA",143794,8892,15186,12756,218475,-477,-821,15270,309132,27910,22610,308655,89951,41618,48562,13651,1900,27089,21564,5969,4069,95141,1999
7,"Arlington, VA",11176050,577035,1216248,1248906,6567372,0,0,1201488,9128357,539415,48371,9128357,-3407190,2160125,400860,188716,18550,539415,1840701,194191,175641,8795934,1999
8,"Augusta, Staunton + Waynesboro, VA*",1787122,104927,207674,173210,1680702,15990,9272,191532,2529808,163961,23540,2545798,85112,495334,369762,108150,10873,173233,294279,60837,49964,1319610,1999
9,"Bath, VA",82266,5049,8601,8758,72925,231,-49,9428,124890,5137,24767,125121,87,31620,20576,5052,532,5088,12980,2950,2418,64198,1999
10,"Bedford, VA*",637378,41056,61643,57412,1220796,-956,-2444,69762,1801105,120196,27375,1800149,653180,366717,212636,65758,7084,117752,90349,24916,17832,429277,1999
11,"Bland, VA",64159,4110,8733,5862,76383,-876,-1340,7041,120365,9004,17335,119489,19265,17515,25591,6893,1007,7664,11664,2795,1788,44831,1999
12,"Botetourt, VA",297789,18508,30444,26434,606195,-865,-2099,31725,845836,56200,28037,844971,340131,148610,90166,30138,4510,54101,43661,12042,7532,200027,1999
13,"Brunswick, VA",169162,10417,22047,15988,191413,2687,595,18411,309001,22351,17041,311688,40662,50444,69831,18290,1192,22946,30041,6716,5524,116175,1999
14,"Buchanan, VA",341256,21251,45976,39696,258195,-87,-100,41099,522141,46263,19005,522054,-41962,98477,165382,27469,2006,46163,65824,10776,8770,229269,1999
15,"Buckingham, VA",115654,7204,14198,10430,153992,1121,254,12419,247242,21184,16045,248363,50757,40668,53703,15479,2261,21438,19413,5483,3222,74803,1999
16,"Campbell + Lynchburg, VA*",2765102,161654,303487,285662,1745842,-30,-1553,304485,2693515,147638,23176,2693485,-714775,455037,492606,116218,7381,146085,446318,85003,77622,2172699,1999
17,"Caroline, VA",199192,12065,22258,16330,364429,-462,-1654,20230,517527,51945,23451,517065,185467,81314,71322,22049,2844,50291,30423,7847,5003,118478,1999
18,"Carroll + Galax, VA*",475246,29463,56331,47038,446073,1221,67,52982,707501,52124,19833,708722,23809,102069,160580,35735,4551,52191,79850,20994,16443,343205,1999
19,"Charles City, VA",53264,3354,6680,4888,107320,438,-340,5798,159062,9953,23082,159500,59854,29991,22189,6910,601,9613,9124,2064,1463,34527,1999
20,"Charlotte, VA",117128,7841,13445,10360,139938,263,-1803,13021,235455,21595,18865,235718,35831,39637,56143,12495,1798,19792,18625,5598,3800,78711,1999
21,"Chesapeake (Independent City), VA",2891510,165861,326291,309290,3882084,5631,-649,320506,5261158,200736,26867,5266789,1311080,906490,478215,196035,13151,200087,480936,99593,86442,2210487,1999
22,"Chesterfield, VA",4617657,260657,488618,458074,6190197,2587,1117,489694,8021580,405209,31277,8024167,2062234,1298899,535071,256555,20563,406326,717655,133201,112638,3493676,1999
23,"Clarke, VA",154350,9326,14676,14112,227172,978,-1296,16382,353005,23134,28240,353983,89204,94219,32592,12535,1752,21838,21732,6068,4316,110780,1999
24,"Craig, VA",24925,1710,2721,1968,75894,104,-178,2694,107334,8568,21212,107438,53663,15590,15954,5065,852,8390,3705,1448,596,12830,1999
25,"Culpeper, VA",511722,30353,54685,49512,565788,-1116,-5225,55109,826672,67255,24575,825556,109175,162289,97479,33593,4051,62030,79441,17465,13414,370251,1999
26,"Cumberland, VA",47968,2774,5035,3746,120338,5522,4494,4647,173216,8852,20002,178738,77017,28189,30211,8936,827,13346,6908,2249,1422,27714,1999
27,"Dickenson, VA",126962,8665,17805,13342,141565,-2363,-2400,15336,284027,21773,17054,281664,29939,42591,97508,16516,1129,19373,24476,4737,3608,83113,1999
28,"Dinwiddie, Colonial Heights + Petersburg, VA*",1184379,71230,151580,121672,1142373,3941,2146,132066,1891286,67972,25117,1895227,90060,364008,388846,75455,5017,70118,212416,41587,36570,901845,1999
29,"Essex, VA",121880,7479,14122,11506,130047,113,-582,13232,215141,14189,21776,215254,21399,43685,41522,9885,886,13607,19875,5238,4352,88398,1999
30,"Fairfax, Fairfax City + Falls Church, VA*",36309210,2033732,2869166,3881212,37018678,2881,1430,3974338,49177759,3805082,49813,49180640,4683806,10399802,1762160,987296,110490,3806512,4809772,704997,594507,27692926,1999
31,"Fauquier, VA",677049,40041,62776,60960,1350857,1601,-4261,70521,2048657,125307,37947,2050258,744329,573367,126034,54029,7845,121046,93256,25346,17501,462747,1999
32,"Floyd, VA",96119,6095,8935,7332,172813,4627,914,9761,261193,26948,19471,265820,86455,47081,45926,13652,2586,27862,12601,5420,2834,55656,1999
33,"Fluvanna, VA",126040,8257,15878,12192,290509,409,111,14353,438908,16368,22496,439317,178822,90405,58403,19529,1606,16479,21974,5398,3792,87587,1999
34,"Franklin, VA",446714,27717,47654,43510,719634,4089,371,49472,1045330,42450,22483,1049419,322392,180161,149624,46677,3774,42821,69409,18424,14650,334484,1999
35,"Frederick + Winchester, VA*",1749035,101636,181853,171146,1531528,6874,2192,187209,2133072,175969,26246,2139946,-30298,384644,223774,81533,8230,178161,267426,55630,47400,1303448,1999
36,"Giles, VA",226030,14045,27524,21010,228762,77,-42,24550,351549,23565,21241,351626,27282,51319,71545,16554,1431,23523,38029,7370,5939,164478,1999
37,"Gloucester, VA",280860,17274,34699,25932,570702,401,7,30240,854405,42836,24723,854806,320082,187369,96735,34576,3345,42843,47665,12857,9512,190352,1999
38,"Goochland, VA",299889,17512,27331,29924,436975,664,-99,32474,678156,38114,40709,678820,169560,189771,52074,16675,5172,38015,42293,11734,6562,219581,1999
39,"Grayson, VA",98762,6789,11463,8312,194427,1148,-309,10945,307706,21647,17340,308854,106610,48464,65963,17812,1903,21338,15619,4944,3041,61805,1999
40,"Greene, VA",116019,7279,13749,10210,239543,536,294,12384,320622,20092,21551,321158,135908,46193,35422,14902,1300,20386,18854,4711,3411,76779,1999
41,"Greensville + Emporia, VA*",276889,16500,36725,27408,187155,3765,2777,30204,298750,17700,17554,302515,-59530,50227,65133,17233,811,20477,50429,9846,9035,205983,1999
42,"Halifax, VA",479952,29303,54796,47744,458833,6444,2471,53175,715389,45441,19278,721833,32056,110686,152314,37444,3494,47912,78668,18537,15043,353372,1999
43,"Hampton (Independent City), VA",2954773,155475,391662,332826,2384213,0,0,321888,3538148,118805,24311,3538148,-248672,730940,422995,145538,7300,118805,558075,82269,74969,2277893,1999
44,"Hanover, VA",1484809,87364,147093,149594,1959384,3262,-1292,162161,2586560,124293,30612,2589822,636736,412694,217744,84602,7240,123001,221890,47024,39784,1139918,1999
45,"Henrico, VA",7344570,421819,694248,753096,6282175,2317,1133,798367,8817285,351389,34200,8819602,-264028,1823622,713805,257884,16420,352522,1070796,187320,170900,5921252,1999
46,"Henry + Martinsville, VA*",1177297,73173,133294,122958,972439,1966,1343,134652,1569973,82670,21386,1571939,-70206,299364,300136,73502,4977,84013,194773,43740,38763,898511,1999
47,"Highland, VA",21916,1325,2110,1446,27210,2382,1948,2048,52030,6176,21601,54412,7342,17622,9580,2519,703,8124,2833,1355,652,10959,1999
48,"Isle of Wight, VA",554440,32253,58827,47628,552993,1432,-1171,56067,762224,61474,26050,763656,54620,117364,93299,29315,3003,60303,82641,15622,12619,411496,1999
49,"James City + Williamsburg, VA*",1371166,78697,146375,138354,1220666,361,65,147874,2039800,150033,34621,2040161,-2626,633097,186398,58928,6740,150098,215552,48317,41577,1005516,1999
50,"King George, VA",561769,26986,79524,63124,299393,-397,-690,58548,449252,28002,26994,448855,-203828,113379,36083,16628,3173,27312,111086,13037,9864,423371,1999
51,"King William, VA",152796,9577,15785,14650,243735,614,-861,16902,335813,13465,25895,336427,107841,55291,37401,12992,847,12604,23110,4908,4061,117082,1999
52,"King and Queen, VA",46320,3300,5046,3702,104823,-177,-880,5151,152570,12113,23003,152393,63654,23985,23585,6625,914,11233,6897,2115,1201,28190,1999
53,"Lancaster, VA",151471,10180,15534,13982,134778,-110,-278,17171,342348,20855,29794,342238,478,142780,64680,11487,1636,20577,22525,6481,4845,108369,1999
54,"Lee, VA",186953,12366,24228,17976,225340,3374,2706,21354,409233,29474,17438,412607,59741,55153,132114,23662,3267,32180,33216,8771,5504,121557,1999
55,"Loudoun, VA",5231927,300922,391893,440446,5137206,1687,-2327,521145,6414021,287542,40573,6415708,426424,1057233,221269,158128,17036,285215,612116,99750,82714,4334596,1999
56,"Louisa, VA",314905,18797,31151,25050,456468,-222,-1011,31322,627313,86978,24829,627091,172885,91247,79376,25256,5237,85967,43676,11356,6119,185262,1999
57,"Lunenburg, VA",94405,6055,12504,8822,135471,1166,-469,10466,225664,12183,17206,226830,51532,42718,48641,13183,1117,11714,16915,4322,3205,65776,1999
58,"Madison, VA",118994,7344,10883,10026,187194,613,-899,12357,283791,30320,22866,284404,80557,59614,37596,12438,2465,29421,15896,5916,3451,73677,1999
59,"Mathews, VA",55606,4032,5785,4448,151016,944,-45,6256,263966,14684,28723,264910,101666,74590,39304,9223,1014,14639,8009,2746,1732,32958,1999
60,"Mecklenburg, VA",438566,26778,52696,43294,397403,3254,-2414,48425,644411,43902,20054,647665,7262,116133,134129,32296,2847,41488,74343,18655,15808,322735,1999
61,"Middlesex, VA",91630,6126,11692,8382,129965,658,-209,10317,249430,12460,25400,250088,48652,72540,47583,9846,1045,12251,15883,4319,3274,63496,1999
62,"Montgomery + Radford, VA*",1573327,89129,215480,155470,1284335,1909,388,166864,1887336,112752,19066,1889245,-122128,375738,229172,99088,6790,113140,293215,53913,47123,1166972,1999
63,"Nelson, VA",118909,7904,11788,10218,221604,1580,372,13013,342586,28369,24034,344166,115708,67095,55467,14320,1497,28741,16897,5194,3697,73271,1999
64,"New Kent, VA",87586,5640,9359,8014,269172,171,-187,9647,355152,14933,26795,355323,191233,53086,33065,13261,1081,14746,13366,3812,2731,59474,1999
65,"Newport News (Independent City), VA",3959533,211568,552737,501666,2587024,0,0,462401,3970982,100514,22034,3970982,-910108,837566,546392,180224,6212,100514,803570,111594,105382,3055449,1999
66,"Norfolk (Independent City), VA",8565431,439086,1145499,945082,3266532,0,0,911627,5562141,274385,23821,5562141,-4387272,1501747,793862,233497,10287,274385,1618040,221269,210982,6673006,1999
67,"Northampton, VA",172319,9867,18803,14966,149458,22523,16203,17350,249664,18690,20710,272187,-5511,59689,63040,13143,1298,34893,26286,6775,5477,111140,1999
68,"Northumberland, VA",98405,6772,10355,7488,135910,481,83,10516,293585,27367,24143,294066,48021,100259,57897,12180,1370,27450,14099,4234,2864,56856,1999
69,"Nottoway, VA",216840,12921,29874,23262,197143,6105,5089,24552,325053,17674,21061,331158,4855,62450,71565,15724,1406,22763,41505,8027,6621,152572,1999
70,"Orange, VA",258090,16566,29511,25456,372656,3097,-1003,29294,619113,29396,24344,622210,143860,151048,98506,25559,2103,28393,42239,10443,8340,187458,1999
71,"Page, VA",243867,13827,25044,20518,316756,26106,24584,24086,449945,33563,20560,476051,96975,76565,82730,23154,2348,58147,35303,9744,7396,150417,1999
72,"Patrick, VA",179259,11393,20226,16624,229596,1707,-778,19705,348599,25832,18114,350306,70042,52594,68116,19339,1939,25054,28538,8037,6098,125667,1999
73,"Pittsylvania + Danville, VA*",1562875,95378,178737,159808,1502811,10009,3891,175282,2292906,111404,20878,2302915,115218,359362,440742,110305,7751,115295,258641,55893,48142,1188939,1999
74,"Portsmouth (Independent City), VA",1942761,102920,291818,210364,1307124,0,0,208102,2130998,55536,21142,2130998,-427535,423530,400344,100794,4399,55536,397000,51963,47564,1490225,1999
75,"Powhatan, VA",194713,11537,24430,17938,450658,703,21,20506,573408,29257,26366,574111,276451,76647,46806,21775,4285,29278,33399,9560,5275,132036,1999
76,"Prince Edward, VA",264585,16358,32478,26960,195336,1866,1157,29838,324523,21760,16519,326389,-39411,59502,71551,19758,1464,22917,45958,10656,9192,195710,1999
77,"Prince George + Hopewell, VA*",1047942,55216,145202,111006,843660,29,-481,110719,1246763,43005,22766,1246792,-93563,241026,162106,54765,2593,42524,200705,27826,25233,804713,1999
78,"Prince William, Manassas + Manassas Park, VA*",4480153,245798,470433,472520,7255499,1830,280,482058,9313932,430205,29365,9315762,3257404,1573852,486411,317240,23965,430485,706693,135623,111658,3342975,1999
79,"Pulaski, VA",626722,37306,72909,54180,536392,1777,509,64396,778530,39190,22240,780307,-25934,102639,141276,35085,2226,39699,99999,20058,17832,487024,1999
80,"Rappahannock, VA",67437,4436,4974,5412,102123,-303,-948,7142,179667,16526,25453,179364,41828,55520,21721,7047,1715,15578,7680,3335,1620,44179,1999
81,"Richmond (Independent City), VA",8533679,476653,1036219,861998,3567485,0,0,907652,5932124,570756,29788,5932124,-4058542,1465640,898999,199145,13774,570756,1467218,191853,178079,6495705,1999
82,"Richmond, VA",103242,6367,13441,10232,84716,-327,-1225,11483,152473,9027,17221,152146,-7043,36046,31384,8835,738,7802,18557,4021,3283,76883,1999
83,"Roanoke (Independent City), VA",2999508,179124,325991,351672,1447279,0,0,354960,2309363,144187,24199,2309363,-1197269,399053,463031,95431,4993,144187,501827,85523,80530,2353494,1999
84,"Roanoke + Salem, VA*",2371862,134653,258269,240314,2240996,784,-88,254810,3321247,243921,30233,3322031,123944,747323,333712,109882,12043,243833,378426,73469,61426,1749603,1999
85,"Rockbridge, Buena Vista + Lexington, VA*",471667,28700,54214,47648,439528,401,-807,52524,719736,44867,21220,720137,20385,163019,117590,33937,3094,44060,78038,18019,14925,349569,1999
86,"Rockingham + Harrisonburg, VA*",2010243,110833,228044,189600,1647583,80637,66051,205633,2254104,158494,21757,2334741,-157027,416097,271061,107311,9733,224545,322844,68004,58271,1462854,1999
87,"Russell, VA",307690,19204,38369,31392,316444,-374,-1515,34900,535974,39239,17788,535600,43654,71648,147508,30110,3183,37724,54065,12290,9107,215901,1999
88,"Scott, VA",139716,9936,16339,12254,237735,4078,3305,16063,401028,22440,17306,405106,114082,64246,103125,23408,2720,25745,22466,7357,4637,91505,1999
89,"Shenandoah, VA",480698,28716,53865,44400,525766,9608,6935,50916,796274,56897,23265,805882,95984,160394,119722,34639,4225,63832,76065,19249,15024,340801,1999
90,"Smyth, VA",508338,30586,62451,49602,425926,2412,1224,55387,651931,50367,19821,654343,-27025,94355,134062,33013,3575,51591,87252,19433,15858,369495,1999
91,"Southampton + Franklin, VA*",303490,18498,41481,31380,378198,2830,-410,34188,589531,11854,22751,592361,108896,106051,108112,26037,1537,11444,57171,11266,9729,234875,1999
92,"Spotsylvania + Fredericksburg, VA*",1624005,93797,170064,161286,2056859,-515,-1298,174440,2850579,175137,26719,2850064,607294,531388,261817,106667,9091,173839,250707,56981,47890,1199459,1999
93,"Stafford, VA",970473,53312,115983,92762,1883702,-526,-722,99693,2461217,90951,27513,2460691,1012922,440996,135993,89436,4564,90229,162364,30812,26248,717880,1999
94,"Suffolk (Independent City), VA",750813,44709,88701,73890,1032902,4975,-1917,81654,1529375,80746,24592,1534350,363743,279453,221995,62393,4115,78829,125646,25506,21391,546338,1999
95,"Surry, VA",114964,6521,16224,12692,88057,-69,-1572,12867,135425,5255,19996,135356,-14040,24644,22655,6769,531,3683,22570,2650,2119,88711,1999
96,"Sussex, VA",129113,7966,18249,12988,145706,1061,-909,14460,229126,8272,18333,230187,31053,37385,47096,12556,649,7363,24743,4789,4140,97007,1999
97,"Tazewell, VA",523034,33436,66113,54192,513522,-393,-1304,60532,889272,52384,19767,888879,51020,139170,236187,44968,2936,51080,93209,20368,17432,378745,1999
98,Virginia,159419000,8976267,16811347,16612118,150058326,315292,124653,17282326,214145913,13184910,30637,214461205,7921652,44153729,20249150,7000174,611271,13309563,25117406,4261127,3649856,120992031,1999
99,"Virginia Beach (Independent City), VA",6898656,380468,761916,700686,8927494,2084,952,730811,12917132,810405,30588,12919216,2759649,3033602,958120,422369,32724,811357,1112259,225726,193002,4975040,1999
100,"Warren, VA",339858,20505,36996,31488,538563,128,-158,36249,770714,45587,24793,770842,234954,142895,89384,31091,2822,45429,52740,13125,10303,241689,1999
101,"Washington + Bristol, VA*",1149915,68588,134492,108812,933081,4828,1134,122994,1540020,103309,22600,1544848,-93840,338254,273513,68357,6705,104443,188898,41860,35155,856574,1999
102,"Westmoreland, VA",108502,7345,11867,9050,226627,3838,-393,11870,376060,23808,22766,379898,129995,83140,70131,16687,1534,23415,16392,5140,3606,68695,1999
103,"Wise + Norton, VA*",643390,38408,89995,79838,471936,-209,-299,78327,836976,34876,18973,836767,-93127,115181,249650,44103,1807,34577,129914,20252,18445,478899,1999
104,"Wythe, VA",352402,21841,45140,34916,356188,-817,-2375,39299,549852,29294,19985,549035,43085,82939,109908,27472,2597,26919,62598,14336,11739,262885,1999
105,"York + Poquoson, VA*",664974,39948,81702,64388,1382825,459,-1,72142,2013088,85754,30001,2013547,789993,478996,151726,67117,7083,85753,113896,26635,19552,465325,1999
0,"Accomack, VA",460888,25676,55070,41536,436283,24826,16934,46444,729819,57570,19747,754645,21839,165542,152820,38215,3414,74504,75838,17554,14140,310546,2000
1,"Albemarle + Charlottesville, VA*",3681729,204896,419921,352340,2679312,4682,1865,381066,4468655,457749,35820,4473337,-621351,1417358,376667,124883,16550,459614,596091,100673,84123,2626024,2000
2,"Alexandria (Independent City), VA",5567191,301193,541331,629716,4785019,0,0,616051,6578730,351986,50909,6578730,-166121,1444545,349166,129225,11090,351986,856189,113367,102277,4359016,2000
3,"Alleghany + Covington, VA*",417951,26035,45176,48900,332781,19,-199,50485,540615,27119,23012,540634,-34685,88248,119605,23494,1736,26920,69626,12636,10900,321405,2000
4,"Amelia, VA",104228,5829,10150,8294,196889,8990,6326,9976,264750,21086,23916,273740,102637,38647,38204,11446,1637,27412,14297,4349,2712,62519,2000
5,"Amherst, VA",363828,21878,43418,34554,485125,605,-23,39155,690283,37532,21689,690888,160452,98280,107483,31854,3002,37509,60695,13178,10176,265624,2000
6,"Appomattox, VA",149069,8869,15484,12724,240293,1531,1253,15231,335670,29497,24628,337201,106455,45975,50933,13692,1977,30750,21846,5990,4013,96473,2000
7,"Arlington, VA",12308868,628536,1322039,1356500,7195815,0,0,1306786,9950012,634765,52590,9950012,-3806267,2335812,418385,189198,19745,634765,2000289,200667,180922,9673814,2000
8,"Augusta, Staunton + Waynesboro, VA*",1887631,108116,213898,180648,1784694,26576,20548,198440,2689536,179400,24889,2716112,95503,535588,395830,109129,11352,199948,304222,61784,50432,1383461,2000
9,"Bath, VA",85573,5145,8650,9198,76571,985,711,9744,133528,3587,26795,134513,742,36629,21313,5020,545,4298,13249,3045,2500,68026,2000
10,"Bedford, VA*",691636,42815,68621,61026,1294418,3508,2124,73328,1919428,127429,28745,1922936,676110,396923,231595,66897,7384,129553,99134,25987,18603,462949,2000
11,"Bland, VA",67010,4126,9019,5988,79737,169,-320,7120,124936,9057,18309,125105,19847,18469,26899,6833,1037,8737,12013,2763,1726,46260,2000
12,"Botetourt, VA",326718,19598,32991,28656,643402,566,-634,33926,908847,59286,29673,909413,350610,166738,99273,30648,4754,58652,47319,12748,7994,220747,2000
13,"Brunswick, VA",184831,10887,23176,17000,208233,5856,4072,19387,332504,25305,18402,338360,42789,54912,75215,18387,1230,29377,31676,6803,5573,123778,2000
14,"Buchanan, VA",351642,21459,46438,41912,265422,84,72,42415,545839,45771,20341,545923,-43805,109343,171158,26838,2100,45843,67394,10726,8626,238405,2000
15,"Buckingham, VA",126443,7507,14573,11058,167563,3589,2980,13036,266234,24222,17259,269823,54156,45150,57110,15634,2340,27202,20102,5607,3267,79139,2000
16,"Campbell + Lynchburg, VA*",2888803,165503,315002,295268,1833668,4929,3537,313137,2849178,154124,24517,2854107,-741998,495777,524662,116412,7720,157661,462636,85978,78258,2268506,2000
17,"Caroline, VA",211982,12272,23686,17698,390925,2200,1033,21121,552771,50273,25071,554971,200064,89411,74635,22136,2988,51306,32535,8137,5149,128141,2000
18,"Carroll + Galax, VA*",494144,29906,57144,48030,468638,2720,1624,53921,749050,57529,20776,751770,28415,112189,170943,36185,4691,59153,81159,21074,16383,353832,2000
19,"Charles City, VA",56823,3456,7258,5208,119073,1166,511,6060,173664,9462,25228,174830,68310,32520,23237,6930,630,9973,9862,2107,1477,36988,2000
20,"Charlotte, VA",126002,8010,13970,10778,150794,3340,1507,13399,248264,22684,20167,251604,38191,43397,57413,12476,1845,24191,19359,5710,3865,82452,2000
21,"Chesapeake (Independent City), VA",3086089,173063,357441,325836,4158606,7673,2149,335981,5660997,212230,28312,5668670,1408498,994490,515574,200224,13955,214379,520359,102047,88092,2351351,2000
22,"Chesterfield, VA",4990408,275902,518452,483356,6722426,3061,1720,517580,8738567,519187,33487,8741628,2249598,1427903,591299,261047,21960,520907,760130,137184,115224,3709371,2000
23,"Clarke, VA",168741,9867,15251,15180,257462,2193,-70,17457,397862,26202,31570,400055,106178,106046,36547,12672,1841,26132,22841,6280,4439,119768,2000
24,"Craig, VA",26017,1683,2787,1998,82386,971,720,2682,115621,8318,22983,116592,59051,17131,17075,5073,888,9038,3786,1514,626,13193,2000
25,"Culpeper, VA",559248,32199,59427,53308,639644,1722,-2354,58853,928588,72921,27011,930310,139249,183534,107132,34442,4246,70567,86081,18124,13878,402600,2000
26,"Cumberland, VA",51589,2781,5239,3922,129147,8091,7193,4742,181032,8011,21044,189123,82300,28993,30983,8987,854,15204,7200,2279,1425,29185,2000
27,"Dickenson, VA",123199,8385,17477,13530,142481,-3300,-3335,15150,289632,19066,17543,286332,34432,42537,101314,16322,1174,15731,24242,4743,3569,83226,2000
28,"Dinwiddie, Colonial Heights + Petersburg, VA*",1225491,72377,157554,126772,1178218,7469,5969,135763,1958204,53304,26160,1965673,88490,378020,409435,75140,5266,59273,220940,42297,37031,945278,2000
29,"Essex, VA",129708,7521,14572,11964,141667,4223,3621,13503,229163,13501,23376,233386,25462,47007,44712,9984,923,17122,20554,5291,4368,92032,2000
30,"Fairfax, Fairfax City + Falls Church, VA*",42458385,2328435,3294151,4399036,40161287,3408,2000,4527953,53620200,4794295,53224,53623608,2230855,11508306,1954015,1007517,117779,4796295,5493669,746842,629063,32168421,2000
31,"Fauquier, VA",760362,43357,68767,67564,1566945,6722,1325,77139,2284685,139448,41309,2291407,883722,588607,135855,55470,8256,140773,102549,26867,18611,517040,2000
32,"Floyd, VA",107758,6396,9243,7624,191555,7569,4060,10208,286867,32305,21169,294436,94005,54118,48763,13909,2668,36365,13055,5618,2950,58338,2000
33,"Fluvanna, VA",137401,8717,17434,13272,325870,1928,1604,15353,487645,15457,24247,489573,203822,99176,64527,20191,1686,17061,24070,5671,3985,96270,2000
34,"Franklin, VA",469275,28245,49295,44234,764670,6871,3691,50362,1124637,53462,23798,1131508,345757,205794,161044,47546,3903,57153,71412,18623,14720,340710,2000
35,"Frederick + Winchester, VA*",1896641,107817,193743,184170,1676572,4411,385,199902,2346352,198054,28208,2350763,-20167,429237,244954,83338,8659,198439,285828,57890,49231,1412374,2000
36,"Giles, VA",213628,13088,26088,19978,229022,1250,1145,23077,358636,21049,21501,359886,38471,55365,75499,16738,1485,22194,36077,7211,5726,155357,2000
37,"Gloucester, VA",291574,17520,35678,27286,606054,1791,1423,31163,910637,38983,26224,912428,345643,203812,102562,34793,3513,40406,49321,13084,9571,201847,2000
38,"Goochland, VA",309645,17455,29702,30424,474864,2589,1879,32667,729595,42183,43235,732184,197886,203587,53733,16935,5549,44062,44914,12480,6931,220669,2000
39,"Grayson, VA",89998,6119,11488,8384,190775,2935,1518,10311,316130,10248,19012,319065,111088,56847,71443,16782,1928,11766,15680,4840,2912,62552,2000
40,"Greene, VA",131241,7905,15804,11664,267402,2095,1850,13737,354210,19102,23056,356305,149898,50998,37905,15454,1340,20952,21636,5054,3714,88653,2000
41,"Greensville + Emporia, VA*",294337,17164,37414,28956,196991,5646,4854,31642,311561,18879,18420,317207,-65704,50876,69340,17221,841,23733,51892,9950,9109,218712,2000
42,"Halifax, VA",488103,29019,55076,47862,470004,12544,9245,52950,741398,41253,20213,753942,34851,122129,161809,37299,3573,50498,79007,18425,14852,358598,2000
43,"Hampton (Independent City), VA",3048468,157949,410854,340096,2543005,0,0,327997,3761750,121312,25756,3761750,-177466,764738,454007,146054,7729,121312,580902,82637,74908,2346254,2000
44,"Hanover, VA",1550804,89433,156513,157132,2118398,5822,1376,167999,2810792,111605,32385,2816614,735593,457924,240292,86972,7672,112981,235079,48327,40655,1202744,2000
45,"Henrico, VA",8112339,456280,757528,806432,6810732,2835,1732,859496,9568624,489072,36203,9571459,-442111,2003386,757341,264385,17466,490804,1160744,193262,175796,6460791,2000
46,"Henry + Martinsville, VA*",1160990,71653,130492,118574,972811,2481,1949,130940,1620194,92373,22157,1622675,-57239,328497,321367,73234,5220,94322,189779,41942,36722,876889,2000
47,"Highland, VA",24221,1337,2291,1548,29649,3790,3408,2111,55229,5965,23337,59019,7539,19108,10262,2529,710,9373,3065,1366,656,11783,2000
48,"Isle of Wight, VA",528924,29951,55280,45894,606956,6464,4268,52898,831296,61891,28067,837760,130930,130062,100742,29849,3160,66159,78227,16056,12896,384538,2000
49,"James City + Williamsburg, VA*",1513350,84924,154223,148108,1362577,714,387,158978,2226955,201779,36792,2227669,8205,656565,208527,60548,7168,202166,228277,49616,42448,1082907,2000
50,"King George, VA",633641,30182,88019,70016,330211,1535,1297,65190,490498,33996,29087,492033,-238240,121757,40065,16916,3344,35293,123027,13638,10294,475321,2000
51,"King William, VA",154506,9469,15975,14550,268255,2171,619,16744,369129,14613,28048,371300,130493,61702,41343,13238,885,15232,23250,4815,3930,116024,2000
52,"King and Queen, VA",52265,3437,5582,4112,111286,2135,1477,5493,159396,11376,24400,161531,64514,26393,23852,6620,952,12853,7638,2283,1331,31774,2000
53,"Lancaster, VA",161998,10487,15654,14702,146050,989,864,17838,362955,24852,31513,363944,1890,149852,68042,11549,1729,25716,23005,6534,4805,113277,2000
54,"Lee, VA",189179,12107,24410,17854,232367,5406,4824,21034,424201,29259,18244,429607,64222,58765,138475,23548,3325,34083,33337,8812,5487,121759,2000
55,"Loudoun, VA",6162254,346964,462421,519602,5914725,11025,7131,606765,7333465,359517,42232,7344490,359236,1171382,258383,173907,18071,366648,722222,111287,93216,5073384,2000
56,"Louisa, VA",337893,19388,32212,27124,505717,1878,1033,32950,695748,92724,27020,697626,200774,104075,87834,25819,5526,93757,45774,11837,6311,198362,2000
57,"Lunenburg, VA",102834,6275,12925,9374,146064,3674,2224,10962,240304,12480,18634,243978,54192,46839,51075,13093,1150,14704,17612,4354,3204,70518,2000
58,"Madison, VA",123574,7259,11228,10388,201079,3507,2106,12453,304149,27352,24544,307656,89958,65894,40683,12535,2570,29458,16422,6246,3676,77694,2000
59,"Mathews, VA",61740,4241,6113,4774,168474,1439,585,6628,292045,17376,32103,293484,113362,82667,42343,9142,1060,17961,8500,2793,1733,35279,2000
60,"Mecklenburg, VA",458851,27272,53260,44708,418502,6764,1941,49626,680419,47079,21220,687183,9277,127493,141188,32384,2940,49020,75614,18723,15783,334217,2000
61,"Middlesex, VA",104273,6633,12653,9264,143968,1790,1005,11265,272354,15169,27602,274144,50960,79728,50448,9932,1101,16174,17285,4596,3495,70814,2000
62,"Montgomery + Radford, VA*",1704001,94959,228888,168316,1344443,4340,2835,179117,1995489,118041,20064,1999829,-180441,410007,245379,99671,7137,120876,313046,55379,48242,1270079,2000
63,"Nelson, VA",123720,8024,12024,10744,239678,1297,154,13396,375847,29350,26098,377144,129354,75719,61747,14451,1554,29504,17396,5137,3583,76820,2000
64,"New Kent, VA",94950,5889,10311,8690,290847,1025,683,10234,383398,14870,28398,384423,206131,56565,37011,13537,1143,15553,14656,4007,2864,64741,2000
65,"Newport News (Independent City), VA",4304326,225258,603002,548932,2728690,0,0,499724,4206837,128775,23341,4206837,-1075912,900414,577733,180236,6588,128775,877468,114228,107640,3298083,2000
66,"Norfolk (Independent City), VA",9047934,457432,1194831,985366,3524103,0,0,950115,5914807,344445,25171,5914807,-4573716,1563573,827131,234986,10947,344445,1687514,223161,212214,7015975,2000
67,"Northampton, VA",197000,10722,19839,16622,169325,30376,24249,19033,271583,19922,23183,301959,-8642,66956,65678,13025,1359,44171,28150,7178,5819,124679,2000
68,"Northumberland, VA",96136,6343,10544,7822,137791,3591,3272,10254,309194,18710,25577,312785,51909,114509,60485,12229,1428,21982,14455,4315,2887,59699,2000
69,"Nottoway, VA",216821,12631,29448,23018,203754,8782,7890,24140,333878,16324,21724,342660,11073,64032,74874,15773,1462,24214,40957,7919,6457,151650,2000
70,"Orange, VA",265299,16650,30127,26310,402319,6005,1709,29805,666833,24759,25897,672838,166825,160918,109601,25981,2180,26468,43282,10421,8241,195549,2000
71,"Page, VA",255856,13979,25290,21690,337617,31669,30248,24824,480579,29751,22128,512248,106585,86155,88476,23149,2410,59999,36135,9924,7514,159722,2000
72,"Patrick, VA",183725,11359,20829,16960,233898,3456,796,19839,359531,24025,18693,362987,70012,54589,74500,19418,1998,24821,29309,8253,6255,129595,2000
73,"Pittsylvania + Danville, VA*",1643783,97590,184567,164560,1582742,20198,14728,179870,2419551,125715,22192,2439749,118829,392684,464323,109939,8048,140443,266847,57034,48986,1236493,2000
74,"Portsmouth (Independent City), VA",2062048,108357,307085,223810,1372740,0,0,220262,2230344,52548,22229,2230344,-469046,444416,413188,100337,4659,52548,418990,52374,47715,1590510,2000
75,"Powhatan, VA",218364,12621,26862,20084,499094,1482,847,22663,635048,31744,28184,636530,303393,86975,50461,22585,4538,32591,36904,10283,5745,148869,2000
76,"Prince Edward, VA",277847,16828,33586,28086,206824,4174,3554,30871,339823,21125,17455,343997,-40152,63655,73518,19708,1524,24679,47629,10906,9382,205539,2000
77,"Prince George + Hopewell, VA*",1111185,57377,154212,117514,891020,756,317,116134,1325768,44946,23954,1326524,-104031,264978,170526,55377,2740,45263,212969,28751,26011,852953,2000
78,"Prince William, Manassas + Manassas Park, VA*",5047465,270624,514698,507938,8439551,2733,1272,524593,10674333,633693,32376,10677066,3916679,1689562,547953,329784,25360,634965,768667,141845,116485,3643833,2000
79,"Pulaski, VA",610797,35655,71089,53074,571523,5188,3929,62192,828157,36701,23712,833345,22918,112688,149134,35144,2330,40630,97626,19519,17189,472541,2000
80,"Rappahannock, VA",78512,4836,5263,5664,116549,598,-50,7668,203432,24878,29231,204030,45705,64118,23363,6980,1788,24828,8095,3451,1663,45589,2000
81,"Richmond (Independent City), VA",9080369,498507,1082323,916528,3790678,0,0,956771,6339429,633122,32215,6339429,-4332920,1599375,949376,196782,14672,633122,1540587,194011,179339,6906660,2000
82,"Richmond, VA",104458,6203,13262,9682,90500,1862,1131,11044,161402,11556,18546,163264,-2914,38991,33773,8803,759,12687,18103,3833,3074,73668,2000
83,"Roanoke (Independent City), VA",3163904,185237,344154,365988,1487245,0,0,368231,2388274,120191,25155,2388274,-1308428,425925,475104,94941,5297,120191,527148,87530,82233,2516565,2000
84,"Roanoke + Salem, VA*",2415368,134478,270677,246670,2315308,1217,378,257813,3474734,201141,31459,3475951,157753,795319,365324,110491,12796,201519,394012,74143,61347,1819837,2000
85,"Rockbridge, Buena Vista + Lexington, VA*",496653,29411,56306,50122,463260,4780,3637,54472,769212,40371,22737,773992,21079,183582,127150,34041,3227,44008,81367,18570,15343,371278,2000
86,"Rockingham + Harrisonburg, VA*",2148501,115952,235055,199762,1759600,94671,81568,215833,2412572,168105,23127,2507243,-173068,456314,291329,108414,10176,249673,334936,69394,59218,1563892,2000
87,"Russell, VA",313556,19148,39223,31896,325206,902,-184,35096,558761,37575,19133,559663,46746,78610,155847,29251,3262,37391,55171,12236,8974,220994,2000
88,"Scott, VA",154598,10490,17268,13330,251928,6530,5765,17155,424510,24043,18459,431040,114485,71159,107953,23351,2723,29808,23933,7483,4760,100857,2000
89,"Shenandoah, VA",509806,29675,54549,46198,567641,11613,9394,52774,852940,66397,24533,864553,110609,171940,124972,35240,4406,75791,77648,19691,15285,356367,2000
90,"Smyth, VA",512352,30116,63917,49102,431760,5019,3963,54667,677158,49855,20623,682177,-25925,105688,144729,33079,3697,53818,88468,19136,15439,370066,2000
91,"Southampton + Franklin, VA*",318408,18564,41861,31644,387949,12724,9970,34386,599654,12150,23771,612378,103927,113991,110438,25762,1606,22120,57683,11172,9566,238605,2000
92,"Spotsylvania + Fredericksburg, VA*",1819297,102518,188507,177262,2377681,204,-566,191149,3243534,213605,29263,3243738,749533,579078,286979,110848,9628,213039,277138,59880,50252,1329120,2000
93,"Stafford, VA",1077199,58096,129776,103346,2138752,293,102,109769,2771979,87330,29610,2772272,1171322,479549,153971,93625,4815,87432,181449,32924,28109,808318,2000
94,"Suffolk (Independent City), VA",798719,46142,94615,78070,1157560,9102,2593,85177,1690236,82208,26463,1699338,444018,309905,231873,64216,4335,84801,133650,26057,21722,580268,2000
95,"Surry, VA",122205,6692,16055,13628,101643,2831,1486,13506,147449,5488,21993,150280,-7056,25316,23321,6833,550,6974,22869,2605,2055,92362,2000
96,"Sussex, VA",136870,8136,18692,13504,154678,4080,2427,14888,240206,8208,19612,244286,32696,38671,50937,12456,671,10635,25444,4721,4050,100791,2000
97,"Tazewell, VA",536154,33622,66816,55286,528561,706,-120,61265,927144,49523,20889,927850,53672,148792,250497,44418,3066,49403,94459,20535,17469,392292,2000
98,Virginia,175309707,9662257,18152545,17957432,162731250,558176,383497,18640973,231911439,15410457,32715,232469615,6062516,48048351,21690014,7105817,645181,15793954,27131261,4399151,3753970,132384492,2000
99,"Virginia Beach (Independent City), VA",7538243,405450,829583,746148,9473425,3219,2165,778524,13807425,980222,32350,13810644,2713706,3302013,1035206,426918,34904,982387,1202657,234125,199221,5353199,2000
100,"Warren, VA",375830,21984,40556,35288,594223,1131,882,39628,843637,44696,26657,844768,258021,155943,94602,31690,2966,45578,58200,13884,10918,272052,2000
101,"Washington + Bristol, VA*",1216784,70733,139740,113126,986463,9069,5596,127296,1652950,122680,24256,1662019,-103025,386512,289044,68519,6904,128276,196303,42683,35779,892205,2000
102,"Westmoreland, VA",115206,7399,12246,9558,246705,6720,2956,12178,400888,22934,24490,407608,143677,88778,72125,16644,1604,25890,17025,5237,3633,72291,2000
103,"Wise + Norton, VA*",685363,40100,94940,84978,501853,-41,-126,82589,887317,38142,19292,887276,-100921,124865,260558,45993,1878,38016,137429,20776,18898,509918,2000
104,"Wythe, VA",373653,22370,47164,35916,374614,2777,1273,40328,577019,36748,20991,579796,41289,86427,118755,27621,2698,38021,65122,14564,11866,270510,2000
105,"York + Poquoson, VA*",712510,42132,86034,67596,1491980,475,35,75930,2184542,101164,31805,2185017,855400,526302,166735,68701,7516,101199,119832,27555,20039,491479,2000
0,"Accomack, VA",487580,27636,54803,46650,455005,22323,12773,50961,777625,62610,21195,799948,18386,177763,167180,37742,3340,75383,78128,17666,14326,334069,2001
1,"Albemarle + Charlottesville, VA*",3833477,213675,423427,381370,2786904,1357,-2095,404360,4679995,472518,37025,4681352,-642213,1481770,412678,126438,15765,470423,614112,99452,83687,2748942,2001
2,"Alexandria (Independent City), VA",5897249,320940,549618,634474,5051847,0,0,638177,6967583,472908,53215,6967583,-207225,1545806,369930,130932,14325,472908,866855,115345,101020,4557486,2001
3,"Alleghany + Covington, VA*",404909,24624,45332,45156,328523,-635,-872,47202,556220,29871,23742,555585,-29184,97686,129376,23401,1515,28999,67910,11987,10472,308000,2001
4,"Amelia, VA",105195,6015,10031,9500,201317,7838,4921,10765,282279,18880,25269,290117,106887,46360,42440,11481,1513,23801,14781,4278,2765,66613,2001
5,"Amherst, VA",371596,22581,43590,38834,482957,-364,-1138,41998,711346,34793,22251,710982,153359,105292,122733,31953,2616,33655,63007,12816,10200,274934,2001
6,"Appomattox, VA",142222,8670,14667,13568,233500,496,209,15454,338953,24436,24582,339449,106732,50279,55670,13809,1552,24645,21451,5399,3847,96126,2001
7,"Arlington, VA",13063454,670065,1383118,1370290,7877980,0,0,1355210,10581317,1038421,55578,10581317,-3830264,2244070,459267,190386,20982,1038421,2068263,199758,178776,9956770,2001
8,"Augusta, Staunton + Waynesboro, VA*",1880561,111195,218567,198428,1788473,35512,28436,210409,2744998,124418,25369,2780510,118321,548568,443469,109602,10401,152854,317781,60313,49912,1409926,2001
9,"Bath, VA",93033,5512,9484,10078,82729,915,564,10551,145254,11228,29251,146169,247,40155,23285,4997,538,11792,14523,2956,2418,66718,2001
10,"Bedford, VA*",683113,43265,66057,66452,1277207,-384,-1960,76491,1975422,117366,29310,1975038,670585,428090,269741,67385,6991,115406,99283,25190,18199,468424,2001
11,"Bland, VA",74166,4575,10032,7478,82902,41,-615,8314,135952,7630,19778,135993,17050,22609,30482,6876,872,7015,13771,2756,1884,53380,2001
12,"Botetourt, VA",388705,23104,37286,38370,674669,-398,-1914,42289,948384,66612,30831,947986,328253,165056,108261,30748,3162,64698,56471,12651,9489,267536,2001
13,"Brunswick, VA",170112,10580,21016,18084,195394,3367,1379,19622,346085,11921,19063,349452,44904,66796,87262,18331,1216,13300,30058,6650,5434,126754,2001
14,"Buchanan, VA",322937,21771,39139,38530,236436,-19,-32,41036,538644,9420,20325,538625,-45465,115975,186214,26501,1431,9388,58404,10001,8570,255145,2001
15,"Buckingham, VA",135056,8063,16268,12536,175951,3096,2568,14331,283352,19144,18064,286448,55226,48346,62151,15857,1215,21712,22536,4741,3526,90808,2001
16,"Campbell + Lynchburg, VA*",2882157,165808,305800,320140,1831478,2448,792,325878,2922909,148040,25142,2925357,-724801,516335,577544,116352,9168,148832,465870,83732,74564,2267455,2001
17,"Caroline, VA",205338,12230,24197,20228,409026,142,-1341,22344,589987,31870,26621,590129,226032,99318,81785,22168,1758,30529,34311,7178,5420,140498,2001
18,"Carroll + Galax, VA*",484833,29798,52541,52154,456388,3492,2135,55875,767977,55710,21298,771469,27430,122992,192089,36223,3152,57845,78618,18785,15633,348370,2001
19,"Charles City, VA",66959,4041,6921,6010,139088,600,-121,7046,199652,14392,28805,200252,79175,36307,24857,6952,437,14271,9926,2057,1620,42762,2001
20,"Charlotte, VA",118935,7932,14097,12614,143920,685,-1449,14239,255528,15109,20528,256213,39224,47963,64330,12481,1810,13660,20404,5615,3805,84871,2001
21,"Chesapeake (Independent City), VA",3443885,194091,358562,364616,4477074,3892,-2493,376399,6088081,311257,30110,6091973,1409588,1039322,575577,202325,14246,308764,540870,107952,93706,2594251,2001
22,"Chesterfield, VA",5229989,288020,544216,534004,7005103,1782,169,555022,9170691,554235,34542,9172473,2330136,1497706,669664,265544,23763,554404,811218,140512,116749,3864367,2001
23,"Clarke, VA",193346,11079,17075,18438,298399,1897,-1012,20298,447423,39767,34934,449320,125351,109876,41045,12862,2263,38755,26294,6777,4514,128297,2001
24,"Craig, VA",24851,1657,2831,1930,83061,755,463,2622,120529,6946,23988,121284,60832,18995,19228,5056,568,7409,3796,1164,596,13646,2001
25,"Culpeper, VA",615054,35457,60978,59762,713266,-5735,-10975,65338,1032605,104115,29091,1026870,163550,193591,120013,35299,4560,93140,90859,18632,14072,431055,2001
26,"Cumberland, VA",56303,3062,5382,4362,136546,7550,6519,5243,194222,11631,22414,201772,85486,29845,35381,9002,704,18150,7563,2171,1467,30590,2001
27,"Dickenson, VA",111965,8293,14323,12190,135039,-4442,-4484,14388,295129,12475,17903,290687,37462,44917,110731,16237,814,7991,20418,4304,3490,83556,2001
28,"Dinwiddie, Colonial Heights + Petersburg, VA*",1250627,74533,147806,133414,1246311,7021,5383,141240,2059225,84834,27605,2066246,136924,367120,452815,74851,5656,90217,214513,41070,35414,945897,2001
29,"Essex, VA",126171,7454,13236,12480,144935,2448,1763,13694,242241,18457,24484,244689,32458,50915,48839,9994,918,20220,19476,5094,4176,86475,2001
30,"Fairfax, Fairfax City + Falls Church, VA*",43171724,2370793,3457728,4326234,41396217,1185,-586,4533910,54685196,4523042,53416,54686381,2758403,11085808,2204356,1023782,118321,4522456,5620845,750122,631801,33028423,2001
31,"Fauquier, VA",828907,47059,72323,78050,1696341,4366,-2140,86084,2408829,154614,42428,2413195,953518,562736,154118,56878,7512,152474,111348,26689,19177,565085,2001
32,"Floyd, VA",112270,6788,9715,8768,198118,5231,881,11172,307211,35320,22181,312442,97020,59838,54486,14086,2263,36201,14099,5079,2816,61970,2001
33,"Fluvanna, VA",162724,10259,16929,14412,357873,533,92,17465,533151,38045,25381,533684,212614,102767,73044,21027,2184,38137,24135,6174,3990,100452,2001
34,"Franklin, VA",546988,32102,48518,49438,837647,6007,2437,56821,1233379,133010,25616,1239386,347480,219907,181832,48384,5128,135447,73237,19372,14244,338304,2001
35,"Frederick + Winchester, VA*",1996175,113153,199850,208198,1803858,2955,-1588,217252,2537430,209377,29683,2540385,24935,458614,277913,85584,8966,207789,303949,58726,49760,1484437,2001
36,"Giles, VA",230868,14154,29920,24188,240258,862,741,26248,385178,20857,22980,386040,35638,61175,84607,16799,1593,21598,42014,7231,5638,167256,2001
37,"Gloucester, VA",317443,19121,35153,30108,656316,701,258,34175,984307,53505,28263,985008,373048,214434,114258,34852,3128,53763,50207,12698,9570,213473,2001
38,"Goochland, VA",665006,37028,56145,51508,599879,1295,425,62782,889705,96692,51652,891000,-2345,228207,62914,17250,2129,97117,81899,10932,8803,485990,2001
39,"Grayson, VA",105293,7042,10629,8432,207313,1342,-456,11258,348715,32184,21154,350057,113278,64613,78131,16548,2354,31728,14845,5079,2725,58720,2001
40,"Greene, VA",149840,8803,16966,13578,284094,2037,1715,15592,381135,28153,24262,383172,149846,55766,43312,15793,1462,29868,23755,5447,3985,96217,2001
41,"Greensville + Emporia, VA*",295766,17545,36257,32986,196210,5060,4237,34038,320464,9084,18901,325524,-65518,53640,75674,17223,323,13321,52750,9432,9109,229695,2001
42,"Halifax, VA",494914,30036,57998,53360,471445,3920,329,56716,775857,40469,21073,779777,33247,131523,176809,37003,3156,40798,84678,17844,14688,369438,2001
43,"Hampton (Independent City), VA",3168660,166401,414689,355952,2625016,0,0,344377,3873246,115413,27004,3873246,-199267,754878,493352,143432,7401,115413,592665,81643,74242,2460582,2001
44,"Hanover, VA",1724306,99092,159299,179444,2314010,114,-5522,188814,3087313,207238,34751,3087427,778518,502723,270694,88845,9379,201716,249021,51062,41683,1273569,2001
45,"Henrico, VA",9017258,496531,836435,896662,7671761,254,-1093,944862,10535044,1097128,39352,10535298,-400635,2027441,836096,267722,25374,1096035,1284766,203360,177986,6636457,2001
46,"Henry + Martinsville, VA*",1146115,71116,124433,125626,966764,2008,1418,133929,1675530,99850,23117,1677538,-45422,355713,355061,72566,5081,101268,187246,40412,35331,857601,2001
47,"Highland, VA",28436,1501,2279,1664,33589,5232,4790,2333,59830,8433,25716,65062,7486,20334,11139,2530,696,13223,3111,1341,645,12102,2001
48,"Isle of Wight, VA",544363,31211,56685,53712,628414,4745,2316,58067,881458,41912,29423,886203,142118,143963,113826,30119,2351,44228,83541,14973,12622,416594,2001
49,"James City + Williamsburg, VA*",1540623,86932,160444,158856,1408442,157,-296,166360,2337930,153832,37827,2338087,34179,687719,241926,61810,7110,153536,239872,50418,43308,1147215,2001
50,"King George, VA",647439,31598,90493,70800,348997,786,532,66998,524100,21029,30631,524886,-231444,131376,44513,17136,1597,21561,125893,12111,10514,499985,2001
51,"King William, VA",169319,10315,17315,17116,282254,500,-1583,18873,398839,20127,29775,399339,131808,68688,48397,13412,1163,18544,25873,5275,4112,124902,2001
52,"King and Queen, VA",50416,3492,6024,5006,110290,2007,1200,5995,162685,6774,24927,164692,65869,27407,26995,6607,598,7974,8527,1918,1320,33915,2001
53,"Lancaster, VA",182108,11570,17089,16562,162426,801,683,19851,395416,36820,34753,396217,169,161087,72704,11401,1728,37503,25370,6549,4821,119235,2001
54,"Lee, VA",182989,12235,24358,18618,231029,3049,2385,21544,448148,17865,19348,451197,69584,70686,149482,23320,2401,20250,33667,8000,5599,129072,2001
55,"Loudoun, VA",7557556,430092,537702,611154,6591508,3001,-1903,735669,8213528,425620,43265,8216529,-230379,1319869,305152,189910,21526,423717,843279,125707,104181,6290560,2001
56,"Louisa, VA",333444,19199,40526,30922,508836,31,-1114,34660,716805,56354,27235,716836,210052,111697,96303,26320,2653,55240,55987,9097,6444,222217,2001
57,"Lunenburg, VA",110876,6971,13355,11390,149755,1577,-112,12666,256598,9486,19784,258175,51545,52190,56230,13050,963,9374,19050,4209,3246,82452,2001
58,"Madison, VA",140475,8180,12389,12640,218742,2118,430,14500,327342,35245,26059,329460,92767,67626,43092,12643,1760,35675,18709,5602,3842,86091,2001
59,"Mathews, VA",70316,4781,5734,5112,179817,664,-306,7337,316143,25657,34643,316807,116838,90772,46218,9145,1244,25351,8290,2993,1749,36675,2001
60,"Mecklenburg, VA",450711,27269,56595,47866,411046,751,-4628,51202,709562,41712,21906,710313,11537,140242,159025,32425,2782,37084,80528,17849,15067,333099,2001
61,"Middlesex, VA",119443,7489,13502,10372,158618,1178,244,12675,293815,26115,29479,294993,51850,82904,53471,10007,1476,26359,18688,4959,3483,74396,2001
62,"Montgomery + Radford, VA*",1796651,100062,237487,187134,1401180,3616,1692,193629,2103830,134132,20778,2107446,-201842,435201,271065,101429,8001,135824,331054,56015,48014,1329773,2001
63,"Nelson, VA",132140,8638,12566,11744,247313,373,-1038,14510,396776,34358,27397,397149,129683,82054,67782,14496,2362,33320,18438,6000,3638,80382,2001
64,"New Kent, VA",124870,7524,11557,11028,330387,659,236,13038,433386,31332,31280,434045,218555,61671,41987,13876,1564,31568,17071,4755,3191,76231,2001
65,"Newport News (Independent City), VA",4580421,246808,585723,500452,2950256,0,0,497034,4487199,183787,24672,4487199,-1133131,906932,630011,181873,9981,183787,835949,115328,105347,3560685,2001
66,"Norfolk (Independent City), VA",10031038,503371,1271339,1096270,4108137,0,0,1051506,6504765,805736,27506,6504765,-4871395,1487197,909431,236489,12324,805736,1819474,225938,213614,7405828,2001
67,"Northampton, VA",196463,10723,18874,17016,171889,29008,21276,19231,286850,27771,24594,315858,-5343,72238,71731,12843,1447,49047,27382,6959,5512,120034,2001
68,"Northumberland, VA",103002,6935,9874,8950,143472,2639,2303,11410,327987,22686,27014,330626,51880,120715,66439,12239,1377,24989,14349,4271,2894,63664,2001
69,"Nottoway, VA",214852,12708,29379,24292,203315,8500,7476,24854,352460,11903,22775,360960,13317,69294,88351,15849,1340,19379,41525,7680,6340,153948,2001
70,"Orange, VA",296363,18762,28810,28468,451247,621,-5121,32996,747070,61595,28288,747691,187880,174206,122238,26431,3244,56474,43044,11279,8035,196845,2001
71,"Page, VA",275997,14803,25970,24896,362867,36005,34269,27251,514092,41804,23741,550097,114121,91124,96106,23171,2258,76073,38418,9606,7348,161506,2001
72,"Patrick, VA",198643,12389,21512,21288,240308,2367,-1292,23033,387138,25374,20189,389505,64698,63653,85544,19293,2237,24082,32156,8833,6596,142405,2001
73,"Pittsylvania + Danville, VA*",1618228,97271,179304,175030,1546617,11077,4648,184786,2486901,129984,22823,2497978,113175,429853,521508,109452,7828,134632,266819,55303,47475,1216777,2001
74,"Portsmouth (Independent City), VA",2071275,110067,302330,232496,1423715,0,0,226315,2362406,53778,23823,2362406,-421245,488770,449921,99166,4791,53778,418578,51498,46707,1598919,2001
75,"Powhatan, VA",246213,14225,26015,22228,539032,957,190,25339,690785,50040,29959,691742,318158,92722,59988,23090,2171,50230,37129,7941,5770,158854,2001
76,"Prince Edward, VA",286590,17451,33152,30420,216981,2169,1461,32661,369257,27972,18819,371426,-36948,72876,81569,19737,1703,29433,48362,10930,9227,208795,2001
77,"Prince George + Hopewell, VA*",1149085,59552,163183,127690,917895,-276,-776,123397,1375090,46360,24668,1374814,-107793,267690,189229,55733,2595,45584,227028,28054,25459,876473,2001
78,"Prince William, Manassas + Manassas Park, VA*",5507760,295636,534532,572186,9033214,1105,-691,581729,11484578,647001,33296,11485683,4107183,1823537,628932,344961,29004,646310,820625,150702,121698,4040825,2001
79,"Pulaski, VA",581858,34027,64707,64142,561822,4440,2819,66098,844246,44968,24165,848686,46062,119724,167140,35120,2514,47787,96778,17781,15267,437293,2001
80,"Rappahannock, VA",82047,5041,5478,5584,129694,-14,-855,7833,226170,29823,31599,226156,55480,69469,26993,7157,1388,28968,8270,3037,1649,44809,2001
81,"Richmond (Independent City), VA",9271833,509823,1083449,945736,3894220,0,0,982691,6590531,661575,33357,6590531,-4394922,1663915,1032396,197575,11797,661575,1556317,187731,175934,7053941,2001
82,"Richmond, VA",107756,6529,13453,10906,91168,1142,364,11982,166063,9874,18737,167205,-4606,39499,36538,8924,774,10238,18906,3894,3120,78612,2001
83,"Roanoke (Independent City), VA",3269191,190783,359234,384580,1540758,0,0,383073,2502156,180490,26358,2502156,-1345360,451370,510028,94931,7096,180490,551524,88623,81527,2537177,2001
84,"Roanoke + Salem, VA*",2531897,139840,269450,263496,2458803,605,-443,271588,3703167,265724,33540,3703772,198494,836049,408920,110428,10127,265281,401198,69235,59108,1865418,2001
85,"Rockbridge, Buena Vista + Lexington, VA*",527149,31287,56481,56828,491082,3891,2486,59701,816899,60713,24010,820790,23634,187794,141914,34186,3691,63199,84895,18933,15242,379055,2001
86,"Rockingham + Harrisonburg, VA*",2383158,124818,246973,231046,1944666,152733,137320,240341,2590794,229582,24869,2743527,-198151,475300,323561,110317,11466,366902,362496,71676,60210,1653760,2001
87,"Russell, VA",287421,18478,35923,32372,310326,-3183,-4520,34664,570669,25760,19568,567486,57569,86624,170536,29001,2844,21240,52109,11085,8241,214072,2001
88,"Scott, VA",163925,11438,17283,15802,264519,3699,2729,19339,460514,26153,20072,464213,119933,79443,120251,23127,2830,28882,25184,7618,4788,109859,2001
89,"Shenandoah, VA",564496,32482,53743,52294,630438,13018,10614,58629,946586,106439,26778,959604,124571,187632,141534,35835,4825,117053,79890,20129,15304,367553,2001
90,"Smyth, VA",514431,30488,61823,53252,432953,4427,3210,57114,706192,53267,21579,710619,-24364,117273,160393,32931,3432,56477,88449,18376,14944,369505,2001
91,"Southampton + Franklin, VA*",323998,19144,39304,32576,401499,13643,10572,35432,638393,23236,25421,652036,112933,130090,120447,25649,1862,33808,55592,11019,9157,234598,2001
92,"Spotsylvania + Fredericksburg, VA*",2046979,115207,200393,211472,2599765,-1268,-2249,220943,3574916,232540,30705,3573648,773729,644528,329355,116387,9880,230291,306129,61728,51848,1510559,2001
93,"Stafford, VA",1148073,61510,122467,112324,2390379,-405,-644,117672,3121660,172769,31746,3121255,1359978,550584,180292,98320,8122,172125,178629,35469,27347,797319,2001
94,"Suffolk (Independent City), VA",858951,50202,95860,89400,1237521,2394,-5647,94902,1842016,88652,27757,1844410,473472,349207,257682,66448,4744,83005,140560,27503,22759,635386,2001
95,"Surry, VA",136663,7285,22880,13864,107099,1979,405,14217,157871,4940,23408,159850,-15347,26846,25905,6829,497,5345,29812,2594,2097,101506,2001
96,"Sussex, VA",135979,8320,18492,14578,151258,2411,597,15609,245111,5911,20094,247522,30888,41523,54741,12318,625,6508,25781,4679,4054,103690,2001
97,"Tazewell, VA",589367,36997,66975,59548,574436,1399,426,66771,1013244,79918,23068,1014643,51840,168945,271262,43985,3385,80344,96749,21034,17649,412274,2001
98,Virginia,184666498,10200996,18740497,18925970,171577224,477685,268221,19663981,244275923,17458220,34001,244753608,6574707,49039189,24137195,7198362,656978,17726441,28203482,4417451,3760473,138736575,2001
99,"Virginia Beach (Independent City), VA",7563721,408125,848310,795354,9610891,2724,1436,805802,13987668,704833,32658,13990392,2852972,3216702,1162799,428396,34593,706269,1245987,230814,196221,5611465,2001
100,"Warren, VA",415642,24043,41962,40996,655421,1292,1007,44541,917135,69203,28503,918427,284320,157398,105608,32222,3500,70210,62460,14304,10804,282972,2001
101,"Washington + Bristol, VA*",1212359,73017,145619,131302,961627,7849,3601,138668,1662035,54024,24282,1669884,-112064,380665,327592,68771,7534,57625,211270,42679,35145,943464,2001
102,"Westmoreland, VA",113166,7596,11620,10180,245186,4531,131,12686,417879,23557,25573,422410,144706,97270,79954,16518,1657,23688,16710,5139,3482,72768,2001
103,"Wise + Norton, VA*",711066,42677,84333,79946,518721,-361,-461,82650,943112,45704,20626,942751,-109695,135956,288074,45706,2743,45243,124306,22034,19291,541517,2001
104,"Wythe, VA",375120,22919,42209,38510,376420,2374,488,42174,604013,44291,21982,606387,43474,96152,133815,27585,3049,44779,61464,14601,11552,268877,2001
105,"York + Poquoson, VA*",794112,46411,92592,77420,1610416,-602,-1157,85121,2312816,126685,32950,2312214,901425,513332,188466,70174,4723,125528,131302,25339,20616,537282,2001
0,"Accomack, VA",518277,29880,62183,50106,479530,19799,8144,54933,812497,65635,22309,832296,16186,178914,173852,37308,3479,73779,87236,18177,14698,357262,2002
1,"Albemarle + Charlottesville, VA*",4005988,224760,467673,395844,2915232,1967,-2241,422682,4770898,505122,37405,4772865,-668074,1428836,428797,127599,16011,502881,665595,100170,84159,2837512,2002
2,"Alexandria (Independent City), VA",6188214,340408,610472,664968,5142690,0,0,672892,7023241,499138,53771,7023241,-372632,1503137,377414,130614,14684,499138,942956,114482,99798,4746120,2002
3,"Alleghany + Covington, VA*",418759,25980,49222,46774,340531,-1101,-1346,49367,567792,31605,24388,566691,-28861,90502,135658,23236,1421,30259,72609,11799,10378,315891,2002
4,"Amelia, VA",98772,6206,10498,9482,199202,701,-2543,10947,290282,20492,25215,290983,111377,45775,46006,11540,1578,17949,15239,4316,2738,65584,2002
5,"Amherst, VA",391758,24126,48365,41094,487778,-1002,-1957,44673,721825,37052,22685,720823,140693,101525,131520,31775,2625,35095,68912,13168,10543,287751,2002
6,"Appomattox, VA",142147,8907,15418,13494,232209,-541,-831,15654,339715,25831,24698,339174,105716,46651,60314,13733,1513,25000,22165,5255,3742,94982,2002
7,"Arlington, VA",13366353,691667,1507965,1401502,8121059,0,0,1392418,10825744,1068316,56937,10825744,-3852876,2233104,471581,190137,21178,1068316,2208716,195090,173912,10089321,2002
8,"Augusta, Staunton + Waynesboro, VA*",1926429,115841,229764,201000,1853732,20388,12014,216341,2826068,157563,25775,2846456,143644,518908,473816,110436,10610,169577,330264,59698,49088,1426588,2002
9,"Bath, VA",95221,5719,9985,9740,84476,1510,1065,10589,147568,12093,29744,149078,-156,39913,24689,5012,540,13158,14855,3004,2464,67208,2002
10,"Bedford, VA*",714401,46373,72036,69850,1280341,-1295,-3221,81298,2010698,126012,29594,2009403,647238,442413,286649,67900,7125,122791,106961,25358,18233,484649,2002
11,"Bland, VA",76323,4860,10700,7790,84534,-890,-1747,8755,140239,8063,20385,139349,16966,22419,32396,6836,870,6316,14595,2680,1810,55412,2002
12,"Botetourt, VA",386884,23546,39799,37668,662365,-2078,-3982,42380,938434,71030,30055,936356,317861,160836,113155,31155,3200,67048,58633,12185,8985,261203,2002
13,"Brunswick, VA",175604,11065,22264,18738,201534,4402,2168,20434,348847,12658,19371,353249,46364,61859,89856,18236,1140,14826,31633,6517,5377,129145,2002
14,"Buchanan, VA",315952,22109,37356,36524,235333,73,61,40371,540685,11368,20562,540758,-40248,113382,192043,26299,1313,11429,55618,9639,8326,248905,2002
15,"Buckingham, VA",135354,8435,16827,12926,179079,-143,-548,14898,290601,20055,18259,290458,58623,48172,63207,15908,1197,19507,23290,4648,3451,92557,2002
16,"Campbell + Lynchburg, VA*",2844760,167021,318432,311886,1841467,1769,-215,322964,2959235,157027,25319,2961004,-680329,509887,609650,116948,9258,156812,474375,80753,71495,2213573,2002
17,"Caroline, VA",201988,12403,24764,19684,420287,-1023,-2922,22245,603055,34192,26679,602032,240544,93380,88365,22566,1797,31270,34606,7012,5215,136112,2002
18,"Carroll + Galax, VA*",500059,31447,57583,53080,466259,2043,354,57987,780096,58933,21634,782139,24187,115805,200075,36153,3145,59287,84123,18564,15419,356649,2002
19,"Charles City, VA",71521,4441,7765,6592,137559,-767,-1578,7737,204914,14970,29039,204147,73775,40355,26233,7030,460,13392,11061,2191,1731,47068,2002
20,"Charlotte, VA",120469,8230,14932,12686,146128,1929,-525,14573,258370,16003,20675,260299,40232,45591,68580,12590,1783,15478,21275,5479,3696,83716,2002
21,"Chesapeake (Independent City), VA",3607423,206636,389561,380942,4780526,6943,-607,397107,6473472,330901,31771,6480415,1570210,1080943,618946,203970,14594,330294,580032,107987,93393,2697097,2002
22,"Chesterfield, VA",5459635,305463,594750,556206,7195848,2884,941,583566,9460222,578926,34953,9463106,2319779,1542555,724703,270741,24684,579867,872853,143308,118624,4006915,2002
23,"Clarke, VA",203584,11851,18865,19348,299268,1714,-2042,21525,447418,42466,34682,449132,117209,106697,43167,12950,2183,40424,28539,6759,4576,134621,2002
24,"Craig, VA",27388,1832,3306,2160,87157,746,396,2912,125499,7441,24925,126245,62681,18930,20158,5065,561,7837,4386,1202,641,15165,2002
25,"Culpeper, VA",618919,36154,62497,59756,743815,-2176,-8942,66032,1058654,110174,28856,1056478,190928,185612,127051,36612,4782,101232,92375,18534,13752,425312,2002
26,"Cumberland, VA",55892,3420,6029,4938,134896,2237,1039,5889,199311,12283,22165,201548,84893,30244,36408,9093,730,13322,8498,2248,1518,34072,2002
27,"Dickenson, VA",117007,8942,14919,12654,139412,-5630,-5671,15269,304025,13834,18564,298395,37674,43184,115799,16074,782,8163,21246,4466,3684,87598,2002
28,"Dinwiddie, Colonial Heights + Petersburg, VA*",1286819,77785,157691,136166,1318900,9096,7280,145868,2141679,90071,28728,2150775,177949,358933,472942,74867,5825,97351,225774,40941,35116,963694,2002
29,"Essex, VA",130894,8004,14668,12988,150467,233,-562,14498,248526,19861,24693,248759,34071,48646,49646,10074,1016,19299,21162,5143,4127,90433,2002
30,"Fairfax, Fairfax City + Falls Church, VA*",43349256,2411553,3711361,4333106,41946597,6756,4465,4578106,55284188,4651062,53638,55290944,3175447,10992265,2352082,1030816,122156,4655527,5877914,739436,617280,32815815,2002
31,"Fauquier, VA",917995,53010,84164,87914,1724887,2129,-5800,96967,2457947,163528,42037,2460076,903859,571892,163297,58522,7839,157728,128121,28556,20717,632146,2002
32,"Floyd, VA",121131,7253,10641,9278,210054,8717,3343,11892,316454,37259,22945,325171,100815,55880,59237,14172,2202,40602,15280,5227,3025,65249,2002
33,"Fluvanna, VA",171458,11083,18753,15362,373995,-808,-1412,18764,556033,40233,25328,555225,221301,103757,77473,21921,2288,38821,26434,6359,4071,106203,2002
34,"Franklin, VA",564697,34137,52001,50966,865564,1914,-2134,59620,1284142,141280,26157,1286056,360487,221234,199258,49167,5283,139146,77484,19240,13957,348067,2002
35,"Frederick + Winchester, VA*",2112866,122249,217622,219676,1902468,-123,-5365,232087,2632543,221275,29943,2632420,21689,433297,296655,87915,9249,215910,327460,59423,50174,1569496,2002
36,"Giles, VA",233427,14558,31408,24150,249914,1122,988,26633,392808,22309,23448,393930,43120,57204,86812,16800,1569,23297,43483,7064,5495,166647,2002
37,"Gloucester, VA",338477,20743,38814,32246,694555,625,83,36866,1028979,56543,29331,1029604,392944,214575,120474,35103,3058,56626,54937,12966,9908,226914,2002
38,"Goochland, VA",705805,40228,58951,56548,591127,1269,219,68502,889996,95333,50611,891265,-46176,234102,66036,17610,2197,95552,87225,11209,9012,523028,2002
39,"Grayson, VA",114833,7734,12233,9210,220513,1657,-538,12339,361126,34705,21910,362783,118019,62246,80024,16558,2213,34167,16838,5102,2889,63828,2002
40,"Greene, VA",161786,9487,20518,14392,294616,2147,1739,16683,396703,30218,24457,398850,149513,55404,48830,16308,1556,31957,27714,5724,4168,102115,2002
41,"Greensville + Emporia, VA*",314989,18897,39884,34814,211724,6791,5933,36304,333340,9537,19576,340131,-66961,51562,76845,17375,296,15470,57291,9764,9468,242228,2002
42,"Halifax, VA",503780,30905,59831,52674,482540,11864,7984,57242,785873,44527,21608,797737,36002,124013,191184,36919,3100,52511,86168,17051,13951,365101,2002
43,"Hampton (Independent City), VA",3387970,177941,478079,377864,2709328,0,0,366873,4010663,121067,28275,4010663,-311769,768242,533093,141844,7548,121067,667011,80698,73150,2599892,2002
44,"Hanover, VA",1813513,106022,174879,187638,2397162,4006,-3281,199841,3201503,220717,35083,3205509,783490,519175,289172,91370,9846,217436,268698,53013,43167,1327379,2002
45,"Henrico, VA",8931624,502683,855019,893512,7750780,701,-980,949439,10679566,1036931,39468,10680267,-231405,2054816,874671,270608,26313,1035951,1301775,200486,174173,6593898,2002
46,"Henry + Martinsville, VA*",1124008,71419,125795,120496,958840,1738,1081,131667,1727317,108418,24064,1729055,-33501,370282,399933,71853,5274,109499,186043,37515,32241,828466,2002
47,"Highland, VA",28051,1562,2424,1676,33178,4317,3809,2400,61049,8808,26680,65366,7527,20936,11252,2450,677,12617,3262,1316,639,12172,2002
48,"Isle of Wight, VA",557635,32621,61144,55444,667213,3314,579,60343,925293,44401,30449,928607,169921,142643,118751,30497,2481,44980,88866,14875,12394,423789,2002
49,"James City + Williamsburg, VA*",1630946,93298,177275,166844,1513106,385,-225,176720,2451169,162483,38576,2451554,58880,678201,260247,63551,7557,162258,260697,51464,43907,1207991,2002
50,"King George, VA",683754,33810,100207,74606,386343,24,-252,71113,571732,22134,32272,571756,-226298,137257,48156,17717,1632,21882,137510,12148,10516,524362,2002
51,"King William, VA",172399,10653,18203,17324,289341,547,-2254,19315,402615,22030,29668,403162,136257,64877,48944,13589,1251,19776,26865,5287,4036,125758,2002
52,"King and Queen, VA",51962,3741,6487,5270,111985,1016,11,6376,166378,7363,25417,167394,66399,26742,28667,6586,593,7374,9122,1883,1290,35466,2002
53,"Lancaster, VA",192449,12537,18662,17530,168481,130,24,21302,401980,38590,35220,402110,-2666,157895,75734,11417,1699,38614,27427,6709,5010,126408,2002
54,"Lee, VA",205549,13609,29384,20796,250455,3428,2688,24007,472155,18841,19589,475583,68913,70830,154298,24278,2275,21529,39782,8143,5868,144238,2002
55,"Loudoun, VA",6538317,365888,600756,649940,6630931,17945,11755,690858,8342724,459765,41076,8360669,783472,1379812,349926,203543,23410,471520,925726,130096,106686,5141071,2002
56,"Louisa, VA",348821,20497,44466,32382,532074,-425,-1988,36688,742351,59590,27451,741926,219941,106417,103435,27027,2766,57602,60657,9540,6774,230562,2002
57,"Lunenburg, VA",114423,7232,14356,11648,150732,2475,497,13056,253179,10104,19502,255654,49365,48488,56434,13109,908,10601,20180,4188,3280,83642,2002
58,"Madison, VA",144935,8680,13553,12936,224453,730,-1316,15148,336462,37767,26265,337192,94666,64625,48114,12838,1751,36451,20021,5493,3742,88463,2002
59,"Mathews, VA",74096,5124,6319,5358,184855,1128,2,7803,324962,27001,35763,326090,118562,93221,48014,9118,1274,27003,8998,3037,1763,38095,2002
60,"Mecklenburg, VA",439368,27161,55096,45440,405159,5960,-107,49881,703388,44620,21807,709348,15672,133136,171053,32528,2732,44513,77816,16564,13832,317039,2002
61,"Middlesex, VA",128939,8175,14910,11258,166889,1189,57,13804,304607,27777,30491,305796,51754,84646,54261,10029,1523,27834,20539,5099,3576,80566,2002
62,"Montgomery + Radford, VA*",1917143,107388,267985,199320,1481550,3468,970,207048,2195356,143248,21619,2198824,-228545,432528,284746,101709,8193,144218,367645,57362,49169,1405280,2002
63,"Nelson, VA",140675,9320,13789,12412,253234,896,-849,15526,404110,36158,27714,405006,128085,80823,70949,14614,2164,35309,19995,5879,3715,85371,2002
64,"New Kent, VA",141662,8630,13996,12740,356356,253,-287,15000,462089,34171,32578,462342,229694,61656,44330,14192,1701,33884,20366,5124,3423,87412,2002
65,"Newport News (Independent City), VA",4620584,251952,623681,500174,3088653,0,0,502039,4663090,196871,25473,4663090,-1029892,912358,662079,183061,10158,196871,873768,115777,105619,3549945,2002
66,"Norfolk (Independent City), VA",10853225,544108,1469614,1176618,4385852,0,0,1132417,6794320,881078,28110,6794320,-5334956,1471690,936778,241704,12595,881078,2057923,229176,216581,7914224,2002
67,"Northampton, VA",210266,11243,20385,17782,184639,36422,26476,20134,291345,28448,25750,327767,-5493,69409,73719,12729,1491,54924,29276,6995,5504,126066,2002
68,"Northumberland, VA",104706,7417,10742,9248,145163,-78,-436,12041,337351,24281,27088,337273,52498,123051,69059,12451,1419,23845,15366,4274,2855,65495,2002
69,"Nottoway, VA",219762,13228,32148,24836,206434,5764,4561,25646,357940,12870,23084,363704,12318,64881,92389,15756,1317,17431,44566,7700,6383,157765,2002
70,"Orange, VA",330065,21036,32758,31624,487524,3381,-4288,36848,784138,66172,29030,787519,194307,169868,130127,27128,3252,61884,48570,11643,8391,219611,2002
71,"Page, VA",263247,15606,28312,25110,353261,14967,12879,28161,531708,44572,23498,546675,118175,89832,103582,23265,2245,57451,40867,9484,7239,164929,2002
72,"Patrick, VA",199037,12597,22996,20548,239259,4647,83,22871,394130,27156,20910,398777,63093,66075,93443,19071,2182,27239,33270,8669,6487,138528,2002
73,"Pittsylvania + Danville, VA*",1689473,102340,194402,177956,1593640,28126,20683,191318,2567367,139125,23833,2595493,95485,445822,556031,108904,7797,159808,283380,55187,47390,1246285,2002
74,"Portsmouth (Independent City), VA",2324252,122936,357432,260124,1535124,0,0,252998,2498469,57753,25418,2498469,-536130,497844,465501,98297,4925,57753,487494,53336,48411,1779005,2002
75,"Powhatan, VA",258183,15175,27873,23466,549077,393,-550,26908,700769,53270,29088,701162,317802,86813,65272,24105,2195,52720,39606,8018,5823,165857,2002
76,"Prince Edward, VA",297423,18316,36187,31416,226052,1367,547,34024,382036,29898,18920,383403,-37347,71660,85691,20264,1706,30445,51895,10674,8968,215083,2002
77,"Prince George + Hopewell, VA*",1220440,63438,183030,134512,956184,564,-16,130694,1412356,50095,24986,1412920,-133562,256511,200225,56549,2693,50079,250286,28361,25668,920075,2002
78,"Prince William, Manassas + Manassas Park, VA*",5922394,322313,601696,616272,9512117,2230,-40,630449,12058750,684344,33617,12060980,4220172,1838707,710156,358777,31775,684304,909832,157349,125574,4328258,2002
79,"Pulaski, VA",586423,34962,70710,63506,579932,3051,981,66715,864229,48500,24910,867280,60224,114934,172414,34817,2449,49481,102463,17047,14598,434479,2002
80,"Rappahannock, VA",84345,5321,5850,5922,137409,-437,-1502,8282,236065,31890,32740,235628,61346,70780,27439,7197,1336,30388,8811,2987,1651,45146,2002
81,"Richmond (Independent City), VA",9479056,529224,1124819,963080,3959915,0,0,1010764,6701444,678154,33929,6701444,-4508377,1694024,1047505,197513,12403,678154,1606359,186229,173826,7194543,2002
82,"Richmond, VA",108326,6802,14699,11262,93433,-1290,-2112,12433,172292,10503,18994,171002,-2460,39131,38438,9003,781,8391,20330,3880,3099,79605,2002
83,"Roanoke (Independent City), VA",3395712,201651,380111,394694,1607261,0,0,398998,2601722,188727,27691,2601722,-1389453,459800,534661,93956,7201,188727,577458,86907,79706,2629527,2002
84,"Roanoke + Salem, VA*",2603517,146160,289087,267394,2548734,1408,84,279857,3828887,279161,34469,3830295,225074,841040,440521,111123,10482,279245,422784,69171,58689,1901488,2002
85,"Rockbridge, Buena Vista + Lexington, VA*",554314,33551,61873,58870,515116,2647,909,62986,840833,65288,24632,843480,23788,177232,151132,34243,3657,66197,91308,19117,15460,396809,2002
86,"Rockingham + Harrisonburg, VA*",2353558,130842,266202,236582,1884368,50578,32122,249133,2641554,245168,24004,2692132,-220057,459509,348255,112152,11510,277290,384493,72157,60647,1691775,2002
87,"Russell, VA",315124,20462,39616,34750,331622,-2019,-3635,37837,593867,27389,20592,591848,54335,89489,170737,28741,2604,23754,56991,10993,8389,234379,2002
88,"Scott, VA",171452,12136,18914,16056,275445,5035,3810,20164,468170,27759,20531,473205,124157,73135,124625,23048,2721,31569,26942,7561,4840,112941,2002
89,"Shenandoah, VA",573578,34457,59944,53962,642748,-1671,-4233,61438,977445,112540,26715,975774,130608,181071,151955,36525,4844,108307,86925,20043,15199,378346,2002
90,"Smyth, VA",524643,31836,67040,53598,439858,1149,-265,58635,720854,57016,21979,722003,-26150,109301,172844,32849,3358,56751,93839,17612,14254,374053,2002
91,"Southampton + Franklin, VA*",337421,19739,41280,32870,415692,22261,18770,36174,642231,25525,26164,664492,114445,126183,122617,25397,1881,44295,57715,10810,8929,235411,2002
92,"Spotsylvania + Fredericksburg, VA*",2184172,125033,225073,224806,2765641,-2694,-3952,237436,3778241,245126,30870,3775547,818905,655252,354654,122303,10382,241174,337476,64243,53861,1605522,2002
93,"Stafford, VA",1240040,67753,136224,121660,2583822,-589,-886,128583,3351168,180391,32235,3350579,1472365,566938,199819,103943,8618,179505,197054,37206,28588,863481,2002
94,"Suffolk (Independent City), VA",919100,54208,103436,95226,1361666,10339,181,101821,1982445,93629,28767,1992784,544387,355416,275702,69274,5127,93810,151049,28067,22940,674241,2002
95,"Surry, VA",140896,7542,24927,14290,111509,2839,944,14687,160629,5396,23739,163468,-14700,25109,26850,6886,501,6340,32072,2643,2142,102484,2002
96,"Sussex, VA",138550,8608,19158,15006,150957,2770,741,16111,242117,6274,20224,244887,28518,37302,56628,12109,649,7015,26661,4602,3953,104874,2002
97,"Tazewell, VA",613798,39268,72859,61136,592685,25,-1133,69836,1052542,85420,23925,1052567,48723,164890,294992,43995,3408,84287,103427,21212,17804,426084,2002
98,Virginia,189146440,10578618,20402134,19481764,176905587,362504,108706,20319500,251017052,18240835,34498,251379556,8078647,48877962,25596007,7286873,675204,18349541,30143016,4421795,3746591,140653883,2002
99,"Virginia Beach (Independent City), VA",7995044,436791,945401,839976,10178650,786,-819,856779,14582694,736057,33901,14583480,3040385,3155350,1249480,430183,35633,735238,1365389,233810,198177,5894417,2002
100,"Warren, VA",428021,25299,44204,41726,665277,618,291,46162,933841,74133,28290,934459,283418,154532,114650,33031,3522,74424,65067,14246,10724,288530,2002
101,"Washington + Bristol, VA*",1210318,74100,156012,130556,969819,5647,357,139378,1696072,64500,24750,1701719,-101121,385856,346044,68757,7402,64857,221290,42393,34991,924171,2002
102,"Westmoreland, VA",123101,8280,13337,11070,254366,5829,540,13815,420206,25346,25777,426035,145080,90403,81266,16528,1737,25886,18872,5336,3599,78343,2002
103,"Wise + Norton, VA*",725832,44732,87007,81090,526640,-534,-649,85277,963891,50143,21128,963357,-113915,128111,308606,45596,2679,49494,127552,22193,19514,548786,2002
104,"Wythe, VA",383258,24031,45421,39144,386537,-551,-2922,43603,618519,48500,22301,617968,46882,91338,140093,27710,3046,45578,64993,14570,11524,272687,2002
105,"York + Poquoson, VA*",862251,50786,102420,84490,1710893,451,-236,93031,2450935,133459,34131,2451386,941673,535528,204965,71823,4865,133223,144665,26304,21439,584363,2002
0,"Accomack, VA",555464,31309,70143,52948,514801,28323,15999,57783,859737,66604,24170,888060,17120,186327,186932,36742,3473,82603,96617,17963,14490,376244,2003
1,"Albemarle + Charlottesville, VA*",4201509,232924,520920,417940,3039193,-1763,-7256,441894,5114999,498002,39849,5113236,-720422,1618173,455870,128315,16846,490746,729890,101299,84453,2980873,2003
2,"Alexandria (Independent City), VA",6490610,353978,663563,704052,5325596,0,0,706004,7273177,515314,56198,7273177,-459010,1562131,385450,129421,15600,515314,1015589,116680,101080,4959707,2003
3,"Alleghany + Covington, VA*",431948,26252,54394,46374,353838,-795,-1035,49439,589627,30511,25694,588832,-28671,92806,142188,22917,1437,29476,77581,11637,10200,324891,2003
4,"Amelia, VA",106229,6780,12011,10356,206400,-1430,-5107,11958,304936,22310,26291,303506,112129,47207,49899,11544,1706,17203,17189,4461,2755,71837,2003
5,"Amherst, VA",403757,24652,53481,42236,499328,-1024,-2025,45770,743749,35923,23349,742725,141341,104193,139204,31810,2613,33898,74599,13111,10498,295260,2003
6,"Appomattox, VA",148529,9295,17415,14118,239781,-1270,-1596,16354,352984,26323,25551,351714,107606,47647,64286,13765,1529,24727,24474,5321,3792,99328,2003
7,"Arlington, VA",14031569,713593,1704534,1469562,8559361,0,0,1448374,11394806,1133216,60375,11394806,-4023834,2351303,484142,188735,22179,1133216,2439315,194238,172059,10459038,2003
8,"Augusta, Staunton + Waynesboro, VA*",1991421,119080,252049,207212,1943497,7541,-2045,222686,2998570,169412,26949,3006111,174762,556336,506278,111549,11073,167367,355655,59782,48709,1468399,2003
9,"Bath, VA",97936,5864,11023,10410,86098,1195,671,11069,152800,11230,30960,153995,-769,41604,26293,4974,556,11901,16228,3023,2467,69807,2003
10,"Bedford, VA*",769283,49877,82336,75858,1324879,-5071,-7220,87806,2068020,131596,30038,2062949,643402,433647,304423,68678,7423,124376,120265,26160,18737,524642,2003
11,"Bland, VA",75245,4848,11208,7574,85465,-1496,-2418,8635,146309,8801,20948,144813,18855,24245,35103,6913,813,6383,14995,2603,1790,53867,2003
12,"Botetourt, VA",402565,24404,44930,39456,663807,-2382,-4383,44132,956996,68506,30350,954614,305374,169384,121423,31454,3376,64123,64658,12415,9039,273784,2003
13,"Brunswick, VA",177209,11216,23834,19056,206231,2661,354,20744,366450,12837,20424,369111,49766,66618,96262,18072,1144,13191,33362,6347,5203,130656,2003
14,"Buchanan, VA",328557,22394,42658,36278,246850,-247,-265,40533,562509,16487,21675,562262,-41174,116588,198824,25941,1377,16222,60797,9369,7992,251538,2003
15,"Buckingham, VA",141534,8746,18820,13438,188182,-37,-650,15465,306244,20875,19070,306207,62113,48982,69043,16057,1189,20225,25539,4678,3489,95770,2003
16,"Campbell + Lynchburg, VA*",2916397,169583,342125,319600,1905072,-2211,-4391,329383,3109916,159779,26252,3107705,-681942,545300,657333,118381,9422,155388,501925,79672,70250,2259084,2003
17,"Caroline, VA",221096,13425,27600,21430,446091,1133,-948,24140,641282,35138,27768,642415,249135,103377,92947,23135,1886,34190,38315,7227,5341,148591,2003
18,"Carroll + Galax, VA*",514031,32151,64294,54092,480754,696,-1129,59197,819454,60450,22646,820150,25920,116968,222428,36216,3113,59321,91340,18504,15391,363370,2003
19,"Charles City, VA",82316,4879,9481,7354,144434,1137,187,8556,216575,16136,30703,217712,70674,44880,28398,7091,442,16323,13158,2273,1831,52835,2003
20,"Charlotte, VA",122073,8563,16906,13092,149574,-2402,-4831,15109,270170,16962,21482,267768,42610,46743,71451,12465,1739,12131,23452,5488,3749,86490,2003
21,"Chesapeake (Independent City), VA",3925984,222291,446888,416086,5165812,6950,-1001,430334,6998529,339768,33858,7005479,1670162,1164858,674809,206909,15245,338767,654931,111448,96203,2932286,2003
22,"Chesterfield, VA",5674197,314976,642960,576036,7503738,2401,629,602994,9978579,612240,36124,9980980,2432535,1685867,791375,276300,26502,612869,930978,145272,118770,4130350,2003
23,"Clarke, VA",216805,12676,21188,20886,320321,242,-4107,23119,483390,43877,36890,483632,126635,115337,47974,13110,2291,39770,31631,6982,4691,145404,2003
24,"Craig, VA",27803,1902,3587,2208,89361,447,69,3006,130844,7485,25758,131291,64564,20199,21731,5097,542,7554,4691,1187,645,15558,2003
25,"Culpeper, VA",649587,37690,69776,63230,810642,-1806,-8565,69305,1156684,110163,30295,1154878,230360,204452,139784,38121,5017,101598,101391,18797,13780,446598,2003
26,"Cumberland, VA",58442,3507,6705,4870,139002,3458,2184,5942,208545,13370,23004,212003,86502,32184,40817,9216,718,15554,9140,2228,1510,33748,2003
27,"Dickenson, VA",115614,8864,15869,12238,143772,-4707,-4754,14983,313902,13449,19303,309195,43141,44703,120720,16018,773,8695,21988,4207,3434,84931,2003
28,"Dinwiddie, Colonial Heights + Petersburg, VA*",1328771,80060,171505,141480,1376952,3186,1249,150800,2242027,83715,29890,2245213,198981,356059,512202,75116,6045,84964,242245,40859,34814,1001562,2003
29,"Essex, VA",140301,8336,16512,13550,163040,3336,2466,15111,265682,20285,26372,269018,37850,51135,54843,10201,1080,22751,23287,5147,4067,94263,2003
30,"Fairfax, Fairfax City + Falls Church, VA*",46159698,2542942,4066845,4581888,44337732,4821,2549,4833886,58400362,5047009,56420,58405183,3011920,11558048,2509403,1035184,128556,5049558,6357789,749746,621190,34752351,2003
31,"Fauquier, VA",1026152,58759,102209,99534,1856397,-3466,-13422,108526,2628650,169371,43853,2625184,938771,594524,174263,59863,8116,155949,151976,29649,21533,718227,2003
32,"Floyd, VA",124896,7670,12372,9892,216827,5497,-709,12616,335689,38808,23924,341186,104547,58817,65542,14261,2169,38099,17318,5255,3086,69479,2003
33,"Fluvanna, VA",185188,11977,20912,16636,400521,-1038,-1722,20295,601912,42816,26314,600874,235628,115954,84399,22835,2422,41094,29230,6554,4132,114864,2003
34,"Franklin, VA",602985,36629,59838,56032,887031,-2929,-7570,64645,1335927,142918,26654,1332998,348691,228145,217822,50012,5638,135348,87854,19877,14239,379783,2003
35,"Frederick + Winchester, VA*",2205250,126367,237627,227976,2042928,-2291,-8134,240355,2828653,244023,31394,2826362,78033,462370,321064,90028,9818,235889,351615,59670,49852,1617746,2003
36,"Giles, VA",240653,14922,33296,24690,260282,511,335,27267,411076,23299,24469,411587,46896,57189,94116,16821,1567,23634,45641,6971,5404,171378,2003
37,"Gloucester, VA",358441,21891,43257,34152,740822,1462,891,38967,1094857,57267,30922,1096319,421348,224841,130656,35454,3206,58158,60333,13194,9988,239950,2003
38,"Goochland, VA",718461,40722,61671,59196,597615,737,-862,70320,926873,93497,51357,927610,-50526,262171,67824,18062,2314,92635,91269,11540,9226,534557,2003
39,"Grayson, VA",116314,7983,13766,9720,226760,-538,-2924,12843,377541,33532,22968,377003,123289,64028,86215,16414,2222,30608,18626,5187,2965,67080,2003
40,"Greene, VA",146417,8880,16669,13056,302236,1176,683,15408,412848,30662,24826,414024,171227,58886,52902,16677,1612,31345,23197,4999,3387,91875,2003
41,"Greensville + Emporia, VA*",323594,19145,43713,35728,222376,7827,6916,37009,351975,7330,20479,359802,-64209,55360,82066,17569,808,14246,61577,10098,9290,247771,2003
42,"Halifax, VA",483902,30291,62874,50732,470058,801,-3411,55657,801456,45555,21893,802257,41813,127171,205028,36645,3141,42144,88240,16483,13342,353518,2003
43,"Hampton (Independent City), VA",3532985,181582,548735,395990,2810136,0,0,379577,4171743,122782,29711,4171743,-343272,793863,567744,140413,7739,122782,746730,79481,71742,2663473,2003
44,"Hanover, VA",1927278,111622,196162,199488,2529137,5661,-2375,211366,3397297,225781,36409,3402958,813225,563705,310116,93466,10428,223406,295906,54095,43667,1407966,2003
45,"Henrico, VA",9278436,517543,930535,936896,8014179,1501,-289,985991,11164783,973374,40670,11166284,-278266,2217790,934315,274555,28161,973085,1398983,202373,174212,6906368,2003
46,"Henry + Martinsville, VA*",1120076,70634,136829,119766,963904,1052,231,130517,1777254,107541,24940,1778306,-25655,395635,418767,71302,5314,107772,196712,37013,31699,815592,2003
47,"Highland, VA",26984,1602,2714,1784,32277,2850,2286,2494,63843,8138,26784,66693,7787,22143,12273,2490,666,10424,3606,1300,634,12954,2003
48,"Isle of Wight, VA",613386,34894,72257,59192,743110,10174,7248,64490,1019796,49928,32986,1029970,194214,158253,128607,31224,2636,57176,101853,15630,12994,454357,2003
49,"James City + Williamsburg, VA*",1698801,95940,196052,175140,1635504,583,-7,183510,2618933,166838,39974,2619516,120213,697896,286116,65530,8059,166831,283622,51858,43799,1248348,2003
50,"King George, VA",735965,36226,111291,80188,435878,275,-84,76320,636423,24998,34743,636698,-223767,150035,50785,18326,1735,24914,151385,12340,10605,559666,2003
51,"King William, VA",182410,10969,20513,18026,304060,2867,-231,19982,427068,21805,31137,429935,141632,73067,52808,13808,1317,21574,29526,5389,4072,131310,2003
52,"King and Queen, VA",58123,4023,7604,5558,118930,3374,2378,6802,173387,8214,26953,176761,67609,27317,30514,6558,611,10592,10383,1890,1279,37148,2003
53,"Lancaster, VA",204355,13186,20703,18626,177052,238,80,22499,420747,39930,36547,420985,-4804,164747,79186,11519,1683,40010,30016,6735,5052,134329,2003
54,"Lee, VA",218741,14407,33423,21680,267057,858,19,25247,504292,23299,20233,505150,73563,70420,167673,24967,2220,23318,44263,8052,5832,151160,2003
55,"Loudoun, VA",7041401,386802,715636,720412,7414257,7771,-81,747008,9283799,477575,42164,9291570,1119864,1496454,380859,220366,26731,477494,1075842,140449,113718,5488065,2003
56,"Louisa, VA",396619,23295,50538,37146,576851,-1983,-3629,41868,810888,63309,29027,808905,222100,119743,112311,27867,2922,59680,69111,10405,7483,267828,2003
57,"Lunenburg, VA",114249,7329,15902,11834,150288,-424,-2395,13246,264156,9958,20188,263732,49285,52498,60946,13064,880,7563,21819,4166,3286,84867,2003
58,"Madison, VA",149406,9020,15206,13866,232589,-632,-3032,15953,356080,36919,27629,355448,99136,74576,48283,12865,1806,33887,22139,5634,3828,93380,2003
59,"Mathews, VA",76658,5304,6942,5406,189661,1242,159,8007,340169,28308,37555,341411,121010,99919,51831,9091,1242,28467,9645,2958,1716,38546,2003
60,"Mecklenburg, VA",460234,28660,60373,47364,420500,920,-5350,52342,742525,41800,22843,743445,12608,140501,182444,32546,2743,36450,84055,16112,13369,339729,2003
61,"Middlesex, VA",135306,8511,16899,11658,174301,1798,579,14340,319587,29041,31391,321385,53335,86836,60248,10238,1546,29620,22728,5110,3564,82958,2003
62,"Montgomery + Radford, VA*",1976667,109546,290449,204440,1542010,946,-1939,211766,2302492,148671,22495,2303438,-222891,450591,310837,102399,8365,146732,392669,57242,48877,1437266,2003
63,"Nelson, VA",145501,9648,15070,12880,259570,584,-1706,16088,420379,37665,28602,420963,130157,86403,74990,14718,2199,35959,21510,5768,3569,88032,2003
64,"New Kent, VA",148794,9041,16131,13238,411492,891,355,15660,525445,34450,35650,526336,278358,66903,47941,14764,1807,34805,22750,5304,3497,91239,2003
65,"Newport News (Independent City), VA",4868620,260775,703610,529948,3275118,0,0,525749,4943483,200362,26954,4943483,-1067753,955471,712894,183404,10669,200362,968584,116011,105342,3699674,2003
66,"Norfolk (Independent City), VA",11718037,572028,1771685,1283982,4651308,0,0,1214019,7164447,905793,29941,7164447,-5852710,1513081,1000058,239286,13425,905793,2413676,229496,216071,8398568,2003
67,"Northampton, VA",239649,12068,23003,19468,210341,49096,36802,21802,317042,33026,28798,366138,-7506,77334,78463,12714,1480,69828,32737,7090,5610,137084,2003
68,"Northumberland, VA",112603,7820,11953,9632,153796,1602,1104,12636,348187,26838,27887,349789,53829,123548,72445,12543,1440,27942,16769,4272,2832,67892,2003
69,"Nottoway, VA",223649,13485,34809,25168,211656,4596,3178,26069,375295,13383,24208,379891,14076,68994,99241,15693,1369,16561,47393,7673,6304,159695,2003
70,"Orange, VA",354702,22288,38440,33638,529771,6729,-2233,39107,841724,68019,30355,848453,214176,177045,141637,27951,3501,65786,55259,12212,8711,233657,2003
71,"Page, VA",263492,15788,30189,24868,362363,13318,11024,28222,554611,45494,24135,567929,127093,90883,114683,23531,2253,56518,42623,9012,6759,164351,2003
72,"Patrick, VA",199323,12718,25204,20628,239436,2345,-2252,23032,409453,28249,21698,411798,63145,70585,101777,18979,2177,25997,35518,8512,6335,137808,2003
73,"Pittsylvania + Danville, VA*",1707636,104184,213862,184292,1594553,-488,-8526,196330,2663986,131932,24521,2663498,83247,472459,596486,108622,7954,123406,306008,54373,46419,1278222,2003
74,"Portsmouth (Independent City), VA",2554545,132379,417005,284462,1659633,0,0,274610,2675331,74921,27529,2675331,-620302,516088,499610,97184,5109,74921,559236,54764,49655,1920388,2003
75,"Powhatan, VA",269703,15850,30413,24478,569035,468,-508,28089,731779,55114,29422,732247,327421,93365,69847,24888,2395,54606,42652,8300,5905,172445,2003
76,"Prince Edward, VA",313631,19093,40143,33020,239191,568,-347,35603,406566,31947,20152,407134,-38837,75876,92067,20203,1710,31600,56653,10687,8977,225378,2003
77,"Prince George + Hopewell, VA*",1268696,64713,208840,140318,985501,923,379,134872,1462075,44686,25944,1462998,-148323,263429,214068,56391,2889,45065,278999,27733,24844,944632,2003
78,"Prince William, Manassas + Manassas Park, VA*",6385693,343066,689843,667190,10356173,-497,-3136,676661,13111802,712880,35342,13111305,4647141,1963261,791871,370987,35437,709744,1023438,163786,128349,4652511,2003
79,"Pulaski, VA",653200,38331,83575,69606,616478,2456,375,73134,919897,51047,26513,922353,36412,119869,186006,34789,2515,51422,118378,17972,15457,483400,2003
80,"Rappahannock, VA",92057,5811,7035,6594,151641,-1086,-2343,9108,257613,34687,35629,256527,68692,75459,29427,7200,1373,32344,10332,3112,1739,49381,2003
81,"Richmond (Independent City), VA",9734972,537625,1189116,988326,4082919,0,0,1031788,7038777,721787,35674,7038777,-4620265,1862760,1093098,197306,13056,721787,1683279,182692,169636,7329906,2003
82,"Richmond, VA",117753,7149,16421,11834,102736,1363,328,13066,183876,11200,20349,185239,-1951,40906,41597,9103,840,11528,22338,3945,3105,83887,2003
83,"Roanoke (Independent City), VA",3393503,199568,408405,393986,1614818,0,0,396561,2654356,171979,28323,2654356,-1382124,485872,553666,93716,7536,171979,605398,84653,77117,2616126,2003
84,"Roanoke + Salem, VA*",2706917,150890,311644,279738,2645729,816,-423,290759,3948109,275491,35320,3948925,229571,823327,479869,111803,10861,275068,451513,69240,58379,1980336,2003
85,"Rockbridge, Buena Vista + Lexington, VA*",575771,34701,69120,61578,535494,32,-1871,65490,882644,63593,25589,882676,25213,186624,160558,34494,3845,61722,99909,19382,15537,414140,2003
86,"Rockingham + Harrisonburg, VA*",2503700,136928,298449,249594,1987119,63630,44785,261725,2812824,252513,25421,2876454,-254856,519766,369569,113151,11702,297298,423246,72919,61217,1783156,2003
87,"Russell, VA",315631,20547,43977,34756,342326,-4636,-6286,37925,622257,26345,21471,617621,64620,94241,181054,28766,2530,20059,61355,11198,8668,234217,2003
88,"Scott, VA",175701,12695,21085,16884,282565,218,-1030,21137,491661,30216,21407,491879,128001,75756,133558,22978,2802,29186,29527,7595,4793,116988,2003
89,"Shenandoah, VA",575434,34797,65546,54466,660579,-5823,-8811,62030,1022143,110647,27241,1016320,147175,192864,162877,37309,4921,101836,92779,19571,14650,380819,2003
90,"Smyth, VA",523487,31797,71653,53304,443183,-685,-2338,58449,739664,56521,22576,738979,-21855,112349,183447,32733,3262,54183,98305,16917,13655,370999,2003
91,"Southampton + Franklin, VA*",350623,20162,44474,33450,435177,26281,22555,36887,666673,27552,27151,692954,121441,126494,131283,25522,1902,50107,61199,10753,8851,239317,2003
92,"Spotsylvania + Fredericksburg, VA*",2330121,132399,249862,238724,3020444,-3852,-5310,251761,4102486,266318,32226,4098634,942084,689833,388357,127184,10938,261008,369224,65700,54762,1699889,2003
93,"Stafford, VA",1434423,77274,168106,143776,2866000,-1170,-1520,149162,3713031,182016,34002,3711861,1580739,617138,228723,109166,9300,180496,239994,39790,30490,1013933,2003
94,"Suffolk (Independent City), VA",1005088,58584,118847,103544,1523128,11986,574,110356,2190844,102375,30292,2202830,628396,375915,303787,72721,5486,102949,170619,28779,23293,731520,2003
95,"Surry, VA",165869,8868,27165,16578,121583,3703,1696,17157,171373,5150,25370,175076,-27129,25971,27522,6901,495,6846,35454,2717,2222,123569,2003
96,"Sussex, VA",145788,8852,20375,15500,152570,5443,3181,16602,245909,6490,20594,251352,23384,38260,60522,12205,654,9671,28125,4517,3863,107992,2003
97,"Tazewell, VA",618401,39631,79279,61820,595138,-1447,-2600,70541,1072765,78699,24325,1071318,47278,169415,306765,44042,3413,76099,110189,20761,17348,432113,2003
98,Virginia,199919105,11044781,22846356,20603340,187347998,267274,-13341,21346451,266330371,19110810,36188,266597645,8775344,51803003,27446644,7366977,709898,19097469,33148026,4467387,3757489,147673610,2003
99,"Virginia Beach (Independent City), VA",8706876,466859,1106892,908810,11026663,1933,120,921264,15735958,874402,36464,15737891,3241051,3353447,1357781,431600,37443,874522,1561297,236601,199158,6271057,2003
100,"Warren, VA",445398,26246,49229,43628,701296,-708,-1182,48060,991787,74872,29324,991079,303958,165810,123973,33797,3624,73690,71043,14578,10954,300665,2003
101,"Washington + Bristol, VA*",1341537,81621,176968,142978,1056354,-2439,-7651,153110,1847405,80584,26595,1844966,-132073,419189,369423,69373,7609,72933,248457,42973,35364,1020147,2003
102,"Westmoreland, VA",132656,8749,14924,11694,267861,7083,1161,14596,442895,28300,26916,449978,149801,95515,86602,16718,1733,29461,20771,5409,3676,82424,2003
103,"Wise + Norton, VA*",775480,46909,100197,84454,555861,-710,-832,89136,1009612,58897,22133,1008902,-130483,128740,324301,45584,2737,58065,142424,22474,19737,574991,2003
104,"Wythe, VA",404993,25278,52246,41584,408728,-3813,-6454,46070,658309,49984,23493,654496,49805,95355,150413,27859,2991,43530,73038,14846,11855,288425,2003
105,"York + Poquoson, VA*",932639,54178,119039,92212,1827533,858,131,100284,2625325,139326,36265,2626183,995178,574657,223993,72417,4974,139457,165145,27467,22493,628037,2003
0,"Accomack, VA",583037,33038,76171,57084,539007,33559,22011,61580,892497,62577,25504,926056,17550,193716,193333,36310,3624,84588,104713,18095,14471,393736,2004
1,"Albemarle + Charlottesville, VA*",4532873,249125,582082,457022,3253925,-2322,-8442,477636,5462141,529842,42072,5459819,-801312,1727406,478488,129772,17718,521400,810593,104460,86742,3200880,2004
2,"Alexandria (Independent City), VA",6842822,372830,689134,757002,5822863,0,0,751331,7878537,568910,61185,7878537,-268628,1647787,407887,128765,16266,568910,1067635,117729,101463,5206277,2004
3,"Alleghany + Covington, VA*",430903,26717,55518,46562,355573,-814,-1018,49998,603217,28081,26378,602403,-25332,94921,151909,22837,1420,27063,78799,11381,9961,325041,2004
4,"Amelia, VA",115528,7350,13535,11354,233750,38,-3641,13027,338284,22958,28887,338322,131249,49551,55021,11712,1723,19317,19212,4610,2887,76999,2004
5,"Amherst, VA",418715,25912,58077,44476,522159,-424,-1349,48150,785286,34536,24694,784862,151594,109076,153627,31783,2661,33187,80315,13285,10624,305213,2004
6,"Appomattox, VA",153287,9783,18819,14762,245793,-1771,-2092,17164,367431,27080,26276,365660,109670,48053,71814,13916,1534,24988,26200,5266,3732,102099,2004
7,"Arlington, VA",15872949,808994,1894991,1675192,9245962,0,0,1646590,12055941,1269925,64161,12055941,-4980397,2310181,499798,187901,23137,1269925,2732587,202405,179268,11870437,2004
8,"Augusta, Staunton + Waynesboro, VA*",2257731,130676,274025,223052,2191216,29566,19899,242202,3290306,317884,29444,3319872,175687,593000,535656,112751,11607,337783,385551,61591,49984,1534397,2004
9,"Bath, VA",103779,6296,12436,11386,89210,489,-56,11989,164649,12488,33469,165138,-2580,49650,26278,4934,584,12432,18129,3123,2539,73218,2004
10,"Bedford, VA*",811159,53477,89772,81112,1396754,-3760,-5876,94033,2137311,135234,30584,2133551,679628,422728,314069,69761,7863,129358,130328,26909,19046,551473,2004
11,"Bland, VA",77597,5046,12266,8062,88044,-445,-1317,9077,149351,6972,21540,148906,19524,23528,37334,6913,836,5655,16297,2616,1780,55645,2004
12,"Botetourt, VA",432211,26259,48783,42740,754395,-156,-2014,47629,1038677,71968,32745,1038521,369813,154208,129918,31715,3562,69954,70153,12685,9123,292104,2004
13,"Brunswick, VA",192142,12088,27093,20584,221221,4834,2729,22380,380771,13208,21445,385605,51459,64479,99905,17981,1162,15937,37385,6452,5290,138820,2004
14,"Buchanan, VA",356295,24153,47519,37552,271109,-330,-357,42929,567638,25150,22120,567308,-42257,92610,203589,25647,1343,24793,66295,9390,8047,265207,2004
15,"Buckingham, VA",151263,9191,20916,14200,200982,4008,3262,16291,321706,20078,20146,325714,66010,49941,74791,16168,1239,23340,28016,4794,3555,99907,2004
16,"Campbell + Lynchburg, VA*",3075484,179119,368987,345584,1999461,2404,282,351911,3276053,164434,27524,3278457,-724112,595419,683577,119114,9746,164716,541779,80959,71213,2368989,2004
17,"Caroline, VA",242208,14656,30925,23456,506941,2751,734,26384,711164,39941,29846,713915,291117,105426,101548,23920,2089,40675,42653,7513,5424,158880,2004
18,"Carroll + Galax, VA*",534649,33559,68419,56538,503348,10198,8459,61828,843923,59431,23426,854121,30527,121237,229536,36460,3134,67890,96688,18264,15130,370071,2004
19,"Charles City, VA",86912,5085,9702,7926,153284,2353,1374,9048,222019,16548,31826,224372,75420,40012,31076,7050,470,17922,13665,2273,1803,55325,2004
20,"Charlotte, VA",136453,9207,18814,13558,166370,5079,2975,15986,282231,19371,22941,287310,45903,48006,72934,12524,1742,22346,25593,5505,3763,88514,2004
21,"Chesapeake (Independent City), VA",4351651,245678,506925,473110,5516967,8650,1221,482233,7365817,346009,34797,7374467,1647549,1140712,716788,211927,16553,347230,743480,118165,101612,3260941,2004
22,"Chesterfield, VA",6048108,335886,698842,629718,8166516,2429,1044,650745,10703019,626847,37824,10705448,2769153,1674147,864785,283030,28524,627891,1013701,150166,121642,4406516,2004
23,"Clarke, VA",224898,13255,23002,22486,349206,-243,-4678,24498,528022,42718,39348,527779,148806,124846,53727,13413,2436,38040,34245,7105,4669,152613,2004
24,"Craig, VA",28801,2005,3837,2220,92847,1014,659,3115,136126,7884,26671,137140,67161,19134,25159,5142,556,8543,4947,1187,631,15311,2004
25,"Culpeper, VA",696481,40559,78061,69306,888570,-1198,-7151,75212,1255738,110648,31624,1254540,267301,214166,151804,39670,5344,103497,112714,19624,14280,480270,2004
26,"Cumberland, VA",67060,3846,7491,5356,153917,7384,6184,6524,221696,14168,24838,229080,93381,32200,42963,9223,772,20352,10169,2303,1531,36539,2004
27,"Dickenson, VA",123472,9681,17432,12904,153025,-3859,-3909,16133,328797,13347,20305,324938,45686,41816,130097,16003,828,9438,23884,4264,3436,90150,2004
28,"Dinwiddie, Colonial Heights + Petersburg, VA*",1395438,84201,185961,153024,1336457,5932,4104,160713,2206902,74477,29364,2212834,101732,364366,512011,75358,6267,78581,262473,41698,35431,1054384,2004
29,"Essex, VA",156765,9211,18888,15286,180826,6259,5419,16854,283242,20988,28277,289501,40915,52733,55942,10238,1135,26407,26531,5374,4239,103827,2004
30,"Fairfax, Fairfax City + Falls Church, VA*",50472609,2765159,4424149,5068344,48017079,6051,4054,5299331,62245629,5958152,59703,62251680,2843801,11521638,2712963,1042687,133673,5962206,6958321,772605,638932,37552082,2004
31,"Fauquier, VA",1138977,65387,118171,114176,2010624,-7884,-18711,122475,2853008,176170,46399,2845124,994122,651645,182855,61319,8723,157459,175259,31362,22639,806259,2004
32,"Floyd, VA",130484,8231,13756,10860,232560,4864,-1424,13661,355853,38977,25100,360717,115737,58110,70047,14371,2227,37553,19186,5286,3059,73745,2004
33,"Fluvanna, VA",207246,13407,24308,18576,446476,-510,-1195,22695,666610,49141,28404,666100,261925,129634,89990,23451,2567,47946,33596,6958,4391,125704,2004
34,"Franklin, VA",646742,39268,65245,61300,943650,7239,2559,69918,1423594,140922,28055,1430833,366826,247135,240048,51001,6034,143481,95895,20756,14722,407366,2004
35,"Frederick + Winchester, VA*",2398845,135701,260497,250660,2262575,1885,-3876,261031,3099815,280406,33490,3101700,124761,497818,341307,92617,10550,276530,385827,62042,51492,1736488,2004
36,"Giles, VA",252664,15831,35399,26150,279368,800,604,28906,436770,26471,26068,437570,55610,57008,101194,16786,1630,27075,48474,7167,5537,177115,2004
37,"Gloucester, VA",389207,23876,48377,37902,797458,2386,1855,42827,1175652,59429,32985,1178038,451078,238337,142243,35714,3413,61284,67328,13748,10335,260595,2004
38,"Goochland, VA",843401,48294,70363,67794,676368,770,-1184,82191,1056814,83258,56951,1057584,-84842,305353,75863,18570,2489,82074,104260,12268,9779,657067,2004
39,"Grayson, VA",127856,8802,15124,10524,243988,1427,-842,14064,393938,37832,24254,395365,130196,56323,95054,16301,2176,36990,20386,5139,2963,70480,2004
40,"Greene, VA",133627,8258,14218,11744,323282,1768,1253,14130,442351,32015,26287,444119,203785,64335,56502,16895,1656,33268,20090,4667,3011,80269,2004
41,"Greensville + Emporia, VA*",325030,18810,46346,36816,231601,5752,4890,37218,365722,6420,21740,371474,-56211,55761,84112,17087,321,11310,64754,9280,8959,248966,2004
42,"Halifax, VA",528737,32282,70010,54398,510105,19062,15036,59481,833809,46562,23442,852871,40849,134166,208600,36382,3182,61598,97209,16710,13528,369930,2004
43,"Hampton (Independent City), VA",3618212,185246,573285,416270,2925677,0,0,393381,4277630,137539,30511,4277630,-299154,754662,597291,140200,8064,137539,781420,78752,70688,2699253,2004
44,"Hanover, VA",2036481,118268,215362,215722,2726857,7158,-697,226129,3597730,228855,37829,3604888,916505,556702,321329,95295,10953,228158,323223,55813,44860,1485100,2004
45,"Henrico, VA",10031995,560845,1022875,1059078,8352036,1796,105,1090384,11577149,831301,41311,11578945,-589575,2198712,1028197,280290,29837,831406,1552414,207815,177978,7648175,2004
46,"Henry + Martinsville, VA*",1141977,71811,144722,123274,989433,2602,1714,133448,1810784,108924,25674,1813386,-19096,393327,430626,70631,5491,110638,206359,36292,30801,824980,2004
47,"Highland, VA",28665,1665,3275,1970,34055,4208,3649,2650,65480,6865,28537,69688,8040,22637,12996,2442,672,10514,4260,1348,676,13891,2004
48,"Isle of Wight, VA",645163,37004,77484,63838,803062,8004,5226,68923,1102848,54892,34824,1110852,226822,169249,138541,31899,2812,60118,109403,16009,13197,475642,2004
49,"James City + Williamsburg, VA*",1731170,97848,208582,183138,1768632,944,449,189417,2891840,165300,42436,2892784,226879,816679,307473,68168,8607,165749,300151,51222,42615,1265270,2004
50,"King George, VA",818862,40603,120375,88596,515704,1091,696,84901,723870,49624,37908,724961,-218257,153765,55492,19124,1895,50320,164673,12788,10893,603869,2004
51,"King William, VA",193272,11475,22351,19214,328022,4254,1226,21082,458541,20699,33116,462795,155832,79340,55433,13975,1366,21925,31958,5497,4131,139389,2004
52,"King and Queen, VA",62979,3697,8371,5992,127663,4992,4120,6693,183203,8614,27926,188195,71377,28942,31590,6739,624,12734,11367,1904,1280,38878,2004
53,"Lancaster, VA",212336,13970,22468,19736,184413,888,697,23838,445719,40871,38788,446607,-4085,179651,82543,11514,1729,41568,32336,6778,5049,138432,2004
54,"Lee, VA",235270,15778,36246,23170,287649,1226,394,27363,528611,26213,21052,529837,79742,68852,173336,25168,2203,26607,47831,8000,5797,160832,2004
55,"Loudoun, VA",7948284,436852,802446,836748,8517241,2681,-5900,855226,10594886,499884,44472,10597567,1424183,1668840,411486,238299,30032,493984,1220820,152780,122748,6233480,2004
56,"Louisa, VA",449085,26322,58458,42842,639952,-1138,-2677,47743,884213,68752,30896,883075,238610,124242,118881,28582,3065,66075,79879,11010,7945,303131,2004
57,"Lunenburg, VA",125161,7773,17059,12504,161254,4606,2878,14025,272651,11092,21407,277257,50118,48606,67397,12952,927,13970,23311,4258,3331,87880,2004
58,"Madison, VA",155698,9466,16684,14800,247999,-215,-2684,16866,374366,37043,28999,374151,109167,74737,51415,12902,1881,34359,24084,5676,3795,97255,2004
59,"Mathews, VA",80701,5750,7735,5842,198846,1048,135,8671,359197,29079,39934,360245,126816,108237,53162,9021,1256,29214,10656,3007,1751,40831,2004
60,"Mecklenburg, VA",467326,29165,65250,49314,426283,7332,1609,53822,752799,39657,23355,760131,12779,144938,188910,32547,2814,41266,89907,16424,13610,336153,2004
61,"Middlesex, VA",147322,9419,19214,13068,185969,1830,668,15953,346255,29940,33473,348085,54600,98437,63679,10399,1635,30608,25748,5352,3717,90966,2004
62,"Montgomery + Radford, VA*",2080496,115226,315211,218646,1611535,3673,732,224549,2409539,154254,23422,2413212,-244412,473635,328042,103032,8859,154986,424534,57812,48953,1500976,2004
63,"Nelson, VA",160657,10633,17813,14394,275493,1890,-669,17830,441181,40341,30143,443071,132666,92443,75135,14699,2353,39672,25010,6063,3710,95975,2004
64,"New Kent, VA",155522,9588,18460,14900,465988,1056,592,17038,588908,28718,38517,589964,327504,73196,50780,15317,1940,29310,25910,5674,3734,100302,2004
65,"Newport News (Independent City), VA",5213860,275912,811072,575172,3476844,0,0,563498,5220594,208217,28188,5220594,-1173518,993124,750626,185204,11094,208217,1098658,117906,106812,3906985,2004
66,"Norfolk (Independent City), VA",12689700,613742,1877565,1374492,5324640,0,0,1300988,7942070,1430427,32571,7942070,-6064072,1569933,1047497,243836,14251,1430427,2564811,228039,213788,8694462,2004
67,"Northampton, VA",255607,12608,26177,21260,223531,54335,41105,23238,334404,30987,30468,388739,-8838,82026,83182,12759,1575,72092,36807,7211,5636,146708,2004
68,"Northumberland, VA",128241,8886,14009,11190,167892,3446,2869,14481,380736,29090,30767,384182,54132,135202,81088,12487,1532,31959,19604,4604,3072,76678,2004
69,"Nottoway, VA",239937,14509,38096,26778,227136,6161,4691,27898,390964,15058,25411,397125,15097,70485,99504,15628,1344,19749,51485,7709,6365,168703,2004
70,"Orange, VA",391000,24655,43641,38006,585220,10646,1439,43658,910316,67722,32136,920962,237878,189391,146351,28658,3671,69161,62644,12697,9026,259195,2004
71,"Page, VA",286315,16604,32970,26232,393373,27415,25198,29720,572801,45773,25512,600216,136778,88734,118109,23527,2359,70971,46086,9268,6909,169258,2004
72,"Patrick, VA",197551,12922,25860,20218,241406,4323,328,23031,406746,29350,21824,411069,66886,63741,105922,18836,2165,29678,35969,7926,5761,131904,2004
73,"Pittsylvania + Danville, VA*",1742166,106515,222552,190654,1622054,24889,17251,201842,2682028,118141,25049,2706917,81730,466393,618470,108067,8095,135392,317879,53315,45220,1288895,2004
74,"Portsmouth (Independent City), VA",2743588,141101,457853,309982,1775244,0,0,296092,2779192,91115,28526,2779192,-672252,482867,521081,97428,5307,91115,612844,55716,50409,2039629,2004
75,"Powhatan, VA",301978,17740,35196,28222,646240,1340,441,31851,833538,58239,32653,834878,376113,113945,74693,25568,2622,58680,49307,9056,6434,193991,2004
76,"Prince Edward, VA",337725,20095,45810,35500,257954,3758,2854,37845,427362,34050,20889,431120,-41926,79374,93792,20639,1783,36904,63560,10955,9172,237261,2004
77,"Prince George + Hopewell, VA*",1342894,67600,225818,153306,1031578,229,-214,144253,1532106,40415,26919,1532335,-167063,271031,229726,56923,2990,40201,302471,28113,25123,1000222,2004
78,"Prince William, Manassas + Manassas Park, VA*",7157625,388874,786745,763938,11513464,-324,-3030,770843,14485502,807036,37528,14485178,5126682,2101497,870217,385985,38735,804006,1168714,175931,137196,5184905,2004
79,"Pulaski, VA",687157,40444,91095,74110,646192,3989,2150,77499,962326,53707,27745,966315,36534,122605,197518,34829,2525,55857,128150,17938,15413,503150,2004
80,"Rappahannock, VA",105849,6736,8195,7768,177684,-1246,-2540,10620,284052,37958,38799,282806,82455,75042,30080,7289,1434,35418,12079,3253,1819,58352,2004
81,"Richmond (Independent City), VA",10302607,567571,1263492,1053480,4444427,0,0,1094311,7621523,862587,38712,7621523,-4763869,2111224,1065872,196878,13921,862587,1790232,182447,168526,7649788,2004
82,"Richmond, VA",126647,7646,18176,12708,113260,3443,2319,14000,197152,11864,21799,200595,613,44551,42784,9202,842,14183,24530,3981,3139,87934,2004
83,"Roanoke (Independent City), VA",3571973,210227,436436,419060,1673593,0,0,419757,2778330,157438,29679,2778330,-1478623,534722,570015,93614,8132,157438,645966,85338,77206,2768569,2004
84,"Roanoke + Salem, VA*",2848168,158617,343635,301384,2748732,850,-152,309309,4092789,267381,36461,4093639,209873,830245,514662,112273,11107,267229,494327,70341,59234,2086612,2004
85,"Rockbridge, Buena Vista + Lexington, VA*",612201,36929,75628,65860,570024,3743,1903,69859,940915,68205,27122,944658,27682,208882,165752,34830,4020,70108,108558,19570,15550,433535,2004
86,"Rockingham + Harrisonburg, VA*",2656032,142490,321282,265798,2132665,112403,95360,275389,2930358,269767,26565,3042761,-247978,505952,404144,114542,12371,365127,454181,74115,61744,1836724,2004
87,"Russell, VA",337560,22116,48421,36840,367591,-1706,-3190,40536,635964,26229,22219,634258,70567,75022,191645,28546,2465,23039,66841,11160,8695,247680,2004
88,"Scott, VA",194896,14142,23817,18486,303563,3367,2247,23385,516762,33660,22660,520129,132052,74020,142546,22954,2798,35907,33060,7665,4867,125929,2004
89,"Shenandoah, VA",617427,37051,71882,59714,714163,6805,3759,66908,1083590,103515,28491,1090395,163644,203146,173086,38272,5224,107274,101739,20182,14958,408414,2004
90,"Smyth, VA",577542,35074,83940,60390,479577,528,-1169,65269,777311,53431,23882,777839,-32696,109429,188833,32570,3259,52262,114135,17657,14398,411145,2004
91,"Southampton + Franklin, VA*",360971,21270,48151,35068,446737,21569,18044,38804,701237,31525,28112,722806,124570,138387,137682,25712,2016,49569,65685,10883,8867,245717,2004
92,"Spotsylvania + Fredericksburg, VA*",2569240,147235,280303,266432,3369809,-3677,-5162,280451,4528108,311871,34238,4524431,1081020,751176,403446,132147,11987,306709,413519,69024,57037,1849012,2004
93,"Stafford, VA",1641582,87575,199534,168878,3164903,-1247,-1612,172014,4078125,190322,35826,4076878,1695335,662426,249549,113798,9815,188710,283973,43019,33204,1168899,2004
94,"Suffolk (Independent City), VA",1096862,63820,137402,114406,1695721,12804,1439,121023,2419219,110898,32117,2432023,719882,413973,322329,75725,5971,112337,194605,30162,24191,789920,2004
95,"Surry, VA",158600,8447,28580,16284,127575,3284,1395,16589,180490,4937,26739,183774,-14436,26932,29267,6873,512,6332,36722,2665,2153,115546,2004
96,"Sussex, VA",146669,9096,22109,15748,161359,4704,2472,16970,258331,5414,21894,263035,31660,40915,60761,12014,705,7886,29983,4569,3864,108800,2004
97,"Tazewell, VA",657925,42792,88921,67482,622483,-1742,-2752,76533,1115807,73681,25261,1114065,41091,177783,313799,44102,3449,70929,122662,21174,17725,464334,2004
98,Virginia,216828911,11943454,24961808,22636736,202807735,529702,255485,23261822,284582910,21527022,38139,285112612,9240646,53322208,28982669,7475575,747702,21782507,36280176,4587103,3839401,158766228,2004
99,"Virginia Beach (Independent City), VA",9602330,513521,1209325,1011112,11809177,3299,1495,1019077,16723927,1094791,38234,16727226,3225924,3464801,1453248,437494,39368,1096286,1714881,245737,206369,6791163,2004
100,"Warren, VA",489317,28852,56991,48720,793070,-1644,-2206,53212,1099857,79979,31893,1098213,356965,173528,131615,34434,3892,77773,81351,15308,11416,330193,2004
101,"Washington + Bristol, VA*",1384550,83626,185375,145710,1130444,3339,-1192,156481,1919012,126041,27510,1922351,-97625,403895,388012,69877,7765,124849,258230,42806,35041,1001471,2004
102,"Westmoreland, VA",148359,9867,16751,13180,287475,7974,2100,16457,472320,32214,28833,480294,155573,101486,91333,16658,1748,34314,23341,5513,3765,90704,2004
103,"Wise + Norton, VA*",828001,51427,111190,88036,590794,-650,-758,95445,1055603,69733,23217,1054953,-141762,126870,337289,45438,2838,68975,155208,22660,19822,603818,2004
104,"Wythe, VA",429354,27144,57794,45226,434997,-3280,-5872,49757,686716,46540,24455,683436,55400,96282,152157,27947,3055,40668,80407,15075,12020,308279,2004
105,"York + Poquoson, VA*",1026175,59383,131907,104992,1966549,1414,737,111879,2789270,139800,37866,2790684,1052253,589024,235111,73698,5429,140537,184403,28962,23533,701235,2004
0,"Accomack, VA",610118,35103,79276,61020,561739,39945,30984,65613,916808,60519,26699,956753,17234,181260,213754,35835,3682,91503,109786,18166,14484,408829,2005
1,"Albemarle + Charlottesville, VA*",4858042,270492,613572,492338,3439236,-4975,-10502,516661,5875882,558400,44385,5870907,-902145,1907751,523920,132273,18635,547898,859741,107686,89051,3450403,2005
2,"Alexandria (Independent City), VA",7761114,416371,848324,861146,6138824,0,0,846944,8400637,577218,65537,8400637,-775346,1853732,408081,128181,16016,577218,1278897,122819,106803,5904999,2005
3,"Alleghany + Covington, VA*",443660,27979,57962,49866,367914,-448,-594,52912,618212,25743,27271,617764,-22834,88342,161508,22653,1478,25149,82895,11383,9905,335616,2005
4,"Amelia, VA",127525,8347,15008,13042,248033,-538,-3586,14868,361873,22703,30255,361335,135376,51524,61778,11943,1816,19117,21529,4904,3088,86879,2005
5,"Amherst, VA",432092,27441,60189,46746,543308,-157,-872,50814,824460,36921,25796,824303,162030,111115,169880,31955,2749,36049,83562,13349,10600,312481,2005
6,"Appomattox, VA",155888,10285,19117,15520,256056,-1812,-2075,18045,385313,27929,27430,383501,118213,47762,79683,13981,1531,25854,26877,5277,3746,103157,2005
7,"Arlington, VA",16149383,825688,1939740,1696656,9740199,0,0,1674016,12866164,1259968,68525,12866164,-4735168,2587241,538724,187760,22889,1259968,2788068,197039,174150,12101347,2005
8,"Augusta, Staunton + Waynesboro, VA*",2310660,136452,287542,239462,2253590,39151,31095,256183,3389821,251931,30056,3428972,199113,588103,587279,114085,12192,283026,407273,63083,50891,1620361,2005
9,"Bath, VA",106269,6605,12354,11392,91225,458,-7,12301,164583,13779,33744,165041,-2743,44435,29381,4891,620,13772,18050,3299,2679,74447,2005
10,"Bedford, VA*",848762,57662,95516,85384,1482271,-3883,-5616,100354,2251329,145671,31649,2247446,733863,423447,341728,71011,8248,140055,138208,27459,19211,570499,2005
11,"Bland, VA",84359,5565,13701,9116,93085,161,-530,10123,154254,6919,22467,154415,18849,21988,39342,6873,813,6389,18259,2669,1856,59711,2005
12,"Botetourt, VA",482749,29517,57617,48492,803080,621,-818,53763,1106650,71220,34817,1107271,374094,161888,142303,31803,3764,70402,81863,13794,10030,330484,2005
13,"Brunswick, VA",200760,13159,27966,21518,230690,2830,1234,23918,392043,13907,21961,394873,53848,58069,106114,17981,1229,15141,38725,6559,5330,146894,2005
14,"Buchanan, VA",386867,26697,47988,40436,298272,-415,-440,46915,591694,36429,23357,591279,-41680,77367,215640,25315,1361,35989,68206,9505,8144,282672,2005
15,"Buckingham, VA",156252,9766,21160,14732,211349,4591,3870,17132,333602,20192,20620,338193,72229,48960,77884,16401,1280,24062,28526,4855,3575,103664,2005
16,"Campbell + Lynchburg, VA*",3281511,193125,392962,374952,2107612,1592,-118,380601,3427096,174057,28204,3428688,-793298,602168,718908,121568,10138,173939,580438,83726,73588,2527134,2005
17,"Caroline, VA",258835,16105,33428,24836,564825,1338,-281,28523,777115,44054,30558,778453,334513,101218,112410,25475,2367,43773,45846,7890,5523,169216,2005
18,"Carroll + Galax, VA*",540417,35045,69651,58196,512222,11763,10376,64143,860077,59302,23898,871840,35948,113823,245795,36481,3267,69678,98749,18096,14829,371990,2005
19,"Charles City, VA",91328,5486,9888,8484,157238,3387,2560,9728,226807,16293,32605,230194,75638,39092,33864,7060,482,18853,14130,2298,1816,58345,2005
20,"Charlotte, VA",129883,9529,18055,13002,164521,3123,1600,16030,284096,19100,22739,287219,50668,42770,79928,12631,1806,20700,24556,5185,3379,84627,2005
21,"Chesapeake (Independent City), VA",4589945,261353,543662,507328,5756831,7584,1837,515017,7713330,346986,35890,7720914,1681903,1166368,797715,215128,17627,348823,797326,121114,103487,3443796,2005
22,"Chesterfield, VA",6441880,361646,739663,670682,8760007,1776,906,696987,11528590,678854,39760,11530366,3015114,1794215,976144,289998,30653,679760,1075004,155007,124354,4687116,2005
23,"Clarke, VA",238488,14334,23811,22900,388113,-989,-4709,25784,578742,48745,42141,577753,175409,137248,52392,13710,2564,44036,35261,7239,4675,159191,2005
24,"Craig, VA",29995,2172,3884,2386,96591,1661,1379,3365,139971,7099,27560,141632,69961,18426,26615,5139,567,8478,5077,1222,655,16440,2005
25,"Culpeper, VA",774592,45700,86731,77684,1003331,414,-3919,84542,1401194,116557,33456,1401608,313281,230088,168189,41894,5542,112638,125573,20731,15189,536381,2005
26,"Cumberland, VA",70891,4105,8062,5536,164759,9603,8670,6873,236822,13568,26035,246425,100741,32830,48836,9465,792,22238,10830,2325,1533,37823,2005
27,"Dickenson, VA",145065,11470,19771,15368,166474,-2867,-2907,19154,350506,12502,21578,347639,40563,40734,140431,16111,822,9595,27455,4462,3640,108015,2005
28,"Dinwiddie, Colonial Heights + Petersburg, VA*",1434117,88143,193057,162510,1396009,3416,1986,169398,2297189,74793,30501,2300605,131290,362585,542011,75427,6670,76779,274312,41956,35286,1083026,2005
29,"Essex, VA",164817,10023,19939,16236,190524,5218,4544,18141,299641,22276,29187,304859,43848,51729,62606,10445,1209,26820,28057,5518,4309,109940,2005
30,"Fairfax, Fairfax City + Falls Church, VA*",54681919,3011721,4886068,5430148,50305753,4652,3211,5726795,66619683,6161907,63380,66624335,1350629,13393712,2924870,1051190,138357,6165118,7601142,798631,660274,40915659,2005
31,"Fauquier, VA",1218148,70841,126416,122372,2163805,-8948,-18520,132027,3156112,187101,50205,3147164,1077684,780018,203341,62686,9217,168581,187602,32719,23502,861965,2005
32,"Floyd, VA",134070,8835,14634,11328,245000,4387,-891,14499,373416,38590,25898,377803,125429,56338,76465,14588,2351,37699,20298,5435,3084,76073,2005
33,"Fluvanna, VA",219941,14723,25353,19696,484987,-314,-883,24571,718293,53181,29525,717979,289617,133158,99834,24318,2741,52298,35201,7247,4506,132442,2005
34,"Franklin, VA",680470,42270,72643,67554,969171,5916,2005,76047,1468309,140186,28364,1474225,364748,241211,263843,51976,6468,142191,106420,22041,15573,431859,2005
35,"Frederick + Winchester, VA*",2635084,150306,289714,277056,2482581,-4582,-9286,288834,3376282,320553,35311,3371700,136331,514160,374959,95486,11449,311267,428242,65129,53680,1895575,2005
36,"Giles, VA",262959,16900,36885,29098,290177,574,390,31449,458276,27057,27050,458850,58667,57848,110825,16963,1659,27447,51434,7251,5592,184078,2005
37,"Gloucester, VA",408897,25751,51672,40040,838717,2680,2270,45771,1221896,58631,34006,1224576,475591,230441,155418,36011,3571,60901,71692,14110,10539,276304,2005
38,"Goochland, VA",1015554,58387,87134,75866,790925,112,-1773,96320,1200801,88862,62066,1200913,-128309,327005,82983,19349,2766,87089,125067,13670,10904,803398,2005
39,"Grayson, VA",127679,9073,15765,10870,248053,4016,2197,14508,400328,34096,25032,404344,134882,50969,105322,16153,2239,36293,21200,5137,2898,70186,2005
40,"Greene, VA",141360,9005,15041,12492,360504,1744,1299,15251,492186,33383,28792,493930,234395,72191,61235,17155,1824,34682,21287,4896,3072,85391,2005
41,"Greensville + Emporia, VA*",330066,19339,47222,37722,242445,6967,6290,38200,384458,7711,22089,391425,-49421,53037,95943,17720,863,14001,66083,9713,8850,249982,2005
42,"Halifax, VA",551135,34964,76100,60654,524957,10065,6845,65291,864929,45038,24078,874994,39113,124611,225426,36340,3154,51883,106427,17075,13921,392825,2005
43,"Hampton (Independent City), VA",3844038,198104,611858,446732,2974636,0,0,421470,4384208,139794,31025,4384208,-447932,754406,655166,141314,8383,139794,835224,81485,73102,2869020,2005
44,"Hanover, VA",2153241,126914,228897,230022,2895221,5953,-407,241925,3830409,242734,39775,3836362,983905,591504,349637,96451,11682,242327,343908,57651,45969,1567006,2005
45,"Henrico, VA",10869120,609777,1101343,1151414,8912458,1381,55,1185484,12507803,960401,43671,12509184,-771178,2475851,1120875,286441,31689,960456,1677050,213357,181668,8231614,2005
46,"Henry + Martinsville, VA*",1189734,76378,155227,135660,1025616,3973,3194,144208,1840006,102712,26321,1843979,-19910,352564,465799,70056,5551,105906,223057,36844,31293,860771,2005
47,"Highland, VA",27067,1675,3200,2014,32620,4505,4047,2682,63910,4723,27777,68415,8235,21158,14637,2463,682,8770,4207,1337,655,14090,2005
48,"Isle of Wight, VA",657745,38469,76025,64692,863225,11365,9181,70815,1187652,51341,36818,1199017,276295,183592,152200,32566,3176,60522,108371,16273,13097,488852,2005
49,"James City + Williamsburg, VA*",1868440,106454,220020,196322,1914606,1099,754,204615,3090669,209554,43652,3091768,250781,835375,341787,70828,9170,210308,318181,52763,43593,1339951,2005
50,"King George, VA",867757,43331,127535,91730,579867,664,310,89196,797938,68671,39002,798602,-198694,155459,63276,20476,2083,68981,173400,12979,10896,625376,2005
51,"King William, VA",207969,12575,23829,20756,357531,4217,1753,22953,494024,23946,34896,498241,172515,80011,60699,14278,1469,25699,34207,5684,4215,148063,2005
52,"King and Queen, VA",67739,4133,8913,6574,134254,4094,3466,7420,190454,9442,28644,194548,73935,25447,34847,6792,649,12908,12200,1925,1276,42631,2005
53,"Lancaster, VA",228399,15438,23827,21304,195747,818,635,26090,466405,44047,40512,467223,-6562,183263,88213,11533,1827,44682,34479,6952,5125,149238,2005
54,"Lee, VA",236147,16756,36165,24062,294960,-374,-1067,28787,547668,26102,21761,547294,87600,65711,186623,25150,2260,25035,48196,7961,5701,162916,2005
55,"Loudoun, VA",8652862,478040,877222,897392,10094004,-2311,-9957,926736,12563862,570350,49279,12561551,2367878,1990045,477502,254909,33370,560393,1325918,162117,128747,6766551,2005
56,"Louisa, VA",460347,27750,60150,43492,681422,-1387,-2577,49496,959284,74155,32106,957897,270571,143148,133327,29835,3343,71578,81896,11394,8051,306873,2005
57,"Lunenburg, VA",123435,8155,18213,13052,159217,-128,-1384,14681,285221,10834,21880,285093,50463,52153,73723,13030,928,9450,24739,4336,3408,89246,2005
58,"Madison, VA",157433,9877,16993,15216,262076,-229,-2326,17485,390669,36400,29791,390440,122128,74140,54224,13106,1947,34074,24601,5639,3692,98758,2005
59,"Mathews, VA",83845,6296,7957,6098,205341,915,286,9345,362587,29618,40560,363502,130841,100966,57195,8962,1329,29904,11006,3087,1758,42935,2005
60,"Mecklenburg, VA",476012,30986,67549,53532,431034,2276,-2068,57752,778082,34991,23971,780358,12774,140844,208480,32554,2746,32923,94315,16403,13657,348774,2005
61,"Middlesex, VA",152270,10165,19448,13836,191731,1806,886,17083,350919,29288,33510,352725,56544,92669,68325,10526,1698,30174,26366,5537,3839,95730,2005
62,"Montgomery + Radford, VA*",2190587,122824,331677,235132,1705354,4352,1885,240390,2563932,155950,24532,2568284,-244843,501377,361553,104691,9192,157835,449243,58498,49306,1583509,2005
63,"Nelson, VA",169245,11770,18230,14672,291605,1027,-1294,19106,471919,44425,31895,472946,141466,97467,83874,14828,2455,43131,25566,6177,3722,100548,2005
64,"New Kent, VA",173505,10977,20330,17792,532262,365,30,19873,671177,28253,42095,671542,378630,80477,58803,15953,2102,28283,29226,6042,3940,115996,2005
65,"Newport News (Independent City), VA",5408168,288175,818165,604556,3626137,0,0,590453,5397357,220048,29389,5397357,-1191578,942691,828529,183651,11599,220048,1120443,119148,107549,4067677,2005
66,"Norfolk (Independent City), VA",13075855,631289,1958823,1424984,5466186,0,0,1343781,8217623,1447825,34290,8217623,-6265888,1611928,1139509,239650,14963,1447825,2671315,227100,212137,8956715,2005
67,"Northampton, VA",270090,13512,26723,22568,235879,60206,48621,24796,343109,33187,31581,403315,-9415,76543,90893,12771,1677,81808,38007,7300,5623,150275,2005
68,"Northumberland, VA",132450,9591,14656,12320,171557,3307,2777,15751,391818,28409,31607,395125,54858,135656,87912,12501,1621,31186,20816,4752,3131,80448,2005
69,"Nottoway, VA",245611,15207,39738,27940,234041,6226,4974,29177,403930,14058,25967,410156,17607,70126,105989,15795,1377,19032,53708,7712,6335,172871,2005
70,"Orange, VA",423172,27334,46456,40764,641000,12787,4996,47716,994831,73042,33598,1007618,265544,204805,161813,29990,3973,78038,66838,13268,9295,278296,2005
71,"Page, VA",307817,17977,35039,28808,423115,35566,33768,32381,603349,48051,26949,638915,147679,88578,127222,23708,2542,81819,49443,9412,6870,176555,2005
72,"Patrick, VA",193294,13489,26142,20394,239672,2270,-679,23686,411783,26706,22022,414053,70064,60309,114072,18802,2218,26027,36339,7648,5430,130928,2005
73,"Pittsylvania + Danville, VA*",1753182,110595,229232,202156,1620359,12856,6775,211673,2717346,111538,25385,2730202,78850,432819,677024,107553,8125,118313,330310,52683,44558,1304559,2005
74,"Portsmouth (Independent City), VA",2786608,144097,473039,318468,1827398,0,0,303331,2868358,89625,29248,2868358,-655879,476041,564919,98069,5758,89625,632273,55714,49956,2064710,2005
75,"Powhatan, VA",330461,19895,38288,31330,707304,1879,1191,35560,923045,59423,35072,924924,412403,133717,83903,26372,2924,60614,53953,9728,6804,215894,2005
76,"Prince Edward, VA",353184,21563,47945,37930,265557,3530,2788,40528,441146,35230,20837,444676,-47099,77529,101590,21341,1873,38018,66910,11259,9386,248256,2005
77,"Prince George + Hopewell, VA*",1425500,71251,246396,164396,1064624,-586,-878,153449,1591467,38363,27945,1590881,-207427,275791,250466,56929,3118,37485,328594,28043,24925,1059421,2005
78,"Prince William, Manassas + Manassas Park, VA*",7853938,429888,870486,837612,12594711,-1649,-3942,848694,15840685,882565,39646,15839036,5589467,2288796,955529,399515,42475,878623,1289292,186197,143722,5686023,2005
79,"Pulaski, VA",721295,42799,100016,81398,658382,4210,2857,83498,986677,55370,28516,990887,20585,124170,208335,34748,2668,58227,140715,18490,15822,522353,2005
80,"Rappahannock, VA",108245,7238,8922,8508,188550,-2602,-3705,11492,303165,36453,40705,300563,91797,79785,32228,7384,1501,32748,13176,3390,1889,62321,2005
81,"Richmond (Independent City), VA",10739651,597557,1299943,1095148,4632422,0,0,1145131,7937219,912245,40196,7937219,-4962098,2169857,1134940,197465,14495,912245,1847517,185866,171371,7979889,2005
82,"Richmond, VA",129578,8029,18754,12888,119959,3812,2813,14473,204522,12926,22613,208334,4854,41520,46855,9213,903,15739,25198,4042,3139,88641,2005
83,"Roanoke (Independent City), VA",3500210,208881,434584,420578,1707012,0,0,419170,2850428,156800,30346,2850428,-1374028,526005,617411,93932,7584,156800,644873,83976,76392,2698537,2005
84,"Roanoke + Salem, VA*",3119055,174496,382737,334024,2851269,1230,570,341508,4250132,283077,37439,4251362,73722,847518,552575,113555,12104,283647,549749,73939,61835,2285659,2005
85,"Rockbridge, Buena Vista + Lexington, VA*",627324,38761,78173,67586,585550,4717,3235,72554,981943,70263,27971,986660,30780,218454,182656,35275,4196,73498,111966,19936,15740,441860,2005
86,"Rockingham + Harrisonburg, VA*",2802853,150911,335104,278470,2247680,143976,131215,290146,3066005,281588,27529,3209981,-265027,515444,446857,116602,13174,412803,474339,74983,61809,1915711,2005
87,"Russell, VA",360462,23873,50625,42078,396168,4074,2958,44912,670973,27185,23679,675047,80618,73574,205305,28508,2489,30143,71664,11315,8826,258655,2005
88,"Scott, VA",202779,15376,25972,20040,310574,4486,3651,25396,540848,28529,23624,545334,133191,75532,159228,23084,2759,32180,35992,7849,5090,134607,2005
89,"Shenandoah, VA",673634,40949,78283,64414,786469,11210,8624,73156,1177364,115059,30162,1188574,185991,211902,190203,39406,5528,123683,110490,20959,15431,439461,2005
90,"Smyth, VA",608643,37539,88071,66646,501971,4508,3068,70862,812189,51256,25114,816697,-35810,110022,204704,32519,3252,54324,121394,18020,14768,432925,2005
91,"Southampton + Franklin, VA*",395226,23118,50484,37262,475851,34649,31879,41749,715760,35435,28765,750409,122374,121919,152639,26088,2193,67314,69115,11305,9112,258797,2005
92,"Spotsylvania + Fredericksburg, VA*",2818137,162724,303892,289360,3719466,-4767,-6020,307404,4999791,360326,36546,4995024,1208733,828049,447509,136677,12806,354306,448572,72348,59542,2015259,2005
93,"Stafford, VA",1839347,98858,224577,191016,3489326,-1843,-2155,194366,4484376,220555,38113,4482533,1844345,703882,289325,117611,10658,218400,320085,45510,34852,1300862,2005
94,"Suffolk (Independent City), VA",1206667,71264,150836,128258,1853621,13970,4656,135393,2639376,110125,34036,2653346,782347,441773,357952,77957,6607,114781,214965,31925,25318,876921,2005
95,"Surry, VA",151044,8165,26795,15034,133131,4859,3391,15682,186448,5312,27867,191307,-2231,26691,31485,6865,538,8703,34312,2602,2064,108029,2005
96,"Sussex, VA",164479,10310,23492,17546,172790,6922,5101,19083,272727,7522,23435,279649,27394,40368,66491,11933,745,12623,32265,4737,3992,119591,2005
97,"Tazewell, VA",697926,46508,94260,74786,648974,-2079,-2813,83901,1158998,70000,26279,1156919,34949,174969,332976,44025,3578,67187,131653,21683,18105,499086,2005
98,Virginia,230658070,12810602,26673036,24140418,215285629,575192,352797,24880811,303774762,22477551,40167,304349954,9508370,57465406,31598919,7577105,785765,22830348,38743245,4701063,3915298,169084477,2005
99,"Virginia Beach (Independent City), VA",10109881,545181,1278990,1078150,12226185,2424,933,1084256,17482043,1139182,40083,17484467,3200560,3664057,1594225,436210,40781,1140115,1818065,249002,208221,7151701,2005
100,"Warren, VA",529299,31765,61327,53770,868234,-2542,-3073,58650,1200383,82732,33833,1197841,397585,185432,144175,35405,4214,79659,88212,15982,11768,361428,2005
101,"Washington + Bristol, VA*",1434409,87244,192894,155072,1191214,4330,1085,164780,2031799,134264,28909,2036129,-78415,418819,426096,70433,7874,135349,270430,42874,35000,1028630,2005
102,"Westmoreland, VA",155119,10760,17866,13992,295833,7698,2884,17756,487707,31098,29564,495405,158470,100244,99328,16757,1868,33982,24862,5717,3849,96275,2005
103,"Wise + Norton, VA*",869946,55207,113189,92942,622523,-511,-597,101678,1111181,86108,24490,1110670,-145745,124137,364010,45352,2863,85511,159660,22777,19914,624775,2005
104,"Wythe, VA",457058,29330,62937,50162,461953,-9,-2125,54411,725364,45487,25587,725355,59306,98765,164637,28349,3094,43362,88018,15590,12496,325678,2005
105,"York + Poquoson, VA*",1105990,65572,140334,113706,2153192,1880,1351,122425,3063229,152922,40893,3065109,1169627,648585,263332,74955,5851,154273,197187,30172,24321,754530,2005
0,"Accomack, VA",611660,36676,75073,61996,564650,36232,26609,67674,939800,62592,27734,976032,20664,181772,229610,35192,3738,89201,106071,18074,14336,416388,2006
1,"Albemarle + Charlottesville, VA*",5157536,293059,600959,519698,3633005,-11853,-18657,552908,6482913,591316,47963,6471060,-971623,2263103,574952,134918,19708,572659,860808,111718,92010,3724069,2006
2,"Alexandria (Independent City), VA",8500302,453798,907885,950976,6443517,0,0,929286,9007342,598573,70548,9007342,-1127499,2134830,428995,127676,16752,598573,1383373,127375,110623,6518356,2006
3,"Alleghany + Covington, VA*",425045,28293,50261,48174,359527,-850,-998,52380,636260,26279,28187,635410,-13138,95592,180291,22543,1463,25281,74348,10945,9482,325416,2006
4,"Amelia, VA",137316,9605,14600,14376,255976,-1821,-5310,16793,388138,22897,31536,386317,135453,59714,70627,12250,1610,17587,21788,4883,3273,97941,2006
5,"Amherst, VA",450533,30128,55574,48908,566752,-2690,-3454,54582,880007,43778,27336,877317,170801,122578,187987,32094,2751,40324,80028,13373,10622,330181,2006
6,"Appomattox, VA",156689,11453,17787,15794,260847,-4521,-4821,19350,406356,28514,28268,401835,123508,53105,87883,14215,1538,23693,25684,5261,3723,107312,2006
7,"Arlington, VA",16200895,841026,1878330,1742144,10184371,0,0,1712098,13755639,1142617,73100,13755639,-4304426,2990236,581032,188176,23823,1142617,2749402,193707,169884,12308876,2006
8,"Augusta, Staunton + Waynesboro, VA*",2311694,143649,264795,241784,2297007,15669,6378,264541,3570929,253304,30849,3586598,249854,640517,649074,116262,12549,259682,385687,63738,51189,1666325,2006
9,"Bath, VA",106756,6829,11480,11528,89956,-277,-825,12593,167733,13272,34720,167456,-4207,45285,32215,4823,651,12447,17244,3302,2651,77065,2006
10,"Bedford, VA*",895012,61768,91082,91800,1596707,-12204,-14178,107668,2466860,154928,33853,2454656,809363,474232,383717,72510,8557,140750,136982,28570,20013,617280,2006
11,"Bland, VA",92827,6274,14253,10062,98011,-759,-1517,11305,163385,7880,23776,162626,16489,20579,44036,6840,802,6363,19284,2847,2045,67180,2006
12,"Botetourt, VA",514746,33200,56338,52718,837433,-1815,-3362,59559,1190119,71422,36573,1188304,382246,190632,160239,32491,3842,68060,82697,14434,10592,363989,2006
13,"Brunswick, VA",208233,14270,27079,22352,237746,2921,1232,25446,408499,13992,22843,411420,54959,55882,117792,18011,1262,15224,38255,6661,5399,154754,2006
14,"Buchanan, VA",421398,29937,49207,43798,325314,-791,-823,51836,643562,45584,25702,642771,-44248,80438,237019,25009,1273,44761,71106,9474,8201,305531,2006
15,"Buckingham, VA",160461,10816,20043,15096,211376,2934,2000,18364,342283,22962,20863,345217,69279,52281,81560,16547,1322,24962,27591,4875,3553,107908,2006
16,"Campbell + Lynchburg, VA*",3457606,208582,373046,392844,2170803,-3408,-5322,405004,3645527,195108,29279,3642119,-881799,672753,798563,124394,10524,189786,569468,85551,75027,2698352,2006
17,"Caroline, VA",276630,18216,32882,26914,599772,-1218,-3022,31673,840709,48203,31416,839491,354815,114302,125417,26722,2448,45181,46339,8254,5806,185110,2006
18,"Carroll + Galax, VA*",533294,36587,62132,58106,520815,4498,2963,65640,913027,62581,24951,917525,53161,124938,271772,36773,3331,65544,91185,17422,14091,376565,2006
19,"Charles City, VA",94025,6085,9404,8974,155101,3362,2399,10572,233073,15539,33040,236435,71648,42693,38641,7156,474,17938,13891,2309,1835,62196,2006
20,"Charlotte, VA",128836,9630,16514,12650,166848,1899,380,15955,300373,20855,23743,302272,53967,46832,88592,12731,1786,21235,22839,5010,3224,84762,2006
21,"Chesapeake (Independent City), VA",4854180,283788,511647,543094,6019499,6307,142,555335,8176526,369658,37662,8182833,1720654,1290905,872429,217271,18563,369800,783194,124634,106071,3701186,2006
22,"Chesterfield, VA",6805853,396459,707641,713020,9144496,519,-196,752969,12301880,721203,41215,12302399,3091612,2064626,1093277,298496,31923,721007,1064151,159381,127458,5020695,2006
23,"Clarke, VA",249660,15586,22265,23564,414263,-4194,-8502,27368,639945,59674,45610,635751,191971,162814,58674,13939,2688,51172,34047,7402,4714,164441,2006
24,"Craig, VA",31757,2615,4001,2714,96992,632,322,3972,144294,7463,28097,144926,69207,19047,28887,5158,569,7785,5358,1293,724,18614,2006
25,"Culpeper, VA",828984,50170,83977,82826,1094352,-2049,-6399,91583,1538881,133577,34868,1536832,356951,259383,183097,44076,5969,127178,125390,21889,15920,576416,2006
26,"Cumberland, VA",71030,5106,7702,5966,159050,5888,4872,8089,242535,14299,25888,248423,96109,35657,53716,9596,797,19171,10685,2350,1553,41174,2006
27,"Dickenson, VA",160953,13171,20731,16912,174106,-2190,-2239,21627,371406,12898,23137,369216,34780,44080,151030,15958,810,10659,29187,4654,3844,121107,2006
28,"Dinwiddie, Colonial Heights + Petersburg, VA*",1482461,93488,179628,166262,1441808,134,-1431,176619,2393148,86290,31336,2393282,135966,369595,581879,76375,6740,84859,262759,42036,35296,1134843,2006
29,"Essex, VA",172964,10975,18666,17046,200642,5568,4819,19498,317824,24118,30578,323392,47176,55510,67240,10576,1246,28937,27189,5547,4301,116838,2006
30,"Fairfax, Fairfax City + Falls Church, VA*",57465616,3212146,4779474,5783580,51723307,4226,2790,6103936,69971864,6364424,66565,69976090,361627,15088005,3164778,1051240,143153,6367214,7671264,810456,667303,43427138,2006
31,"Fauquier, VA",1299051,77753,119911,128662,2243501,-17069,-28651,142084,3378827,225697,52724,3361758,1086534,893140,225117,63761,9383,197046,184242,33272,23889,917763,2006
32,"Floyd, VA",133057,9752,13919,11604,248051,171,-5944,15554,391118,38756,26507,391289,130548,59660,83578,14762,2336,32812,19721,5464,3128,80524,2006
33,"Fluvanna, VA",236400,16356,24984,21020,522154,-1492,-2144,26866,790184,58497,32011,788692,312620,157650,108888,24638,2819,56353,35494,7433,4614,144553,2006
34,"Franklin, VA",709607,47601,69967,71888,1000489,1153,-3375,83545,1560411,142742,29443,1561564,374427,265395,295680,53037,6706,139367,105911,23096,16390,464329,2006
35,"Frederick + Winchester, VA*",2773525,162131,277370,294246,2656717,-10469,-15799,309254,3681162,339637,37375,3670693,192446,601183,412793,98213,11702,323838,424493,67279,55577,2025194,2006
36,"Giles, VA",267467,18008,33696,30010,298789,-1478,-1715,33013,479723,30666,27868,478245,64335,63058,116398,17161,1658,28951,48701,7228,5570,189815,2006
37,"Gloucester, VA",437718,28665,49047,43220,891852,1893,1448,50275,1324904,63897,36632,1326797,504409,262299,172646,36220,3796,65345,70657,14652,10856,301716,2006
38,"Goochland, VA",876886,51495,78294,78714,834304,-2393,-4825,90852,1319875,85217,65299,1317482,48270,392316,90862,20176,2920,80392,117651,14004,11084,678843,2006
39,"Grayson, VA",124491,10397,14628,10898,242744,1966,-53,15846,411338,32779,25677,413304,134099,56617,113943,16096,2170,32726,20077,5036,2866,71688,2006
40,"Greene, VA",156230,10386,14958,13814,386292,962,433,17293,540092,38243,30729,541054,247355,87325,67437,17607,1909,38676,21865,5151,3242,95689,2006
41,"Greensville + Emporia, VA*",333877,20556,43499,38510,252740,5342,4603,39811,410983,9606,23413,416325,-41326,58742,104843,17782,986,14209,62754,9826,8840,256914,2006
42,"Halifax, VA",564223,37253,70544,61644,538112,13511,9934,68075,914365,48403,25503,927876,41964,136598,253166,36383,3174,58337,101366,16945,13771,404520,2006
43,"Hampton (Independent City), VA",3956310,208236,594423,470432,3032790,0,0,443452,4545370,146051,32274,4545370,-480068,799749,712831,140839,8746,146051,829639,80619,71873,2980620,2006
44,"Hanover, VA",2334623,138639,220499,247926,3058223,4855,-2306,262602,4094560,280699,41820,4099415,986202,661383,379809,98025,12106,278393,344462,59197,47091,1711768,2006
45,"Henrico, VA",11499479,662940,1050475,1202686,9334549,1075,-369,1264283,13265588,1181980,45518,13266663,-900647,2701040,1231074,291460,33710,1181611,1651818,218733,185023,8666050,2006
46,"Henry + Martinsville, VA*",1214447,81223,142938,141316,1042757,3966,3030,151881,1959828,100059,28157,1963794,-19809,408995,512042,69745,5496,103089,213596,37314,31818,897762,2006
47,"Highland, VA",25608,1842,2958,2050,31368,2078,1555,2867,65820,5593,27389,67898,8627,19688,16842,2479,693,7148,3983,1336,643,14477,2006
48,"Isle of Wight, VA",658939,40409,67508,65086,946846,8837,6458,72952,1328987,56828,39679,1337824,360859,219674,171304,33716,3240,63286,100051,15563,12323,495602,2006
49,"James City + Williamsburg, VA*",2077974,124106,215802,211192,2166842,611,274,229702,3486035,290963,47153,3486646,318570,933151,386653,73943,9636,291237,321398,54189,44553,1465339,2006
50,"King George, VA",915066,46793,129092,97292,638843,-779,-1213,95439,886907,84367,41179,886128,-180784,176234,71051,21519,2245,83154,177738,13160,10915,654174,2006
51,"King William, VA",212170,13418,21723,21292,376445,4309,1513,24064,518645,25709,35159,522954,188339,79427,67082,14874,1561,27222,32369,5769,4208,152579,2006
52,"King and Queen, VA",68705,4453,8386,6746,137976,2936,2311,7826,199172,10872,29227,202108,77097,25136,38996,6915,681,13183,11759,1956,1275,43763,2006
53,"Lancaster, VA",230526,15969,21861,21464,198340,416,178,26701,501198,46201,43426,501614,-5485,207363,95911,11551,1892,46379,32593,7034,5142,151554,2006
54,"Lee, VA",238620,18395,35126,24998,300707,-4581,-5377,30894,576004,25879,22650,571423,92981,69383,201333,25228,2211,20502,47625,8023,5812,170493,2006
55,"Loudoun, VA",9254028,521643,828964,970202,11922275,-8320,-17648,1006744,14731690,674805,55104,14723370,3674991,2267830,533265,267194,34821,657157,1314065,168881,134060,7282806,2006
56,"Louisa, VA",503434,31262,60829,47164,727008,-3765,-5047,54844,1043241,80331,33590,1039476,278418,162372,150096,30946,3453,75284,84411,11729,8276,343739,2006
57,"Lunenburg, VA",127253,9129,16846,13278,163015,590,-671,15768,296566,12134,22736,297156,51530,54338,79803,13070,947,11463,23485,4386,3439,92305,2006
58,"Madison, VA",160935,10842,16129,15544,269750,-4107,-6569,18614,407644,40065,30362,403537,127429,72521,61266,13291,2002,33496,23901,5705,3703,103538,2006
59,"Mathews, VA",87496,6799,7390,6488,206370,653,64,10043,372565,30827,41529,373218,128917,104807,62041,8987,1386,30891,10634,3166,1780,45971,2006
60,"Mecklenburg, VA",486960,33067,62661,54254,443426,2880,-1702,60194,819860,39523,25205,822740,16660,153009,226305,32642,2849,37821,89788,16488,13639,359351,2006
61,"Middlesex, VA",159804,11081,18149,14628,197907,1388,374,18395,370737,31115,34674,372125,56498,99712,74506,10732,1778,31489,25463,5632,3854,102852,2006
62,"Montgomery + Radford, VA*",2294850,131908,320908,244274,1796198,1078,-1776,254045,2766108,172875,26050,2767186,-244607,573887,397101,106225,9681,171099,443045,59316,49635,1680706,2006
63,"Nelson, VA",181593,12692,17576,15490,307156,-191,-3064,20437,503339,51263,33976,503148,146000,104020,91972,14809,2498,48199,25321,6322,3824,108073,2006
64,"New Kent, VA",182139,11863,19199,18732,583839,-161,-490,21229,740672,30427,44395,740511,422929,91181,65491,16680,2261,29937,28565,6243,3982,123637,2006
65,"Newport News (Independent City), VA",5580002,304009,774192,624244,3833218,0,0,616131,5747601,261584,31308,5747601,-1130653,1028684,885699,183581,12020,261584,1086314,119805,107785,4232104,2006
66,"Norfolk (Independent City), VA",13833290,664753,1989987,1555420,5769053,0,0,1442463,8763320,1567274,36003,8763320,-6621774,1788485,1205782,243406,15931,1567274,2767697,228053,212122,9498319,2006
67,"Northampton, VA",280870,14374,25669,23524,243789,65612,51705,26136,351248,30679,32628,416860,-10945,74336,98735,12776,1651,82384,37431,7251,5600,161055,2006
68,"Northumberland, VA",136260,10719,13611,12800,172537,2598,1933,17119,407829,29873,33019,410427,53396,141945,95945,12430,1660,31806,20011,4797,3137,84443,2006
69,"Nottoway, VA",252819,16417,38335,29074,238488,2800,1326,30954,427245,15134,27358,430045,16623,75971,115586,15719,1388,16460,52872,7860,6472,183487,2006
70,"Orange, VA",450740,29632,44128,43406,687406,14074,4963,51335,1082446,77739,34879,1096520,288001,232502,176612,31438,4151,82702,65831,13548,9397,302207,2006
71,"Page, VA",291847,19139,31280,28290,417901,18669,16654,33284,636130,55279,27232,654799,159338,98018,138880,24045,2594,71933,45425,9157,6563,174489,2006
72,"Patrick, VA",199325,14690,24610,21474,245386,667,-2305,25427,432462,27003,23081,433129,71488,63381,124362,18766,2274,24698,35347,7783,5509,139280,2006
73,"Pittsylvania + Danville, VA*",1691747,113032,200594,195010,1572425,8885,2163,210537,2722507,114655,25486,2731392,91215,420009,738958,107172,8198,116818,298099,50874,42676,1276830,2006
74,"Portsmouth (Independent City), VA",2963115,155574,487668,347556,1888370,0,0,329352,2992594,79834,30163,2992594,-745393,504184,600040,99213,6254,79834,661446,56913,50659,2221835,2006
75,"Powhatan, VA",351975,21953,36833,33102,749212,925,191,38504,996311,64013,36407,997236,435741,153521,94503,27391,3094,64204,53384,10241,7147,234387,2006
76,"Prince Edward, VA",368362,22913,46329,39876,280009,2063,1210,42851,479041,36270,22148,481104,-45502,88821,112274,21722,2082,37480,66267,11804,9722,264615,2006
77,"Prince George + Hopewell, VA*",1548999,77718,259797,180410,1087539,-1217,-1476,167923,1671032,43387,29362,1669815,-293537,308710,273566,56870,3209,41911,350002,29364,26155,1157086,2006
78,"Prince William, Manassas + Manassas Park, VA*",8446363,470707,858157,903772,13505271,-4200,-6903,922593,17062356,993144,41882,17058156,5981501,2480312,1072573,407295,44848,986241,1310043,192380,147532,6150079,2006
79,"Pulaski, VA",739715,45848,93355,84434,656380,2237,864,88065,1005932,57563,28895,1008169,4730,124239,227550,34891,2658,58427,135572,18418,15760,545716,2006
80,"Rappahannock, VA",113934,7712,8530,9132,202621,-5067,-6364,12278,335738,36700,45001,330671,100965,92531,35519,7348,1519,30336,13096,3423,1904,70502,2006
81,"Richmond (Independent City), VA",11151581,622272,1243745,1139824,4920258,0,0,1192184,8801842,1054849,44315,8801842,-5039139,2661390,1220194,198618,15453,1054849,1813657,187161,171708,8283075,2006
82,"Richmond, VA",136363,8677,17759,13544,127702,3549,2332,15449,222360,14252,24218,225909,6788,46963,51244,9328,933,16584,24531,4098,3165,95248,2006
83,"Roanoke (Independent City), VA",3625583,214798,408658,439154,1768321,0,0,434375,2948268,163779,31282,2948268,-1422887,520104,659843,94247,8028,163779,628235,85425,77397,2833569,2006
84,"Roanoke + Salem, VA*",3261786,194843,365885,349502,2969416,-361,-944,369594,4480012,318973,38955,4479651,77224,904335,605900,114997,12218,318029,540636,75767,63549,2403121,2006
85,"Rockbridge, Buena Vista + Lexington, VA*",647249,41646,72368,70354,602103,-117,-1778,76823,1050014,77951,29501,1049897,31677,242748,205046,35588,4359,76173,107545,20122,15763,463531,2006
86,"Rockingham + Harrisonburg, VA*",2908778,166728,318271,298966,2281138,75526,62257,316211,3273656,310739,28178,3349182,-311429,577468,490576,118858,13546,372996,467754,77390,63844,2068028,2006
87,"Russell, VA",355674,25949,46334,40346,405201,13,-1151,46122,708541,31465,24759,708554,95649,78914,224439,28618,2533,30314,66507,11132,8599,258853,2006
88,"Scott, VA",208953,17436,25682,22240,313723,-893,-1762,28556,584293,25843,25069,583400,133326,92002,177675,23272,2748,24081,36802,8166,5418,148070,2006
89,"Shenandoah, VA",690561,43850,71957,66608,818388,7173,4148,77154,1258664,122719,31171,1265837,204981,234997,212452,40610,5727,126867,105261,21234,15507,458433,2006
90,"Smyth, VA",602075,39160,79156,66068,498000,2234,546,72194,850085,52748,26119,852319,-31881,124462,229857,32632,3257,53294,112190,17740,14483,436591,2006
91,"Southampton + Franklin, VA*",412159,24978,48630,39350,486721,31412,28387,44653,755701,40962,29683,787113,119215,132878,167514,26517,2309,69349,68305,11641,9332,274505,2006
92,"Spotsylvania + Fredericksburg, VA*",2969907,173593,288364,305562,3961334,-7210,-8664,326374,5413550,395736,38515,5406340,1317801,946066,498940,140370,13323,387072,441145,74260,60937,2141690,2006
93,"Stafford, VA",2021712,112896,226596,211074,3766231,-2733,-3109,218433,4847446,244439,40409,4844713,1962952,755012,323470,119892,11275,241330,332133,47697,36422,1448249,2006
94,"Suffolk (Independent City), VA",1293386,78626,147518,139880,2009115,13564,3025,148566,2932160,112437,36688,2945724,864295,541151,395458,80291,6830,115462,217458,33303,26473,960466,2006
95,"Surry, VA",183389,10173,31847,19000,143684,2978,1390,19673,202992,6101,29462,205970,-20032,26204,36082,6991,565,7491,41347,2788,2223,134551,2006
96,"Sussex, VA",174498,11058,23339,18642,179502,6056,3995,20379,289188,8138,24214,295244,25383,43100,72642,12193,779,12133,32660,4931,4152,129705,2006
97,"Tazewell, VA",729347,49841,90766,78546,678665,-4904,-5640,89114,1242147,72749,27995,1237243,38432,200419,358159,44195,3577,67109,130039,22134,18557,532199,2006
98,Virginia,241780122,13710106,25901429,25567082,226095010,277006,26794,26493647,324974788,24124506,42385,325251794,10808535,64595340,34561444,7673725,816146,24151300,38684970,4781825,3965679,178943852,2006
99,"Virginia Beach (Independent City), VA",10608980,581440,1243343,1149164,12647762,1572,-133,1156022,18470232,1200613,42198,18471804,3194804,4093591,1730451,437739,42479,1200480,1817925,251645,209166,7590575,2006
100,"Warren, VA",564621,35067,58556,57932,917777,-4955,-5633,64033,1280016,87107,35193,1275061,417189,200166,157118,36231,4356,81474,87522,16708,12352,395625,2006
101,"Washington + Bristol, VA*",1546028,97346,178210,162258,1296394,-2100,-5309,178475,2296189,208676,32308,2294089,-71159,527512,470183,71006,8273,203367,259339,43365,35092,1083322,2006
102,"Westmoreland, VA",160297,11727,17204,14852,300116,7035,1556,19153,513018,30727,30880,520053,158972,114161,105776,16841,1936,32283,24630,5962,4026,103384,2006
103,"Wise + Norton, VA*",870601,57015,108277,94710,621868,-995,-1087,104370,1148468,73132,25299,1147473,-144363,133233,392372,45356,2868,72045,155632,22711,19843,642924,2006
104,"Wythe, VA",475636,31583,61025,52830,478590,-6050,-8457,57998,779214,46249,27007,773164,60952,109190,185384,28628,3157,37792,87440,15774,12617,350404,2006
105,"York + Poquoson, VA*",1183152,69767,140149,122712,2310972,2152,1577,131123,3348585,165485,44135,3350737,1258943,742826,296939,75920,5972,167062,201505,31428,25456,814585,2006
0,"Accomack, VA",617759,38087,79052,63760,568760,34837,23864,69967,1003030,51856,30037,1037867,20968,229527,239580,34553,3846,75720,110932,18129,14283,431107,2007
1,"Albemarle + Charlottesville, VA*",5453029,313879,636367,549606,3832674,-13647,-22326,588682,6909178,586871,50499,6895531,-1031673,2456784,606073,136547,20837,564545,911170,114577,93740,3977314,2007
2,"Alexandria (Independent City), VA",8778287,473399,941474,969922,6672548,0,0,958360,9277611,574611,71822,9277611,-1147379,2144899,460164,129175,17918,574611,1426435,127199,109281,6777241,2007
3,"Alleghany + Covington, VA*",429715,29149,53134,47972,367384,-1476,-1621,53135,658856,24766,29104,657380,-9196,102857,187139,22587,1494,23145,77120,10850,9356,329450,2007
4,"Amelia, VA",145533,10165,15749,14858,280763,2888,-1305,17594,414668,21503,33547,417556,152824,64934,71859,12447,1753,20198,23178,5040,3287,102157,2007
5,"Amherst, VA",465531,31809,59416,49928,582193,-3763,-4618,56773,921894,39594,28511,918131,173435,136951,198987,32203,2881,34976,84380,13498,10617,346175,2007
6,"Appomattox, VA",157249,11896,19070,15972,267709,-4459,-4813,19882,431878,24243,29630,427419,130342,63256,96454,14425,1615,19430,27056,5353,3738,110763,2007
7,"Arlington, VA",16859342,881197,1959624,1817842,10705971,0,0,1790118,14582687,978966,76446,14582687,-4363253,3271644,605072,190759,25457,978966,2868545,198545,173088,13011831,2007
8,"Augusta, Staunton + Waynesboro, VA*",2539640,158771,283156,246520,2541718,20896,9688,282031,3944703,394974,33690,3965599,284109,737965,685916,117708,13211,404662,406416,64894,51683,1728562,2007
9,"Bath, VA",107715,7057,12170,11658,88830,-538,-1212,12886,179426,10504,36999,178888,-5999,55929,34129,4835,672,9292,17999,3333,2661,80424,2007
10,"Bedford, VA*",930580,65729,99834,95372,1651004,-12059,-14385,113415,2571015,143449,34787,2558956,833839,493052,414900,73561,9100,129064,147520,29766,20666,653996,2007
11,"Bland, VA",102999,6955,16295,11048,102246,-1226,-2089,12479,172674,8399,24740,171448,11726,24851,44351,6930,832,6310,21819,2972,2140,74870,2007
12,"Botetourt, VA",530963,35017,61549,56194,878399,-3019,-4749,63114,1271291,61104,38808,1268272,410550,215823,174050,32681,4042,56355,89646,15124,11082,384962,2007
13,"Brunswick, VA",212839,14860,28889,22684,246736,2741,898,26202,431715,12578,24376,434456,60099,66415,121305,17823,1332,13476,40231,6739,5407,159132,2007
14,"Buchanan, VA",436207,31741,50405,45816,333015,-1074,-1119,54649,669389,38618,27090,668315,-48543,96068,239232,24670,1353,37499,73313,9857,8504,325395,2007
15,"Buckingham, VA",167481,11567,21411,15712,224415,2255,1035,19423,367319,24022,22081,369574,76357,56746,88413,16737,1374,25057,29267,4956,3582,113157,2007
16,"Campbell + Lynchburg, VA*",3618361,219630,396895,404614,2284908,-4771,-7013,421937,3874687,187126,30559,3869916,-911516,743750,841258,126638,11623,180113,599202,87332,75709,2839046,2007
17,"Caroline, VA",283786,19342,35892,28648,639581,-4121,-6241,33666,913192,41617,32947,909071,389461,134906,134584,27592,2583,35376,50216,8535,5952,198194,2007
18,"Carroll + Galax, VA*",526354,37602,66209,56270,538174,-2585,-4342,65737,969169,57917,26257,966584,77557,145090,283320,36813,3501,53575,94344,17493,13992,378435,2007
19,"Charles City, VA",98150,6436,10100,9556,153243,4131,2945,11214,231033,13318,32899,235164,66307,41945,39976,7148,537,16263,14878,2345,1808,67009,2007
20,"Charlotte, VA",131782,10119,17749,12818,171131,2556,1016,16528,321112,20010,25526,323668,55877,58285,94252,12680,1904,21026,24158,5130,3226,86598,2007
21,"Chesapeake (Independent City), VA",5020920,295715,550958,555624,6272675,6131,-859,573527,8653874,323459,39825,8660005,1825282,1453009,934321,217450,20438,322600,828770,127260,106822,3869550,2007
22,"Chesterfield, VA",7090347,417875,752548,737200,9661500,-158,-693,786475,13056842,699895,42860,13056684,3357628,2201696,1193488,304636,34721,699202,1121148,163918,129197,5269997,2007
23,"Clarke, VA",258168,16605,23778,24554,433047,-5651,-10908,28882,664836,60260,47189,659185,203761,163247,62891,13969,2815,49352,36055,7530,4715,172761,2007
24,"Craig, VA",31494,2803,4210,2904,92298,-564,-922,4255,144821,6545,27678,144257,65059,21409,30550,5212,620,5623,5662,1349,729,20209,2007
25,"Culpeper, VA",845304,52292,90455,84446,1134644,-3502,-8063,94515,1631403,127110,35757,1627901,383855,292053,201204,45527,6147,119047,132678,22237,16090,593579,2007
26,"Cumberland, VA",75511,5532,8507,6380,168856,7679,6525,8722,258538,13275,27271,266217,102067,39084,58277,9762,779,19800,11697,2380,1601,44014,2007
27,"Dickenson, VA",172518,14333,22318,18182,179242,-2874,-2931,23424,386192,12342,24001,383318,30148,48669,155407,15971,878,9411,31409,4854,3976,131698,2007
28,"Dinwiddie, Colonial Heights + Petersburg, VA*",1542725,98131,192389,168068,1495540,279,-1495,182165,2525051,87995,32857,2525330,134980,403691,626099,76858,7350,86500,276423,42701,35351,1179802,2007
29,"Essex, VA",178773,11798,20076,18128,210236,2444,1564,20862,343929,21867,32254,346373,52325,64681,71456,10739,1331,23431,29140,5694,4363,126202,2007
30,"Fairfax, Fairfax City + Falls Church, VA*",59794227,3379102,5016424,6020066,52507436,6256,4755,6389135,72734733,5512210,68601,72740989,-897656,16858062,3375491,1060356,152621,5516965,8026457,827412,674791,46250805,2007
31,"Fauquier, VA",1306682,79952,125551,129792,2287209,-17432,-32065,144848,3479251,215972,53988,3461819,1125375,930469,244141,64122,10000,183907,190447,33630,23630,932328,2007
32,"Floyd, VA",133784,10345,15041,12332,258623,-9,-7409,16511,418604,35353,28240,418595,141350,71242,88730,14823,2492,27944,21207,5707,3215,84633,2007
33,"Fluvanna, VA",236835,17169,26730,21366,544286,-1814,-2599,27852,839115,52920,33313,837301,335303,176168,116847,25134,3043,50321,37413,7598,4555,149101,2007
34,"Franklin, VA",716840,49382,74963,71194,1036139,7884,2446,84979,1682321,128511,31043,1690205,404278,332715,321351,54447,7032,130957,110560,23391,16359,475323,2007
35,"Frederick + Winchester, VA*",2809492,166820,293168,296990,2707242,-13007,-19322,315315,3839007,295663,38119,3826000,213065,680403,438355,100371,12400,276341,441663,67780,55380,2091488,2007
36,"Giles, VA",252847,17707,34043,26626,306376,-2593,-2888,31020,506965,28013,29430,504372,84549,76474,121522,17138,1777,25125,47356,7159,5382,180366,2007
37,"Gloucester, VA",451166,30289,52082,44814,950915,2629,2132,52696,1403198,56980,38552,1405827,552445,272518,182394,36466,3915,59112,74489,14720,10805,317565,2007
38,"Goochland, VA",933182,55226,84726,83722,871112,-2483,-5685,97087,1427309,76643,68275,1424826,35017,452435,101279,20869,3227,70958,126587,14747,11520,735637,2007
39,"Grayson, VA",115649,10736,15610,11246,214904,-1703,-4011,16359,405466,23488,25132,403763,115614,64809,124050,16066,2234,19477,21233,5073,2839,74939,2007
40,"Greene, VA",172759,11780,17199,15852,402562,613,-36,19706,566777,37114,31571,567390,249509,91319,73509,17972,2087,37078,25125,5571,3484,110556,2007
41,"Greensville + Emporia, VA*",344821,21498,46691,39406,267874,3294,2453,41201,442329,9432,24892,445623,-35746,66263,111486,17902,1080,11885,66394,10033,8953,266542,2007
42,"Halifax, VA",556701,37867,74190,59532,538593,11266,7151,67633,957886,42335,26670,969152,49525,167343,263216,36338,3249,49486,103956,16580,13331,403259,2007
43,"Hampton (Independent City), VA",4079985,216556,613059,480506,3096050,0,0,456809,4697240,129495,33499,4697240,-527126,846283,754907,140222,9628,129495,853312,80509,70881,3097178,2007
44,"Hanover, VA",2459323,147820,239889,261904,3180766,4141,-4278,278772,4336650,249148,43922,4340791,1000215,748355,411670,98830,12776,244870,370841,61463,48687,1843612,2007
45,"Henrico, VA",12335664,715705,1131999,1275022,9892312,1522,-134,1353216,14005135,1242807,47255,14006657,-1090136,2790905,1323440,296408,36610,1242673,1769510,228458,191848,9323481,2007
46,"Henry + Martinsville, VA*",1198928,82376,149862,136062,1039360,2304,1122,150407,1981795,82001,28620,1984099,-9161,407773,536966,69326,5749,83123,217893,36927,31178,897912,2007
47,"Highland, VA",23246,1965,3274,2128,29383,-1120,-1733,3029,69780,5598,28325,68660,9166,22570,16707,2424,709,3865,4338,1332,623,15043,2007
48,"Isle of Wight, VA",640151,40109,70964,64256,1020546,4632,1889,72237,1440077,55890,41778,1444709,452632,241202,182961,34581,3500,57779,103092,15899,12399,479280,2007
49,"James City + Williamsburg, VA*",2181963,132712,226520,217250,2351253,391,75,241337,3837004,317539,50393,3837395,410627,1059144,426998,76149,10473,317614,335145,55935,45462,1529204,2007
50,"King George, VA",907314,46951,133819,98448,661008,-2381,-2937,96175,934898,65088,41549,932517,-150131,194078,77431,22444,2460,62151,183043,13028,10568,662120,2007
51,"King William, VA",219198,14126,23370,22164,399959,3282,17,25208,560845,24667,36881,564127,205969,92352,71816,15296,1690,24684,34452,5928,4238,160062,2007
52,"King and Queen, VA",71337,4860,9010,7112,143054,1276,632,8416,213711,11075,30942,214987,80133,31080,40853,6948,733,11707,12566,2038,1305,47064,2007
53,"Lancaster, VA",244129,17328,23756,22776,207649,-165,-472,28716,525754,46045,45415,525589,-7764,216135,101805,11573,2014,45573,35144,7291,5277,163412,2007
54,"Lee, VA",249743,19636,36859,26562,314533,-4009,-4948,32917,603119,25277,23660,599110,97707,77296,207281,25322,2244,20329,50140,8267,6023,179274,2007
55,"Loudoun, VA",9661722,544855,913065,1004306,13393655,-9219,-20982,1047008,16683603,639252,59614,16674384,4778941,2676849,603880,279704,37713,618270,1415218,176203,138490,7628234,2007
56,"Louisa, VA",549655,34644,68780,52908,764029,-5346,-6795,61098,1107488,72833,34750,1102142,275472,179807,158306,31716,3647,66038,95234,12430,8783,388383,2007
57,"Lunenburg, VA",124206,9329,17202,12926,165189,126,-1174,15792,315546,10841,24238,315672,56775,65415,85068,13024,996,9667,23665,4242,3246,90874,2007
58,"Madison, VA",155966,11033,16780,15836,264852,-4519,-7519,18951,426348,31936,31412,421829,127837,92382,64595,13429,2086,24417,24698,5774,3688,106851,2007
59,"Mathews, VA",91562,7433,8198,7020,214025,405,-167,10943,399377,29968,44292,399782,133406,122332,63425,9026,1461,29801,11708,3325,1864,50053,2007
60,"Mecklenburg, VA",514765,35282,68035,56444,461043,4732,-296,63504,868793,34524,26613,873525,9782,174593,237889,32823,3061,34228,96257,16928,13867,384280,2007
61,"Middlesex, VA",162574,11637,19221,14932,202316,1476,302,19103,400336,29494,37333,401812,58845,119863,79633,10763,1874,29796,26687,5653,3779,106091,2007
62,"Montgomery + Radford, VA*",2453149,142316,344360,259298,1894720,30,-3451,271965,2954490,168181,27385,2954520,-286464,635036,424764,107889,10374,164730,474009,60484,50110,1814410,2007
63,"Nelson, VA",183079,13393,18700,15678,311080,-300,-3957,21232,527937,49285,35192,527637,149233,117270,99287,14993,2652,45328,26539,6434,3782,111212,2007
64,"New Kent, VA",196402,13042,21319,20270,660468,-81,-420,23177,846632,28383,49064,846551,487243,113535,72548,17254,2495,27963,31454,6627,4132,136985,2007
65,"Newport News (Independent City), VA",5973572,324931,849987,655760,4029371,0,0,652811,6058374,273565,33191,6058374,-1291390,1095776,933227,182528,13021,273565,1177867,122557,109536,4522140,2007
66,"Norfolk (Independent City), VA",14214389,692696,2041503,1574746,5848221,0,0,1480069,8931782,1491853,37023,8931782,-6886099,1835945,1247616,241248,17347,1491853,2828876,227099,209752,9893660,2007
67,"Northampton, VA",283857,15390,27551,25336,243488,57234,39732,28058,380689,29435,34621,437923,-12311,93409,101026,12649,1683,69167,40219,7284,5601,174471,2007
68,"Northumberland, VA",139925,11515,14396,12862,175589,1474,602,17946,447244,31241,35995,448718,53610,173314,99815,12466,1717,31843,20827,4762,3045,87255,2007
69,"Nottoway, VA",276600,18099,41507,32386,255400,2593,789,34292,459733,14960,29263,462326,13092,85866,121060,15799,1495,15749,57700,8055,6560,203151,2007
70,"Orange, VA",444468,30136,46901,42576,718480,15872,4757,51424,1154823,72247,36275,1170695,325436,263555,188660,32273,4345,77004,68189,13786,9441,299275,2007
71,"Page, VA",294635,20049,32971,28372,429926,20036,17695,34235,664181,50775,28248,684217,169526,108717,145574,24222,2706,68470,47157,9136,6430,179008,2007
72,"Patrick, VA",210894,15818,28502,22782,251706,-26,-3074,27209,460343,24849,24553,460317,68021,79141,129470,18748,2309,21775,39893,8029,5720,149226,2007
73,"Pittsylvania + Danville, VA*",1748763,118560,212788,193102,1618492,13013,5331,215111,2865049,106591,26907,2878062,84840,494180,765390,106965,8506,111922,309339,51004,42498,1327502,2007
74,"Portsmouth (Independent City), VA",3103725,163908,511038,360142,1968969,0,0,343979,3124135,75235,31934,3124135,-790777,528568,626598,97831,6721,75235,691109,57815,51094,2337381,2007
75,"Powhatan, VA",360601,23108,39987,34438,788940,1389,585,40327,1071884,56430,38888,1073273,468666,180148,104185,27599,3268,57015,57206,10577,7309,246380,2007
76,"Prince Edward, VA",381950,24229,48488,41590,284887,1990,985,45024,504978,30618,22741,506968,-52039,97543,124538,22293,2186,31603,69283,11996,9810,281064,2007
77,"Prince George + Hopewell, VA*",1632512,81966,277633,188204,1126609,-1977,-2198,176068,1771885,41003,31043,1769908,-329835,345948,297351,57015,3471,38805,371735,30023,26552,1221972,2007
78,"Prince William, Manassas + Manassas Park, VA*",8695811,489624,915731,929534,14240390,-5452,-8711,954391,18282261,897535,43970,18276809,6498970,2852507,1183912,415662,46437,888824,1380498,193526,147089,6426489,2007
79,"Pulaski, VA",707685,45055,95221,79104,652953,366,-1074,84607,1052321,53840,30027,1052687,29875,153155,246579,35058,2871,52766,134773,18076,15205,520146,2007
80,"Rappahannock, VA",114645,8169,9791,9264,209976,-6740,-8319,12801,362363,34382,48038,355623,108132,107521,38126,7403,1557,26063,14423,3419,1862,74159,2007
81,"Richmond (Independent City), VA",11568287,653659,1288844,1158150,5139478,0,0,1232734,8986962,983579,44890,8986962,-5196075,2570454,1277030,200201,17395,983579,1867919,185708,168313,8716789,2007
82,"Richmond, VA",140485,9226,18917,14308,132432,2028,503,16380,237449,12969,25406,239477,8327,53612,53433,9426,976,13472,26071,4144,3168,100942,2007
83,"Roanoke (Independent City), VA",3774231,224189,427635,448904,1860953,0,0,448641,3230244,172633,34033,3230244,-1464637,673377,695914,94916,8475,172633,652087,84973,76498,2949511,2007
84,"Roanoke + Salem, VA*",3482568,209912,395395,365968,3126204,-1551,-2054,392896,4687421,325639,40535,4685870,36532,906342,653324,115602,12855,323585,578379,77907,65052,2580604,2007
85,"Rockbridge, Buena Vista + Lexington, VA*",665813,43888,76358,72882,618852,-5745,-7673,80329,1113056,79294,30929,1107311,33368,276233,212226,35802,4578,71621,112799,20385,15807,481393,2007
86,"Rockingham + Harrisonburg, VA*",3038725,174555,342673,307754,2367617,105300,90910,328432,3436143,281178,29311,3541443,-342676,651964,521862,120825,14303,372088,496550,79009,64706,2170087,2007
87,"Russell, VA",359279,27014,47852,40782,422296,-1446,-2685,47405,745103,32007,25742,743657,110422,91721,229640,28889,2565,29322,68243,11069,8504,261714,2007
88,"Scott, VA",206107,18016,27399,22810,309755,-5647,-6578,29421,594151,19148,25256,588504,133069,96172,182577,23302,2763,12570,38804,8276,5513,154733,2007
89,"Shenandoah, VA",691044,45370,77974,67234,835424,2482,-1175,78987,1335687,108304,32469,1338169,223367,273786,228959,41214,5920,107129,111591,21444,15524,472324,2007
90,"Smyth, VA",586106,39331,80728,64270,488993,-681,-2737,71466,862984,47227,26574,862303,-25647,132998,240312,32449,3316,44490,112863,17223,13907,428753,2007
91,"Southampton + Franklin, VA*",412530,26393,52926,40400,477896,18793,15333,46593,796807,36918,30005,815600,111959,160321,177383,27182,2474,52251,73126,11966,9492,287153,2007
92,"Spotsylvania + Fredericksburg, VA*",2909162,173071,303068,306904,4054790,-6815,-8585,326523,5673461,285703,39911,5666646,1472151,1065759,546097,141981,14399,277118,456520,75565,61166,2175524,2007
93,"Stafford, VA",2340049,129507,284406,248310,4011398,-3024,-3473,253662,5278777,228243,43058,5275753,1925011,902442,361913,122526,12070,224770,408561,50862,38792,1706718,2007
94,"Suffolk (Independent City), VA",1393737,85382,162435,150542,2178881,13263,582,160653,3179588,111218,39286,3192851,945797,592039,421931,81273,7365,111800,237706,34396,27031,1044231,2007
95,"Surry, VA",189356,10751,32754,19164,153128,874,-941,20333,222736,6193,31754,223610,-15895,31082,39400,7042,596,5252,42336,2931,2335,141768,2007
96,"Sussex, VA",178510,11682,24576,19446,185333,3286,842,21405,309411,8434,25650,312697,28228,50552,76812,12191,804,9276,34299,4976,4172,134935,2007
97,"Tazewell, VA",770413,53332,96085,81398,712965,-572,-1337,94031,1307823,70680,29597,1307251,36583,220053,374233,44169,3750,69343,136784,22637,18887,564286,2007
98,Virginia,251528910,14423064,27422777,26434352,235305855,235014,-59466,27640240,342727725,22232759,44248,342962739,11417185,70862673,36794211,7751000,870928,22173293,40639953,4869348,3998420,188715664,2007
99,"Virginia Beach (Independent City), VA",10915692,604035,1321893,1183352,12907356,1860,-174,1195711,19087878,1053511,43912,19089738,3187375,4338648,1843734,434732,45847,1053337,1913569,255609,209762,7948786,2007
100,"Warren, VA",573616,36417,63373,59370,941836,-5724,-6609,66102,1339553,76610,36232,1333829,434322,219706,172287,36814,4540,70001,93058,17059,12519,410557,2007
101,"Washington + Bristol, VA*",1570793,101147,186631,162666,1346972,1956,-1327,182480,2415087,193081,33684,2417043,-41341,569156,500915,71756,8462,191754,267964,43238,34776,1111075,2007
102,"Westmoreland, VA",161039,12373,18555,15698,298718,6391,-132,20222,537573,25661,31761,543964,157901,130644,114602,17127,2073,25529,26404,6123,4050,109106,2007
103,"Wise + Norton, VA*",879140,58854,111356,96202,616259,-1024,-1123,106955,1181888,58259,26003,1180864,-155926,160495,404110,45412,2968,57136,159457,22930,19962,662547,2007
104,"Wythe, VA",500238,33422,67029,53350,498705,-2574,-5401,60097,820071,42762,28359,817497,58564,124129,194663,28827,3296,37361,93704,16252,12956,369173,2007
105,"York + Poquoson, VA*",1299850,77813,155782,135288,2436256,2384,1741,145457,3534295,156194,46051,3536679,1281863,782004,318419,76799,6452,157935,223426,33356,26904,918489,2007
0,"Accomack, VA",632224,39898,82779,65810,579281,34336,25223,72803,1063867,45391,32329,1098203,19860,251477,267445,33970,3734,70614,115684,17996,14262,445926,2008
1,"Albemarle + Charlottesville, VA*",5698650,332903,666163,565106,4013833,-1588,-10425,615456,7193835,695211,51664,7192247,-1069361,2496247,682167,139211,21502,684786,948716,115796,94294,4065148,2008
2,"Alexandria (Independent City), VA",9334379,511583,1011898,1028780,7145356,0,0,1025973,9897367,719976,74445,9897367,-1163050,2208856,543155,132949,18579,719976,1526288,128235,109656,7088115,2008
3,"Alleghany + Covington, VA*",446595,30750,55539,50344,385972,-1655,-1856,55922,712986,21636,31763,711331,-4701,118669,206690,22395,1426,19780,80711,10537,9111,346104,2008
4,"Amelia, VA",138221,9771,15425,14162,271744,6692,2810,16852,412042,17417,33331,418734,150375,65640,81350,12563,1750,20227,22506,4807,3057,95488,2008
5,"Amherst, VA",472327,32863,61524,50570,589246,-3105,-3900,58148,971430,38055,29785,968325,175067,153378,225701,32510,2919,34155,86809,13395,10476,351363,2008
6,"Appomattox, VA",160926,12481,20331,16854,275022,-4090,-4558,20908,457612,20373,30654,453522,135004,68691,109809,14795,1684,15815,28758,5402,3718,116353,2008
7,"Arlington, VA",17395740,932683,2048903,1905276,11191209,0,0,1885321,15223016,886884,77548,15223016,-4319210,3314928,716879,196305,26568,886884,3001541,202775,176207,13507315,2008
8,"Augusta, Staunton + Waynesboro, VA*",2650632,169624,294946,253096,2648384,15143,5023,296172,4167202,449523,35318,4182345,293924,765048,768913,118420,13030,454546,421494,64776,51746,1774592,2008
9,"Bath, VA",103359,7172,12338,11806,82290,-637,-1237,13075,180548,3920,37654,179911,-7994,60606,37015,4778,635,2683,18241,3113,2478,82435,2008
10,"Bedford, VA*",975173,70248,107067,101242,1699310,-9708,-11917,120869,2715160,126165,36687,2705452,845006,535504,470638,73744,9058,114248,157688,29902,20844,703237,2008
11,"Bland, VA",107716,7471,16543,11260,104854,-1202,-1902,13101,186975,9237,26842,185773,10239,29412,51507,6921,819,7335,22173,2964,2145,78208,2008
12,"Botetourt, VA",526931,35754,62070,55132,894646,-2106,-3660,63320,1331954,55929,40353,1329848,431035,236602,198600,32955,3969,52269,89636,14474,10505,385026,2008
13,"Brunswick, VA",219375,15275,29784,23520,255068,6541,4766,27035,455290,9453,25959,461831,62728,71322,135441,17791,1260,14219,41544,6631,5371,163612,2008
14,"Buchanan, VA",476851,34585,56244,49570,361979,-850,-895,59370,719383,35966,29483,718533,-55502,103905,252649,24371,1366,35071,81029,10049,8683,360751,2008
15,"Buckingham, VA",173350,12100,22708,16832,238907,2984,1835,20516,394675,21285,23643,397659,86073,60525,98227,16819,1367,23120,31124,5009,3642,119106,2008
16,"Campbell + Lynchburg, VA*",3697802,227808,414926,411494,2337536,-2172,-4338,433555,4085844,179334,31841,4083672,-926711,774893,971243,128250,11776,174996,620673,88355,76579,2902133,2008
17,"Caroline, VA",299817,20477,40229,31286,640273,-644,-2616,36120,943570,32313,33663,942926,376576,144477,158176,28011,2670,29697,55872,8675,6005,214248,2008
18,"Carroll + Galax, VA*",530850,38853,69505,57712,539594,-1183,-3037,67709,1023322,51136,27659,1022139,76453,160100,322445,36955,3364,48099,98361,17171,13807,384390,2008
19,"Charles City, VA",94712,6490,10250,9650,149030,3893,2751,11315,234899,9837,33019,238792,65633,43167,46595,7232,524,12588,15075,2291,1767,67049,2008
20,"Charlotte, VA",134898,10463,18769,13126,174782,5415,3873,17026,333930,16229,26817,339345,56910,59501,105062,12654,1878,20102,25332,5110,3232,89464,2008
21,"Chesapeake (Independent City), VA",5070288,303315,573504,560754,6317008,7062,1021,583692,8903371,283727,40788,8910433,1830412,1508983,1084442,218458,19963,284748,853881,126256,106293,3931659,2008
22,"Chesterfield, VA",7164970,430764,786217,752308,9793206,455,-153,806918,13563480,610359,43778,13563935,3435154,2331829,1438900,309837,35137,610206,1162371,163195,128058,5392393,2008
23,"Clarke, VA",264097,17141,24704,25552,449621,274,-4414,29917,695573,54260,49379,695847,215441,173560,72666,14092,2807,49846,37480,7451,4644,176771,2008
24,"Craig, VA",34742,3071,4607,3304,91596,-612,-994,4723,152558,6306,29407,151946,61577,26784,33566,5167,622,5312,6259,1394,772,23171,2008
25,"Culpeper, VA",835202,52803,94542,86382,1138202,-1368,-5979,95994,1683077,101444,36514,1681709,398994,311553,231954,46056,6129,95465,137733,22415,16286,602004,2008
26,"Cumberland, VA",76110,5622,8615,6418,163002,9147,8065,8831,262067,12256,27537,271214,95723,41512,66700,9849,760,20321,11824,2282,1522,43965,2008
27,"Dickenson, VA",202479,16278,26456,20892,194041,-1499,-1556,26724,417276,11778,25860,415777,18286,54815,166921,16078,809,10222,36902,5077,4268,155355,2008
28,"Dinwiddie, Colonial Heights + Petersburg, VA*",1567880,100879,200389,172384,1500737,3150,1546,187071,2619400,74371,33882,2622550,119928,434717,687096,77402,7193,75917,286581,42541,35348,1205382,2008
29,"Essex, VA",186121,12286,21380,18748,221065,6886,6056,21660,367048,18702,34243,373934,56604,71737,81132,10920,1290,24758,30754,5639,4349,130609,2008
30,"Fairfax, Fairfax City + Falls Church, VA*",60509514,3484049,5208908,6259236,52462075,6701,5092,6613667,73665906,4409789,68373,73672607,-1433772,17173737,4036795,1077509,156120,4414881,8338526,832867,676747,47756107,2008
31,"Fauquier, VA",1354019,84495,130356,131700,2332853,-8795,-22050,150345,3631446,223208,56115,3622651,1129179,996121,293677,64558,9925,201158,196206,33214,23289,956655,2008
32,"Floyd, VA",132710,10572,15612,12512,261048,2050,-4031,16828,436801,30408,29061,438851,145166,74272,103531,15101,2448,26377,21868,5617,3169,84465,2008
33,"Fluvanna, VA",238600,17819,28219,21764,563445,-1028,-1717,28701,889258,47443,34886,888230,353546,191533,133252,25461,3053,45726,39101,7595,4542,153773,2008
34,"Franklin, VA",687098,49311,76195,69154,1023061,9994,4982,83888,1737403,107829,31608,1747397,419851,353177,371159,55284,6805,112811,110772,22333,15528,463515,2008
35,"Frederick + Winchester, VA*",2781908,167850,301496,300112,2745758,-3261,-8936,317906,4005666,243137,39215,4002405,281756,735331,521316,102064,12435,234201,451552,66451,54016,2096155,2008
36,"Giles, VA",257831,18486,36138,27538,305228,-2121,-2453,32255,524853,22185,30448,522732,79652,82314,135190,17168,1754,19732,49907,7082,5328,188192,2008
37,"Gloucester, VA",461070,31637,54164,45934,980187,3605,3095,54604,1486276,56780,40665,1489881,573721,298967,210727,36638,3843,59875,77131,14385,10542,324064,2008
38,"Goochland, VA",936011,56101,89449,91220,881105,-1963,-4623,101711,1489365,55483,69880,1487402,46805,494090,112207,21285,3345,50860,135059,15091,11746,750092,2008
39,"Grayson, VA",110543,10783,15784,11336,211328,-1433,-3474,16451,416733,18619,26057,415300,117236,71298,132674,15938,2184,15145,21452,5004,2820,73946,2008
40,"Greene, VA",177393,12472,18531,16994,405016,711,23,20969,593431,32305,32769,594142,248592,101651,87475,18131,2037,32328,27028,5634,3597,118037,2008
41,"Greensville + Emporia, VA*",346258,21932,48639,39532,275256,3045,2189,41698,464482,6894,25936,467527,-29304,64700,127571,18026,1035,9083,68405,9992,8957,268770,2008
42,"Halifax, VA",574886,39660,77623,61526,553166,14619,10860,70423,1014347,35052,28310,1028966,48703,181141,294659,36347,3223,45912,108386,16625,13402,420588,2008
43,"Hampton (Independent City), VA",4138240,224042,631370,488208,3074816,0,0,468146,4778012,124096,34385,4778012,-595278,858380,844816,138957,9144,124096,875474,79657,70513,3138670,2008
44,"Hanover, VA",2498144,152562,251930,267846,3240494,6829,-853,286485,4523009,224820,45570,4529838,1028835,806064,483280,99404,12764,223967,385853,62269,49505,1888324,2008
45,"Henrico, VA",12419661,732825,1186637,1283442,10009689,1454,18,1374546,14385567,1196824,47925,14387021,-1035426,2858635,1518697,300198,37224,1196842,1828358,228733,191509,9394461,2008
46,"Henry + Martinsville, VA*",1166911,82720,149518,130576,1022215,5119,4088,148008,2044644,77516,29658,2049763,3312,424503,603045,69113,5497,81604,214806,34828,29331,870501,2008
47,"Highland, VA",24652,2083,3350,2226,30618,-562,-1155,3196,75958,5534,31376,75396,9162,25799,18979,2403,688,4379,4463,1307,619,15810,2008
48,"Isle of Wight, VA",645619,41194,73253,65726,1091224,7571,5234,74057,1549392,52433,44542,1556963,519662,254711,211028,34955,3427,57667,106116,15852,12425,481836,2008
49,"James City + Williamsburg, VA*",2264427,141225,240193,226114,2512602,767,354,254282,4175175,319469,53722,4175942,502457,1162141,501199,77732,10539,319823,353250,56394,45855,1591354,2008
50,"King George, VA",924191,49368,137898,102198,693888,-3400,-3900,100467,1000894,58295,43377,997494,-129836,206507,97099,22996,2473,54395,188997,13001,10528,680799,2008
51,"King William, VA",213257,14062,23728,21768,413924,4666,2202,24946,595170,21395,38441,599836,225613,102057,83855,15604,1640,23597,34612,5751,4111,155048,2008
52,"King and Queen, VA",75074,5156,9259,7444,147242,3266,2571,8878,226546,10257,33229,229812,81046,35700,46870,6916,726,12828,12981,2018,1292,49265,2008
53,"Lancaster, VA",248784,17957,25337,23664,208914,2585,2276,29789,528787,39970,46283,531372,-10081,212879,109579,11481,1942,42246,37169,7413,5471,169369,2008
54,"Lee, VA",254318,20486,38554,27056,322664,-3551,-4437,34014,640004,21578,24995,636453,102360,86251,227538,25463,2216,17141,52082,8184,5968,185095,2008
55,"Loudoun, VA",10124960,581004,949767,1055406,14802207,-4803,-16040,1108707,18525934,718617,63305,18521131,5785954,2930579,788345,292570,39063,702577,1477470,181061,141998,7944913,2008
56,"Louisa, VA",536333,34589,71791,51818,773223,-3254,-4627,60498,1157064,63432,35529,1153810,297388,194422,186165,32475,3640,58805,97700,12263,8623,379828,2008
57,"Lunenburg, VA",124364,9555,17277,13132,164410,189,-1206,16121,320942,10216,24825,321131,56167,62694,94027,12936,973,9010,23843,4087,3114,91511,2008
58,"Madison, VA",153772,11274,17174,16328,259893,-2224,-5026,19438,442586,25076,33030,440362,125559,105417,75052,13332,2081,20050,25338,5670,3589,108384,2008
59,"Mathews, VA",90336,7695,8594,7276,211053,273,-142,11333,417004,26938,46154,417277,132050,134947,71277,9041,1426,26796,12232,3252,1826,51308,2008
60,"Mecklenburg, VA",532696,37207,70848,58404,469925,6637,1880,66409,908797,30212,27808,915434,3638,179127,266382,32920,3054,32092,100050,16754,13700,400554,2008
61,"Middlesex, VA",167426,12323,19955,15280,205018,1952,857,19963,424392,29591,39454,426344,57555,132869,88457,10806,1805,30448,27595,5570,3765,109383,2008
62,"Montgomery + Radford, VA*",2475417,145232,355158,266326,1915722,396,-2862,278395,3062882,140528,28096,3063278,-281300,655819,491737,109028,10402,137666,488321,61845,51443,1849430,2008
63,"Nelson, VA",185169,13976,19903,16402,300053,1648,-1605,22177,538603,43102,35897,540251,137061,125623,114575,15050,2718,41497,28104,6547,3829,115568,2008
64,"New Kent, VA",205537,13946,22819,21020,681313,892,602,24456,895554,27977,50567,896446,500232,127408,87725,17728,2474,28579,33329,6657,4183,143629,2008
65,"Newport News (Independent City), VA",6234024,343279,890855,683602,4074319,0,0,685080,6207667,259263,34242,6207667,-1474625,1090724,1042624,181287,13046,259263,1232656,122699,109653,4742105,2008
66,"Norfolk (Independent City), VA",13895762,683139,2088547,1605554,5442276,0,0,1485916,8647593,1004707,35852,8647593,-6967570,1800967,1404350,241201,17362,1004707,2891324,224645,207283,9999731,2008
67,"Northampton, VA",281977,15645,27470,26238,240337,59551,44450,28764,387392,21194,35511,446943,-12876,95716,110890,12586,1691,65644,40589,7151,5460,175744,2008
68,"Northumberland, VA",136152,11680,14315,12394,170809,4015,3198,17877,453544,27986,36616,457559,52534,175674,111076,12496,1694,31184,20512,4532,2838,84456,2008
69,"Nottoway, VA",274877,18265,42773,32444,252742,3450,1664,34487,470980,12002,29938,474430,12352,86048,135640,15847,1440,13666,58995,7744,6304,202216,2008
70,"Orange, VA",438248,30745,48226,42910,726895,16411,6158,52200,1199940,60661,36773,1216351,340847,272075,217381,33077,4361,66819,69681,13557,9196,301748,2008
71,"Page, VA",290696,20542,34958,29740,430597,16568,14264,35412,701394,40783,29658,717962,175313,121160,166205,24208,2576,55047,49828,9116,6540,185821,2008
72,"Patrick, VA",208506,16123,29451,22396,246548,2141,-421,27321,477732,21953,25693,479873,65363,85175,148150,18677,2274,21532,40649,7923,5649,146325,2008
73,"Pittsylvania + Danville, VA*",1779903,122345,224232,197092,1629650,20272,12655,220891,2983657,95291,28012,3003929,70638,524027,850252,107237,8545,107946,322778,50972,42427,1349179,2008
74,"Portsmouth (Independent City), VA",3172480,170409,527947,371630,1945831,0,0,356224,3188870,70294,33286,3188870,-870425,553329,689710,95802,6645,70294,713762,57565,50920,2388424,2008
75,"Powhatan, VA",357933,23541,41325,34786,805501,1052,306,40934,1124213,50912,40557,1125265,488502,196421,123343,27745,3295,51218,58718,10437,7142,247997,2008
76,"Prince Edward, VA",391921,25479,50423,43626,298093,2716,1779,47292,545721,25004,23888,548437,-46536,106767,143577,22959,2177,26783,72236,12116,9939,292902,2008
77,"Prince George + Hopewell, VA*",1768974,89957,305141,206072,1146653,-1730,-2001,192993,1852251,42210,32108,1850521,-429328,363671,340197,57635,3471,40209,408177,31161,27690,1320588,2008
78,"Prince William, Manassas + Manassas Park, VA*",8737516,499738,959712,944874,15180044,-2880,-5985,972175,19673547,781734,46571,19670667,7414703,3030478,1460145,422378,46560,775749,1432149,192534,145974,6529618,2008
79,"Pulaski, VA",653810,43231,89479,75382,621170,-4,-1357,80922,1062257,46738,30306,1062253,48282,166525,274558,35051,2839,45381,127170,16889,14050,481259,2008
80,"Rappahannock, VA",112389,8177,9330,8808,216285,-3921,-5461,12581,382321,34427,50997,378400,116477,117649,44466,7420,1578,28966,13734,3342,1764,69689,2008
81,"Richmond (Independent City), VA",11706774,673492,1300065,1175586,5218503,0,0,1261285,9270523,997526,45836,9270523,-5226986,2604759,1447261,202254,17925,997526,1887858,184269,166344,8821390,2008
82,"Richmond, VA",143895,9420,19497,14768,137165,4828,3219,16804,245539,10744,26675,250367,10074,55515,57687,9386,928,13963,26881,4092,3164,103051,2008
83,"Roanoke (Independent City), VA",3931314,236091,446772,460444,1943108,0,0,466313,3380479,219141,35282,3380479,-1521893,672623,764748,95813,8460,219141,676994,84633,76173,3035179,2008
84,"Roanoke + Salem, VA*",3609044,222223,415635,377046,3230246,-598,-1165,410746,4913432,338407,42215,4912834,31948,947628,734960,116377,12805,337242,604158,78445,65640,2667644,2008
85,"Rockbridge, Buena Vista + Lexington, VA*",669417,45127,79091,74018,622081,-4882,-6819,82136,1154979,71269,31956,1150097,34800,291477,236539,35990,4635,64450,116100,20251,15616,488867,2008
86,"Rockingham + Harrisonburg, VA*",3118758,182493,359765,318552,2421558,103042,87793,341769,3620272,260173,30429,3723314,-355431,709237,592519,122361,14645,347966,519041,79039,64394,2251751,2008
87,"Russell, VA",372490,28513,49756,41764,451197,-953,-2273,49395,809968,29027,28061,809015,128102,106549,251269,28831,2573,26754,70638,10825,8252,275098,2008
88,"Scott, VA",214660,18816,28955,23594,320172,-3902,-4716,30613,629081,16539,26904,625179,136125,104245,200762,23237,2778,11823,40752,8347,5569,162085,2008
89,"Shenandoah, VA",674824,45718,79025,66686,836497,5016,1581,79061,1386589,88873,33356,1391605,240734,289756,265352,41720,5764,90454,112368,21058,15294,472002,2008
90,"Smyth, VA",582525,40114,82122,64232,488876,-1471,-3343,72230,899077,45070,27716,897606,-21419,139740,268990,32386,3332,41727,114238,16883,13551,426560,2008
91,"Southampton + Franklin, VA*",412778,27004,55036,41572,469594,17336,13798,47790,816389,29193,30602,833725,104606,169640,194491,27244,2379,42991,75822,11918,9539,293965,2008
92,"Spotsylvania + Fredericksburg, VA*",2819624,169214,313184,310122,4064124,-4270,-5914,324275,5857733,167192,40799,5853463,1568775,1141853,647486,143472,14286,161278,468245,74890,60604,2190101,2008
93,"Stafford, VA",2428102,135729,313689,262910,4206583,-2951,-3378,267184,5645878,190201,45389,5642927,2045665,982578,453766,124323,11862,186823,445144,51350,39488,1796135,2008
94,"Suffolk (Independent City), VA",1455793,90519,171821,156672,2311594,15014,3655,168855,3423190,112213,41623,3438204,1024656,639840,486770,82603,7575,115868,250157,35108,27533,1089768,2008
95,"Surry, VA",206114,11673,36642,19788,158261,2324,863,21567,233093,5865,33340,235417,-26286,34429,42727,7061,629,6728,46536,2926,2297,152850,2008
96,"Sussex, VA",185431,12105,25580,19696,183295,6125,4072,21953,313689,8260,26182,319814,19817,51438,85081,12215,853,12332,35428,5009,4156,137671,2008
97,"Tazewell, VA",813431,56975,102904,86668,755912,-1422,-2204,100309,1414522,64540,31388,1413100,42790,248631,408557,45020,3687,62336,146238,22723,19036,604857,2008
98,Virginia,255776742,14929856,28541014,27232230,240488758,372713,99761,28545971,356163316,19807025,45514,356536029,13257987,73713596,42333675,7833496,876670,19906786,42157129,4870415,3993745,193712827,2008
99,"Virginia Beach (Independent City), VA",10800747,606531,1356298,1193626,12848059,3589,1770,1203344,19416506,819159,44816,19420095,3250656,4440728,2131308,433331,45685,820929,1953111,251683,205998,8026707,2008
100,"Warren, VA",586408,37966,66643,62380,931465,-4087,-4899,69156,1382670,64677,37000,1378583,414213,243912,203206,37259,4336,59778,97833,17338,13002,428797,2008
101,"Washington + Bristol, VA*",1686208,111126,195851,166400,1482622,-4048,-7273,194326,2674252,256991,37032,2670204,-9260,623598,563984,72106,8593,249718,279051,43731,35138,1157439,2008
102,"Westmoreland, VA",168489,13011,19929,16774,298293,8707,2911,21398,565994,22061,33210,574701,151202,147562,128846,17305,1996,24972,28316,6075,4079,115201,2008
103,"Wise + Norton, VA*",910465,61810,117635,100656,637857,-487,-590,112138,1246589,42281,27477,1246102,-160470,171584,436661,45350,3030,41691,167963,22922,19892,700811,2008
104,"Wythe, VA",512771,34973,70398,55670,501181,-2656,-5292,62808,859135,36511,29409,856479,51218,135506,219792,29123,3251,31219,98233,16369,13118,383319,2008
105,"York + Poquoson, VA*",1321966,79859,166755,139470,2545338,2685,1998,149594,3703018,140472,48097,3705703,1372966,795060,365305,77047,6398,142470,236490,33432,27034,943006,2008
0,"Accomack, VA",654540,41267,94947,67440,593312,34427,26711,74987,1067953,40180,32991,1102380,13759,230153,278915,33415,3770,66891,128667,18095,14325,458982,2009
1,"Albemarle + Charlottesville, VA*",5701735,336287,735728,562344,4027554,-402,-9261,617459,6844641,656195,48498,6844239,-1056722,2093065,723620,141125,22159,646934,1016900,113544,91385,4037901,2009
2,"Alexandria (Independent City), VA",9563410,529264,1102006,1041632,7306560,0,0,1050080,9873831,863047,71798,9873831,-1206770,2003604,563667,137523,19353,863047,1622822,126442,107089,7077541,2009
3,"Alleghany + Covington, VA*",430036,30258,57504,48532,368274,-1641,-1879,54524,693016,18690,31067,691375,-7238,111292,211809,22254,1428,16811,81770,10110,8682,331455,2009
4,"Amelia, VA",130820,9469,15965,13098,251619,9209,5547,16018,393043,15384,31940,402252,136817,60671,89962,12594,1695,20931,22514,4471,2776,87375,2009
5,"Amherst, VA",463273,32673,67389,49304,579157,-2690,-3445,57325,965799,34546,29683,963109,173209,144903,239049,32447,2967,31101,92041,13030,10063,340131,2009
6,"Appomattox, VA",153669,12387,21643,15912,272557,-3589,-4159,20343,461854,19716,30939,458265,139231,64060,121648,14812,1548,15557,29599,5066,3518,108513,2009
7,"Arlington, VA",18223945,990495,2286667,2044692,11254789,0,0,2012841,15028023,796314,74162,15028023,-4956315,3019207,754027,202637,27541,796314,3309013,205930,178389,14118618,2009
8,"Augusta, Staunton + Waynesboro, VA*",2592276,170405,322288,244398,2606758,12773,3683,292604,4144128,450301,35052,4156901,307086,713753,836390,118593,13229,453984,444487,62262,49033,1693805,2009
9,"Bath, VA",90911,6833,12632,11290,71519,-735,-1285,12478,171527,-524,36009,170792,-6914,60662,38611,4743,642,-1809,18277,2885,2243,74443,2009
10,"Bedford, VA*",935559,69485,117451,97014,1693485,-5900,-7955,117992,2685458,118729,35932,2679558,875918,473216,512857,74573,9127,110774,165958,29344,20217,658827,2009
11,"Bland, VA",109105,7560,19531,11312,103698,-1207,-1786,13216,190135,7853,27508,188928,7809,31568,53662,6868,767,6067,25187,2891,2124,77851,2009
12,"Botetourt, VA",484827,34273,63424,51298,866910,-1746,-3167,59922,1294809,50796,39134,1293063,442005,211044,215109,33042,3985,47629,89073,13707,9722,348125,2009
13,"Brunswick, VA",212482,14868,32132,22364,246570,8012,6287,26050,458425,8351,26643,466437,60138,67223,152644,17507,1272,14638,43314,6351,5079,154530,2009
14,"Buchanan, VA",459231,33679,61102,49878,345109,-616,-664,58618,711256,24142,29324,710640,-55504,102017,263514,24234,1279,23478,86041,9682,8403,349712,2009
15,"Buckingham, VA",168862,12324,24442,16472,231137,3107,2010,20560,393435,19736,23125,396542,82835,56951,108454,17148,1381,21746,32678,4889,3508,114438,2009
16,"Campbell + Lynchburg, VA*",3665128,226917,462898,407824,2271715,-2272,-4341,430829,3984903,156510,30728,3982631,-962584,661497,1049419,129609,12130,152169,666810,85574,73444,2846149,2009
17,"Caroline, VA",287854,20160,43279,30182,631723,-475,-2343,35251,949576,29115,33581,949101,379120,142166,175212,28263,2603,26772,58370,8349,5746,202712,2009
18,"Carroll + Galax, VA*",524741,39148,74388,56914,518556,-275,-2161,67605,1032085,47128,27911,1031810,61420,156732,356522,36968,3260,44967,102845,16460,13200,376929,2009
19,"Charles City, VA",88291,6268,10562,8830,143690,3801,2683,10683,231398,10659,32594,235199,66082,39179,52330,7216,525,13342,14977,2134,1609,59972,2009
20,"Charlotte, VA",130951,10543,20121,12764,169688,3969,2421,16925,331383,16079,26641,335352,55662,56822,108842,12588,1903,18500,26503,5013,3110,85948,2009
21,"Chesapeake (Independent City), VA",5127688,308146,644954,563056,6424867,8239,2916,589674,9077804,299829,41267,9086043,1886853,1496266,1164910,220176,19963,302745,926482,121598,101635,3898461,2009
22,"Chesterfield, VA",6947980,422715,857277,736750,9497426,884,211,791090,13208101,504390,42188,13208985,3340536,2141109,1570450,313096,35680,504601,1225652,158280,122600,5217727,2009
23,"Clarke, VA",259589,17367,25613,24584,463642,2769,-1506,29659,705803,53898,50558,708572,233712,165496,79434,14015,2771,52392,37905,7145,4374,169292,2009
24,"Craig, VA",33569,3130,5015,3190,85895,-694,-1099,4725,148622,6020,28892,147928,57051,24846,37187,5120,652,4921,6610,1382,730,22038,2009
25,"Culpeper, VA",811120,52168,103118,84764,1124664,1179,-3499,94550,1669290,89002,36129,1670469,408094,293150,252655,46236,6127,85503,145500,21709,15582,580117,2009
26,"Cumberland, VA",71200,5597,9475,6164,159128,7235,6204,8679,263963,10904,27085,271198,96607,39133,72937,10013,744,17108,12557,2212,1468,41535,2009
27,"Dickenson, VA",207037,16818,29116,21736,200939,-1447,-1505,27686,430004,12746,26911,428557,21588,55929,171689,15925,839,11241,39984,5055,4216,155812,2009
28,"Dinwiddie, Colonial Heights + Petersburg, VA*",1537169,99417,219855,169758,1434331,2867,1434,184296,2596699,63828,33508,2599566,81458,403118,762117,77581,7235,65262,304734,41346,34111,1167173,2009
29,"Essex, VA",179204,12138,23751,18352,213215,4799,4000,21314,365861,16421,33381,370660,55325,71411,86034,11104,1329,20421,32927,5619,4290,125856,2009
30,"Fairfax, Fairfax City + Falls Church, VA*",60179215,3492510,5787623,6361282,51571551,5971,4299,6673151,70340463,3269526,63989,70346434,-1934513,14593357,4181526,1099347,160628,3273825,8968264,822361,661733,47937126,2009
31,"Fauquier, VA",1322218,84518,141975,130942,2327745,-7666,-19922,149989,3509581,218115,53953,3501915,1155516,865215,308955,64907,10195,198193,207446,32479,22284,916579,2009
32,"Floyd, VA",134768,10994,17433,12550,260645,3273,-1803,17269,438607,28399,29167,441880,143146,71813,109422,15150,2496,26596,23708,5637,3141,84464,2009
33,"Fluvanna, VA",232800,17886,31507,21424,553398,-339,-963,28598,876335,42052,34251,875996,349196,177034,145564,25576,2989,41089,42219,7407,4418,149492,2009
34,"Franklin, VA",643746,48700,77997,65120,993825,5893,1189,81260,1722444,101424,31012,1728337,431339,322859,411653,55732,6893,102613,110557,21042,14149,430576,2009
35,"Frederick + Winchester, VA*",2719887,165710,332250,295834,2674054,-2266,-7326,313627,3895236,204500,37609,3892970,267794,648615,570301,103513,12517,197174,480167,63678,51161,2042546,2009
36,"Giles, VA",266201,19187,40832,28334,298131,-1853,-2221,33354,523830,20444,30235,521977,65284,78491,145355,17264,1750,18223,54999,6991,5241,192979,2009
37,"Gloucester, VA",437501,30947,58751,43714,968346,2952,2425,52804,1486242,49804,40491,1489194,583649,294148,226700,36778,3852,52229,80608,13976,10124,304664,2009
38,"Goochland, VA",915628,55091,95422,93384,890473,-19,-2260,101783,1423008,36394,65867,1422989,76628,397107,135409,21604,3538,34134,142114,15186,11648,739380,2009
39,"Grayson, VA",109741,11008,17094,11054,199930,-1078,-2916,16535,410599,17929,26091,409521,106724,69519,140072,15696,2133,15013,22621,4847,2714,72107,2009
40,"Greene, VA",180413,13035,20877,17468,407326,892,169,21769,596483,30007,32756,597375,248682,94843,95206,18237,2078,30176,29611,5682,3604,120626,2009
41,"Greensville + Emporia, VA*",342126,21611,52625,38338,263342,4969,4114,40780,457276,5619,25486,462245,-38004,63901,135002,18137,1026,9733,71794,9686,8660,260599,2009
42,"Halifax, VA",580629,40420,87516,62680,545324,9951,6459,71760,1016043,34268,28270,1025994,36455,165288,315382,36293,3274,40727,118856,16357,13083,421046,2009
43,"Hampton (Independent City), VA",4185455,227348,676915,499280,3035156,0,0,476988,4789312,112810,34747,4789312,-673311,833520,920636,137833,9275,112810,926555,77457,68182,3146090,2009
44,"Hanover, VA",2443044,150665,282360,265950,3086678,6398,-740,283640,4352991,175596,43747,4359389,927274,750267,522444,99651,13070,174856,415335,61410,48340,1852853,2009
45,"Henrico, VA",11429045,683992,1230753,1197072,9543327,2077,808,1282528,13672894,1023868,44871,13674971,-603190,2464954,1666690,304763,38002,1024676,1829289,219672,181670,8575080,2009
46,"Henry + Martinsville, VA*",1096139,79828,157077,122666,971254,5043,4137,141161,1995782,68942,29246,2000825,16276,370045,659526,68414,5471,73079,218410,32328,26857,804650,2009
47,"Highland, VA",24418,2080,3777,2238,28999,-376,-961,3199,74982,4864,31573,74606,7780,26546,19061,2363,711,3903,4896,1316,605,15619,2009
48,"Isle of Wight, VA",632624,41147,77745,65574,1093696,8049,6015,73934,1561064,46467,44489,1569113,535006,247370,228047,35270,3538,52482,110532,15356,11818,469610,2009
49,"James City + Williamsburg, VA*",2149519,137092,261869,217708,2449633,610,148,245946,4053368,277326,50799,4053978,546060,1052649,551696,79805,10760,277474,370723,54694,43934,1501322,2009
50,"King George, VA",980099,53066,152116,109322,709498,-2834,-3297,107727,1016520,54178,43441,1013686,-162874,199246,104942,23335,2435,50881,206777,13186,10751,722441,2009
51,"King William, VA",203219,13928,24295,20884,398242,3293,1455,24370,573383,19644,36573,576676,219393,86333,92101,15768,1684,21099,34737,5590,3906,147383,2009
52,"King and Queen, VA",75845,5309,10061,7540,144129,2910,2170,9079,229230,10994,33678,232140,77363,38373,49638,6893,761,13164,13831,2015,1254,48850,2009
53,"Lancaster, VA",236441,17695,28208,22948,196278,-479,-797,29169,497432,36187,43581,496953,-10994,182728,117947,11403,1999,35390,39682,7176,5177,161369,2009
54,"Lee, VA",259814,20971,42671,27698,325345,-3423,-4271,34820,652630,20371,25381,649207,100351,85711,238151,25578,2240,16100,56520,8151,5911,187194,2009
55,"Loudoun, VA",10124694,589002,1068076,1053210,15326572,-2059,-12943,1115607,18773257,778109,61816,18771198,6317485,2630622,814004,303661,40583,765166,1594681,179822,139239,7764847,2009
56,"Louisa, VA",530854,34762,78340,52968,741525,-1917,-3239,61246,1131587,55075,34399,1129670,271917,183218,204927,32840,3533,51836,104824,11830,8297,374194,2009
57,"Lunenburg, VA",128024,9782,18743,13438,164464,2826,1351,16501,322941,9645,25279,325767,52941,61129,100174,12887,962,10996,25462,3912,2950,91566,2009
58,"Madison, VA",144641,11035,19693,15568,252787,-1738,-4400,18819,431776,19118,32193,430038,126965,95701,81550,13358,2023,14718,27477,5427,3404,102446,2009
59,"Mathews, VA",86624,7788,9307,7126,218734,36,-254,11351,409144,24834,45480,409180,143461,114379,76067,8997,1368,24580,12870,3131,1763,49174,2009
60,"Mecklenburg, VA",532142,37386,78789,58556,467150,7901,3328,66664,920717,27229,28299,928618,1672,170711,290757,32815,2976,30557,108067,16285,13309,393518,2009
61,"Middlesex, VA",165097,12517,22022,15024,198721,2479,1440,20029,413638,28259,38264,416117,53653,119370,98026,10875,1854,29699,29534,5483,3629,105864,2009
62,"Montgomery + Radford, VA*",2477383,145660,392863,266156,1899979,1091,-1962,278738,3104552,114706,28199,3105643,-298666,687473,518191,110133,10385,112744,525941,60903,50518,1838698,2009
63,"Nelson, VA",174846,13821,21074,15940,295388,2547,-406,21791,537485,37769,35787,540032,142333,119005,125639,15090,2710,37363,29044,6371,3661,108439,2009
64,"New Kent, VA",199028,13997,24999,20360,727902,168,-86,24177,951555,27698,52707,951723,553051,123160,100661,18057,2480,27612,35179,6607,4127,136237,2009
65,"Newport News (Independent City), VA",6332981,346161,1008136,694308,3976151,0,0,693315,6127926,235117,33856,6127926,-1663515,1036936,1114839,181000,12975,235117,1355290,119637,106662,4742574,2009
66,"Norfolk (Independent City), VA",13356276,653768,2195448,1622604,4930174,0,0,1465070,8124422,523928,33610,8124422,-6961032,1695557,1498691,241725,17956,523928,3006750,214998,197042,9825598,2009
67,"Northampton, VA",282193,16075,30101,25338,244106,56424,43127,28744,397814,20158,36456,454238,-9343,92387,117745,12460,1711,63285,42770,7008,5297,176138,2009
68,"Northumberland, VA",130462,11877,15867,12212,167452,2552,1775,17983,446941,24268,36311,449493,54973,163341,118700,12379,1641,26043,21973,4389,2748,82446,2009
69,"Nottoway, VA",268871,18092,46562,31352,235081,2812,1035,33768,459530,10367,29089,462342,-22,82637,144624,15894,1471,11402,62238,7611,6140,195231,2009
70,"Orange, VA",424600,30698,52181,41482,725634,16381,6752,51439,1213485,59194,36901,1229866,352473,261197,243035,33329,4244,65946,72922,13036,8792,285732,2009
71,"Page, VA",273452,20030,36766,28266,412157,16506,14218,34163,693534,34569,29492,710040,172868,119020,178863,24076,2632,48787,50899,8791,6159,173766,2009
72,"Patrick, VA",203090,16161,30719,21394,238429,2930,731,26858,474576,21381,25725,477506,62197,80877,158200,18562,2228,22112,41416,7576,5348,139562,2009
73,"Pittsylvania + Danville, VA*",1734711,121579,240672,191822,1586884,13443,6064,217490,2983174,90620,28037,2996617,69663,468467,941266,106882,8819,96684,336583,49491,40672,1301444,2009
74,"Portsmouth (Independent City), VA",3211825,171828,571066,381846,1917801,0,0,362751,3186930,62730,33412,3186930,-931273,534292,734837,95384,6709,62730,761989,57088,50379,2387106,2009
75,"Powhatan, VA",349508,23563,45785,34380,772142,1504,798,40753,1088032,43790,38936,1089536,463387,180859,136535,27983,3281,44588,62975,10216,6935,241945,2009
76,"Prince Edward, VA",393230,25567,56923,43378,296710,3624,2735,47256,545094,20945,23591,548718,-49264,96976,155032,23260,2218,23680,78612,11880,9662,290938,2009
77,"Prince George + Hopewell, VA*",1843758,94005,338315,221834,1105093,-2842,-3141,204922,1819320,31541,31167,1816478,-533743,336620,374765,58283,3535,28400,449232,31462,27927,1366126,2009
78,"Prince William, Manassas + Manassas Park, VA*",8811777,508418,1074318,961580,15755707,-2223,-5104,989208,20305319,721162,46218,20303096,7933138,2999001,1548388,439288,48178,716058,1555108,191657,143479,6540611,2009
79,"Pulaski, VA",563699,39133,84077,65134,588590,416,-876,71700,1038591,43162,29696,1039007,96591,151462,298955,34988,2769,42286,116644,15217,12448,404769,2009
80,"Rappahannock, VA",104110,7994,9925,8008,211268,-2806,-4324,11998,363052,33041,49127,360246,119156,101908,47070,7333,1600,28717,13929,3238,1638,61464,2009
81,"Richmond (Independent City), VA",11304595,657116,1408225,1154444,4763468,0,0,1234338,8337222,753452,40933,8337222,-5306789,2032966,1540788,203678,18608,753452,1985447,178463,159855,8565696,2009
82,"Richmond, VA",144282,9529,21936,14846,134485,3839,2159,16952,243978,9653,26788,247817,7155,53153,60179,9251,968,11812,29359,4067,3099,103111,2009
83,"Roanoke (Independent City), VA",3836669,231950,488397,447924,1921050,0,0,455912,3318345,213237,34202,3318345,-1459707,573829,823466,97023,8504,213237,712359,80200,71696,2911073,2009
84,"Roanoke + Salem, VA*",3642983,225333,472453,382882,3187816,255,-350,416774,4826128,305382,41287,4826383,-38393,842333,796234,116899,13078,305032,663894,77616,64538,2674057,2009
85,"Rockbridge, Buena Vista + Lexington, VA*",660058,45234,87095,73022,610944,-4100,-5996,81745,1127253,68210,31240,1123153,32631,253918,258291,35952,4628,62214,123606,19525,14897,474238,2009
86,"Rockingham + Harrisonburg, VA*",3056943,182412,402030,316100,2351444,65622,49961,340462,3583365,229189,29393,3648987,-365037,664306,633237,124144,14975,279150,560080,77220,62245,2217713,2009
87,"Russell, VA",368251,28794,54589,41314,442248,-2490,-3878,49451,824944,31541,28349,822454,123448,108622,271584,29012,2624,27663,75246,10562,7938,265342,2009
88,"Scott, VA",217687,19238,32292,23732,303069,-3234,-3960,31104,611506,15741,26205,608272,116486,92511,212692,23212,2709,11781,44158,8141,5432,161748,2009
89,"Shenandoah, VA",629851,43919,82879,62668,806761,8300,5015,75253,1346269,75527,32450,1354569,252163,266008,281800,41743,5668,80542,114213,19863,14195,435096,2009
90,"Smyth, VA",553534,39082,85714,61282,472116,-3516,-5253,69723,893694,41440,27574,890178,-11695,127913,290149,32283,3331,36187,116355,15703,12372,400992,2009
91,"Southampton + Franklin, VA*",396308,26077,56881,39460,467851,19898,16357,45807,806660,26784,30505,826558,117350,148965,209742,27096,2387,43141,76611,11292,8905,276556,2009
92,"Spotsylvania + Fredericksburg, VA*",2843868,173693,348149,311118,4139552,-2547,-4070,329252,5926272,175560,40906,5923725,1624936,1069075,715098,144813,14152,171490,503708,72883,58731,2168670,2009
93,"Stafford, VA",2484272,140198,343002,273282,4349591,-2438,-2843,276839,5829505,185471,46082,5827067,2142158,980069,497407,126449,11967,182628,479643,51150,39183,1822001,2009
94,"Suffolk (Independent City), VA",1478040,92673,194385,158438,2336043,16487,6099,171892,3446918,106190,41405,3463405,1029895,598377,528985,83648,8003,112289,273604,34826,26823,1092147,2009
95,"Surry, VA",224355,12750,40197,22448,154351,3113,1915,23974,233114,5455,33569,236227,-46030,35298,46578,7037,614,7370,51421,2990,2376,165564,2009
96,"Sussex, VA",181840,11881,27253,19228,177852,7632,5875,21495,308748,7054,25986,316380,17507,49344,89184,12175,847,12929,36867,4805,3958,132044,2009
97,"Tazewell, VA",798000,56636,114914,84722,746884,-1729,-2530,98997,1409844,58178,31244,1408115,47881,240590,420641,45069,3694,55648,157275,22069,18375,585077,2009
98,Virginia,253297482,14929484,31270766,27361798,237770954,348305,92631,28610383,349080210,16738235,44087,349428515,13083855,66248218,45409343,7925937,893192,16830866,44951665,4758119,3864927,191514951,2009
99,"Virginia Beach (Independent City), VA",10387858,590560,1453501,1191052,12584093,1901,246,1186086,18972355,512616,43619,18974256,3382321,4106652,2283511,435004,47138,512862,2049027,243151,196013,7825969,2009
100,"Warren, VA",582812,38204,75588,62214,911880,-3139,-3896,69311,1369962,58180,36703,1366823,398379,241410,213533,37240,4400,54284,106695,16993,12593,421833,2009
101,"Washington + Bristol, VA*",1694099,113848,220955,165194,1414232,-3913,-7026,196445,2518756,193280,34657,2514843,-83422,493895,606716,72564,8316,186254,303552,42116,33800,1204293,2009
102,"Westmoreland, VA",160006,12858,21565,15906,295584,7693,2437,20811,570993,19968,33166,578686,156389,144287,138815,17448,2048,22405,29518,5983,3935,108083,2009
103,"Wise + Norton, VA*",984844,66112,136667,110024,682543,4,-97,121124,1294492,41325,28540,1294496,-181177,165790,446163,45357,2949,41228,191679,23244,20295,751937,2009
104,"Wythe, VA",489674,34190,74346,53392,460535,-3225,-5726,60886,837613,33997,28559,834388,31747,133570,240283,29216,3232,28271,101042,15347,12115,360361,2009
105,"York + Poquoson, VA*",1302040,79701,182964,140970,2505149,2308,1610,150186,3639322,122677,47080,3641630,1353295,748857,387624,77350,6292,124287,253449,32589,26297,924304,2009
0,"Accomack, VA",669368,42187,95329,69258,603275,30526,23563,76816,1092202,51167,33868,1122728,10723,222749,296704,33150,3731,74730,129958,18051,14320,464680,2010
1,"Albemarle + Charlottesville, VA*",5972951,341821,735779,581248,4301638,-1140,-10408,632445,7269881,854558,50950,7268741,-1038868,2180543,786560,142663,22196,844150,1026403,112944,90748,4102398,2010
2,"Alexandria (Independent City), VA",10033478,549450,1045199,1056772,8022104,0,0,1077836,10670343,1340703,75818,10670343,-933538,2015709,632530,140737,19658,1340703,1573585,123544,103886,7119190,2010
3,"Alleghany + Covington, VA*",451606,31611,57444,51702,381859,-2042,-2322,57462,705647,19217,31774,703605,-12285,102743,219003,22144,1352,16895,83295,9903,8551,351416,2010
4,"Amelia, VA",143066,9696,15259,13136,267116,16485,12806,16264,409097,21461,33403,425582,140314,59809,98657,12741,1662,34267,21827,4364,2702,86972,2010
5,"Amherst, VA",456055,32277,64045,48316,576212,-2933,-3697,56435,972617,41939,29939,969684,176592,140661,252811,32389,2921,38242,88203,12472,9551,329610,2010
6,"Appomattox, VA",152044,12286,21081,15618,269588,-3758,-4446,20095,465821,22286,30618,462063,137639,61801,130674,15091,1570,17840,28890,5112,3542,105314,2010
7,"Arlington, VA",20274242,1078354,2394589,2190244,12735445,0,0,2173476,16591315,1642270,79263,16591315,-5365321,2976104,879766,209319,27711,1642270,3489711,210386,182675,15142261,2010
8,"Augusta, Staunton + Waynesboro, VA*",2645300,168149,311520,249184,2661947,25922,17366,292741,4214321,491765,35837,4240243,309388,687639,890657,118320,12993,509131,436112,61243,48250,1700057,2010
9,"Bath, VA",109581,7373,12767,11646,90080,-1125,-1660,13196,183263,18057,38580,182138,-6305,51023,41035,4721,637,16397,18590,2883,2246,74594,2010
10,"Bedford, VA*",979217,71420,114659,102578,1714860,-4939,-6935,122709,2728569,140463,36300,2723630,858352,460526,548244,75032,9069,133528,165948,29699,20630,679741,2010
11,"Bland, VA",113139,7761,19769,11748,106383,-1261,-1769,13635,189440,8778,27669,188179,6879,26657,55139,6801,774,7009,25643,2878,2104,80487,2010
12,"Botetourt, VA",489107,34288,58027,51030,871217,-2247,-3636,59803,1314278,66325,39525,1312031,441913,208735,232079,33195,3979,62689,83542,13228,9249,342876,2010
13,"Brunswick, VA",192092,14004,27653,20708,235187,6458,4678,24358,454326,10148,26492,460784,67453,63879,161718,17393,1222,14826,38007,5891,4669,139259,2010
14,"Buchanan, VA",497943,35741,62248,54468,365755,-505,-552,62975,722400,29568,29965,721895,-69213,88941,267199,24091,1217,29016,89482,9762,8545,379445,2010
15,"Buckingham, VA",177577,12514,24752,16886,232741,6358,5241,20957,401999,23278,23892,408357,76121,59210,116406,17092,1403,28519,33195,4846,3443,115863,2010
16,"Campbell + Lynchburg, VA*",3741501,231095,438196,418562,2352101,-1582,-3650,440376,4174623,216541,31986,4173041,-949024,661918,1159022,130463,12131,212891,647477,84221,72090,2881133,2010
17,"Caroline, VA",291482,20393,43459,30528,637040,-1805,-3690,35657,969101,32185,33785,967296,381215,138509,191747,28631,2536,28495,58723,8221,5685,204264,2010
18,"Carroll + Galax, VA*",542785,40044,72274,58726,528765,503,-1473,69407,1045447,59019,28223,1045950,55387,141879,375306,37060,3324,57546,101637,16507,13183,383602,2010
19,"Charles City, VA",89416,6472,10471,9304,144874,553,-608,11124,239920,12417,33146,240473,66582,39923,55676,7255,530,11809,15123,2152,1622,62484,2010
20,"Charlotte, VA",130733,10525,19181,12674,169873,3059,1415,16862,336843,19148,27045,339902,56002,54986,115043,12568,1912,20563,25518,4869,2957,84652,2010
21,"Chesapeake (Independent City), VA",5278047,314475,626508,581080,6612926,7047,2044,605015,9405681,400790,42110,9412728,1939894,1498536,1301266,223525,20055,402834,917048,121599,101544,3958165,2010
22,"Chesterfield, VA",7067502,426101,843021,766002,9624324,497,-270,809102,13506060,515820,42579,13506557,3365924,2149378,1732855,317210,35341,515550,1226022,156635,121294,5325930,2010
23,"Clarke, VA",260226,16755,23949,23666,478626,3972,-188,28588,718498,65809,51539,722470,246988,158699,85145,14018,2847,65621,35782,7039,4192,158823,2010
24,"Craig, VA",35510,3185,5077,3342,90303,-1042,-1492,4856,155136,7685,29645,154094,59649,25039,38752,5198,640,6193,6748,1386,746,22569,2010
25,"Culpeper, VA",836656,52925,101184,86670,1161076,986,-4013,96260,1729264,113519,36944,1730250,420680,285876,283298,46834,6276,109506,144519,21797,15521,582631,2010
26,"Cumberland, VA",73748,5626,9175,6128,165565,9289,8237,8690,269297,12176,27781,278586,100507,38209,74812,10028,748,20413,12239,2194,1446,41096,2010
27,"Dickenson, VA",218615,17512,29710,22610,219709,-1624,-1683,28817,454106,17111,28555,452482,29911,54678,178095,15846,858,15428,41015,5149,4291,162172,2010
28,"Dinwiddie, Colonial Heights + Petersburg, VA*",1536263,99757,214173,172952,1433823,-834,-2167,186233,2653132,71386,34047,2652298,83793,401571,816904,77902,7023,69219,300649,40567,33544,1166395,2010
29,"Essex, VA",174973,12325,22329,18704,207135,-2521,-3336,21677,372772,19042,33221,370251,53839,68111,95005,11145,1300,15706,31681,5409,4109,127586,2010
30,"Fairfax, Fairfax City + Falls Church, VA*",63086221,3615818,5624116,6630788,54739464,5080,3283,6931212,74393381,4272169,66356,74398461,-1415545,14981389,4677608,1121203,160270,4275452,8939510,825687,665417,49871259,2010
31,"Fauquier, VA",1435352,88658,138412,134144,2496865,-9243,-21326,155730,3702190,317612,56439,3692947,1217243,853838,342244,65433,10154,296286,205484,32311,22157,933582,2010
32,"Floyd, VA",142692,11336,17510,12858,268512,2242,-2252,17765,456768,35362,29870,459010,143585,72355,118143,15367,2432,33110,23939,5627,3195,85643,2010
33,"Fluvanna, VA",245105,18287,32246,22576,566160,-303,-902,29575,899479,48000,34863,899176,350630,175970,157046,25792,2915,47098,43534,7423,4508,154473,2010
34,"Franklin, VA",665529,49272,74596,65634,1021107,10615,5914,82089,1753262,124700,31400,1763877,437667,306564,436206,56174,6748,130614,107413,20746,13998,427502,2010
35,"Frederick + Winchester, VA*",2835377,170188,337379,310148,2783215,-1373,-6090,325262,4066412,240798,38827,4065039,273100,664475,617349,104695,12328,234708,492453,63784,51456,2108216,2010
36,"Giles, VA",272833,19527,39235,29142,308913,-1910,-2326,34098,546747,25303,31463,544837,70178,80489,155435,17317,1794,22977,53806,7011,5217,196050,2010
37,"Gloucester, VA",449109,31355,57835,43972,968229,1753,1180,53341,1491468,64441,40421,1493221,572461,281918,243074,36942,3861,65621,79821,13841,9980,303667,2010
38,"Goochland, VA",980626,58697,94807,98852,936372,-734,-2745,108123,1502531,60310,68556,1501797,63869,413316,152109,21906,3505,57565,144233,15371,11866,778828,2010
39,"Grayson, VA",111572,10989,16137,11166,201605,316,-1450,16572,415746,20540,26843,416062,106605,63935,150522,15500,2029,19090,21720,4723,2694,70762,2010
40,"Greene, VA",185731,13130,20473,17916,424976,1106,313,22088,631122,34254,34211,632228,261333,101928,105324,18480,1971,34567,29431,5620,3649,121733,2010
41,"Greensville + Emporia, VA*",341882,21955,53412,39646,250481,-1081,-1963,41778,456491,6921,25087,455410,-49623,62060,142869,18153,1049,4958,73235,9700,8651,263689,2010
42,"Halifax, VA",599085,41528,87843,64618,555753,7554,4090,73837,1041813,45615,28985,1049367,30505,160003,333611,36204,3231,49705,120152,16446,13215,429228,2010
43,"Hampton (Independent City), VA",4218730,229078,677540,509174,3025065,0,0,483665,4895276,150186,35623,4895276,-710000,863539,1006672,137418,9371,150186,932127,76859,67488,3136417,2010
44,"Hanover, VA",2465267,150901,270681,268864,3170288,4132,-2939,285333,4479851,227025,44891,4483983,990354,745175,568520,99886,12769,224086,405113,60644,47875,1836068,2010
45,"Henrico, VA",12031437,706796,1182721,1226192,10125463,1413,218,1319892,14378448,1515888,46809,14379861,-586082,2444048,1810350,307201,38127,1516106,1795817,218651,180524,8719514,2010
46,"Henry + Martinsville, VA*",1147695,82995,150434,130086,1021546,6895,6056,148038,2061005,94748,30460,2067900,21889,357100,689254,67888,5378,100804,215477,31700,26322,831414,2010
47,"Highland, VA",26775,2083,3621,2240,30485,1717,1110,3203,72926,5314,32496,74643,6913,23501,20657,2297,702,6424,4741,1306,604,15610,2010
48,"Isle of Wight, VA",603309,39850,69350,59870,1114101,3254,1365,69785,1600461,59161,45407,1603715,580577,238669,250945,35319,3517,60526,99285,14202,10685,443498,2010
49,"James City + Williamsburg, VA*",2202378,137276,260639,224470,2570187,538,28,249511,4225552,314646,51926,4226090,617320,1052988,602915,81387,10585,314674,372874,54242,43657,1514830,2010
50,"King George, VA",1056447,56502,160870,119280,749698,-2252,-2703,116142,1075857,67715,45306,1073605,-190607,208756,115151,23697,2310,65012,220510,13347,11037,770925,2010
51,"King William, VA",201582,13842,23397,21064,398588,927,-474,24374,580994,22649,36372,581921,221380,82695,100638,15999,1626,22175,33929,5401,3775,145478,2010
52,"King and Queen, VA",73620,5363,9662,7330,142796,80,-742,9028,233730,13716,33516,233810,78204,36384,54630,6976,703,12974,13327,1903,1200,47319,2010
53,"Lancaster, VA",239059,17480,27686,23520,197257,-536,-873,29240,499160,37901,43885,498624,-12562,179535,121832,11362,2024,37028,39446,7121,5097,162585,2010
54,"Lee, VA",265914,21006,42177,28078,336029,-3729,-4594,35045,668345,25891,25955,664616,105160,83624,244963,25606,2245,21297,56216,8075,5830,188401,2010
55,"Loudoun, VA",10841061,619613,1059225,1123376,16473525,-6534,-17729,1181301,20152009,1012297,63855,20145475,6813765,2735585,936365,315486,41295,994568,1620913,183855,142560,8225580,2010
56,"Louisa, VA",587511,37823,81866,58736,757350,-2615,-3968,67191,1167918,62160,35132,1165303,237030,187573,220380,33169,3485,58192,111234,12229,8744,418085,2010
57,"Lunenburg, VA",125844,9856,18147,13720,163101,-751,-2374,16716,331262,11816,25603,330511,53973,60887,106523,12909,964,9442,25007,3837,2873,91395,2010
58,"Madison, VA",157724,11587,18092,15818,272699,-649,-3338,19496,450155,32156,33800,449506,134471,92189,84618,13299,2015,28818,26001,5292,3277,102905,2010
59,"Mathews, VA",88513,7708,8804,6810,207544,200,-3,11113,403925,29780,45033,404125,130144,116639,79942,8974,1335,29777,12209,3004,1669,46527,2010
60,"Mecklenburg, VA",543515,38440,77010,61202,474703,3628,-1040,69041,939732,34773,28835,943360,229,165418,303239,32716,2985,33733,107611,16121,13136,402171,2010
61,"Middlesex, VA",178177,13155,21910,15378,208026,1227,179,20844,424045,40339,38728,425272,50693,113462,103784,10981,1814,40518,29599,5362,3548,108060,2010
62,"Montgomery + Radford, VA*",2485330,144575,393282,270208,1893779,1340,-1664,279679,3080957,114273,27770,3082297,-311872,622919,565599,110992,10195,112609,528386,59620,49425,1844335,2010
63,"Nelson, VA",183622,14068,20807,16400,300615,1833,-1029,22268,548123,45790,36718,549956,139261,116655,132686,14978,2653,44761,29007,6326,3673,109854,2010
64,"New Kent, VA",200972,14081,23898,19808,783691,-847,-1085,23985,1016326,36894,54763,1015479,606704,122212,109576,18543,2565,35809,33802,6523,3958,131361,2010
65,"Newport News (Independent City), VA",6471769,352095,1002773,722196,4027407,0,0,713193,6261985,299554,34615,6261985,-1731169,1016715,1217863,180905,13145,299554,1363871,119543,106398,4808344,2010
66,"Norfolk (Independent City), VA",13400189,648567,2251879,1658104,4892106,0,0,1477619,8260186,528339,33990,8260186,-7030464,1710964,1657116,243019,18096,528339,3080931,210781,192685,9790919,2010
67,"Northampton, VA",259217,15263,28963,25302,226852,42877,30383,27914,393751,24554,35184,436628,-4451,87696,122080,12410,1725,54937,41614,6988,5263,162666,2010
68,"Northumberland, VA",129957,12013,15941,12912,172155,-660,-1448,18469,454992,22842,36770,454332,60667,158752,123425,12356,1627,21394,22397,4407,2780,86166,2010
69,"Nottoway, VA",277502,18468,47642,32826,228124,4056,2180,34881,454428,10762,28932,458484,-14497,77115,153245,15847,1495,12942,64055,7631,6136,200505,2010
70,"Orange, VA",448105,31993,51872,44018,760883,11415,1783,54002,1258563,70633,37835,1269978,366780,253132,255963,33566,4223,72416,73881,13050,8827,301808,2010
71,"Page, VA",296527,20745,37160,29604,431725,24603,22201,35547,715258,43212,30748,739861,170745,118933,189203,24062,2630,65413,51962,8781,6151,179152,2010
72,"Patrick, VA",211156,16651,29866,22474,245801,2225,217,27888,488943,26787,26587,491168,62533,78745,166622,18474,2225,27004,41103,7690,5465,143049,2010
73,"Pittsylvania + Danville, VA*",1755419,122658,232083,199642,1613427,19049,11608,222479,3037908,100883,28700,3056957,80487,456552,986978,106516,8866,112491,331904,48651,39785,1311024,2010
74,"Portsmouth (Independent City), VA",3354655,178576,601175,401362,1943423,0,0,379257,3298129,89665,34551,3298129,-1031975,544975,809731,95457,6700,89665,801856,57359,50659,2463134,2010
75,"Powhatan, VA",358853,23832,46189,34780,794855,523,-182,41222,1120062,53738,39832,1120585,477224,177453,148277,28133,3284,53556,63579,10054,6770,241718,2010
76,"Prince Edward, VA",408399,26279,57168,45626,303178,3581,2681,49092,561390,26124,24181,564971,-56129,96038,165755,23364,2191,28805,79981,11734,9543,299613,2010
77,"Prince George + Hopewell, VA*",2061943,102788,385820,254028,1126787,-4426,-4762,229802,1880578,45216,32190,1876152,-705354,346436,402929,58283,3318,40454,512834,33083,29765,1508655,2010
78,"Prince William, Manassas + Manassas Park, VA*",9406817,532989,1109127,1018060,16640490,-1467,-4229,1042019,21619488,991213,47114,21618021,8275692,3171084,1806447,458846,48365,986984,1618157,194469,146104,6801676,2010
79,"Pulaski, VA",563807,39299,76201,62700,596318,1106,-207,70649,1067927,53589,30693,1069033,103160,158060,314655,34830,2691,53382,107551,14654,11963,402874,2010
80,"Rappahannock, VA",110865,8015,9637,8084,219659,-2751,-4334,12057,368508,39392,48755,365757,120851,94876,51222,7502,1620,35058,13679,3249,1629,62128,2010
81,"Richmond (Independent City), VA",11523164,653448,1391777,1171514,5010151,0,0,1239205,8615326,970669,42155,8615326,-5273808,1947396,1657779,204375,19211,970669,1977534,177780,158569,8574961,2010
82,"Richmond, VA",144600,9550,22008,14948,135188,2627,792,17024,245293,10717,26727,247920,7612,49174,63558,9276,911,11509,29482,3993,3082,103609,2010
83,"Roanoke (Independent City), VA",3861531,231867,467322,452510,1947219,0,0,458122,3431805,270601,35481,3431805,-1456190,603840,880746,96722,8416,270601,693577,79022,70606,2897353,2010
84,"Roanoke + Salem, VA*",3636193,223291,445014,380032,3187853,55,-602,413307,4908468,375945,41841,4908523,-35033,857974,862696,117313,12907,375343,635030,76166,63259,2625820,2010
85,"Rockbridge, Buena Vista + Lexington, VA*",660296,44831,83256,73702,611927,-4616,-6539,81682,1141453,81835,31574,1136837,33313,249892,275018,36006,4537,75296,120107,18915,14378,464893,2010
86,"Rockingham + Harrisonburg, VA*",3190852,184707,398518,324182,2490235,113905,97240,346798,3725301,299453,30613,3839206,-353819,665920,683051,125412,15069,396693,560609,77309,62240,2233550,2010
87,"Russell, VA",377244,29392,51608,42056,457358,-2246,-3768,50420,841459,39374,29066,839213,130534,101116,280739,28873,2576,35606,72636,10285,7709,269002,2010
88,"Scott, VA",223833,20079,31519,24638,312280,-4717,-5404,32398,625772,21230,26854,621055,120845,85446,223329,23127,2671,15826,43838,8028,5357,164169,2010
89,"Shenandoah, VA",654709,44567,81149,65492,837409,13688,10343,77313,1396346,91151,33534,1410034,260013,268540,304085,42048,5645,101494,113895,19765,14120,439320,2010
90,"Smyth, VA",562100,39398,82954,62338,487000,-1398,-3117,70567,911424,48624,28263,910026,-4533,120777,302249,32198,3270,45507,114123,15541,12271,402470,2010
91,"Southampton + Franklin, VA*",368975,25669,56306,39264,446150,-1888,-5576,45301,813672,28223,29822,811784,122476,134589,231045,27221,2404,22647,75938,11031,8627,270390,2010
92,"Spotsylvania + Fredericksburg, VA*",2918452,176265,348717,321702,4311356,-1551,-3027,337116,6165076,201664,41833,6163525,1730020,1059355,792814,147337,13795,198637,509568,73195,59400,2210247,2010
93,"Stafford, VA",2609110,145467,353741,285536,4542440,-2942,-3353,288235,6132424,231715,47202,6129482,2221565,1018048,568994,129857,11659,228362,496509,51543,39884,1884239,2010
94,"Suffolk (Independent City), VA",1536035,95390,191715,162448,2410385,10411,263,176614,3578560,160530,42293,3588971,1050964,598669,579917,84859,8207,160793,272939,34728,26521,1102303,2010
95,"Surry, VA",233426,13407,40595,23806,146916,650,-389,25310,232667,6149,33118,233317,-61200,33384,53017,7045,620,5760,52498,3041,2421,175168,2010
96,"Sussex, VA",179112,11778,27047,19198,178102,4302,2706,21377,312428,9177,26366,316730,20367,45192,93436,12013,806,11883,36646,4658,3852,130583,2010
97,"Tazewell, VA",799434,56568,109218,85610,761533,-679,-1545,99373,1412414,67724,31290,1411735,61472,210566,439636,45118,3619,66179,152023,21522,17903,581232,2010
98,Virginia,263971808,15337139,31027480,28376402,249044710,333211,79353,29525340,364912269,22237956,45519,365245480,14598242,66616486,49584284,8024004,890637,22317309,45215681,4743189,3852552,196438818,2010
99,"Virginia Beach (Independent City), VA",10653650,597166,1447682,1223654,12864513,-107,-1718,1208993,19605681,715138,44673,19605574,3419856,4159945,2581116,438864,46407,713420,2059509,240301,193894,7880721,2010
100,"Warren, VA",599368,38764,73879,63878,946945,-2978,-3729,70703,1434356,71774,38150,1431378,418280,255112,229321,37520,4244,68045,105818,16578,12334,425505,2010
101,"Washington + Bristol, VA*",1736182,113797,212118,172690,1423545,-1566,-4702,200142,2496834,257489,34306,2495268,-112495,428945,642778,72735,8232,252787,298463,41679,33447,1184932,2010
102,"Westmoreland, VA",161104,13075,21252,16098,301796,4984,-98,21124,586628,23246,33820,591612,161816,143748,146068,17493,2005,23148,29301,5902,3897,108655,2010
103,"Wise + Norton, VA*",1113086,73469,142784,125470,755124,1034,930,136204,1385696,50591,30419,1386730,-221758,161784,469822,45587,2968,51521,205519,23933,20965,856046,2010
104,"Wythe, VA",508117,35021,73679,55314,462018,-992,-3509,62678,838417,46098,28628,837425,16579,122466,252941,29252,3188,42589,101336,15230,12042,364192,2010
105,"York + Poquoson, VA*",1296236,79002,175479,140030,2594342,1514,782,149017,3773807,136562,48794,3775321,1447123,755248,425731,77372,6503,137344,245494,32059,25556,913398,2010
0,"Accomack, VA",647359,33489,86457,66730,597117,35831,30404,66854,1093129,56764,33977,1128960,16612,225985,305858,33227,3843,87168,119822,17567,13724,440369,2011
1,"Albemarle + Charlottesville, VA*",6031959,268098,724048,605106,4405347,706,-7579,570651,7648179,770186,53113,7648885,-1055961,2435184,808354,144011,22618,762607,1026601,114353,91735,4242751,2011
2,"Alexandria (Independent City), VA",9734373,412601,968463,1032978,8404833,0,0,929090,11272972,1327448,78139,11272972,-400450,2211781,656358,144269,20323,1327448,1484952,120806,100483,6921973,2011
3,"Alleghany + Covington, VA*",455355,26042,55598,53004,387800,-2005,-2275,52544,723924,19466,32697,721919,-15011,110956,223163,22079,1352,17191,82100,9816,8464,356064,2011
4,"Amelia, VA",145591,8186,14157,12752,268860,20378,17176,14562,413927,24755,34071,434305,137831,61969,103476,12747,1713,41931,20533,4323,2610,83127,2011
5,"Amherst, VA",448764,26322,60793,48132,584024,-1790,-2453,50388,992016,39023,30791,990226,185648,144577,261625,32160,2916,36570,84859,12514,9598,327335,2011
6,"Appomattox, VA",149727,10290,19904,15736,278183,-2004,-2670,18158,478660,19958,31558,476656,146614,65856,132617,15104,1709,17288,27772,5201,3492,104667,2011
7,"Arlington, VA",21024532,853232,2425999,2289728,13664715,0,0,1998096,17775526,1758438,82264,17775526,-5361721,3276096,834715,216078,28092,1758438,3570863,215762,187670,15695231,2011
8,"Augusta, Staunton + Waynesboro, VA*",2593517,137987,296578,256990,2664051,42642,35707,266482,4287429,394185,36455,4330071,337016,743697,922323,118778,13116,429892,425073,61537,48421,1738552,2011
9,"Bath, VA",117222,6331,12782,12356,99629,-469,-915,12509,205431,20488,44031,204962,-5084,63118,42215,4655,659,19573,18960,2994,2335,78689,2011
10,"Bedford, VA*",991258,60410,106962,104002,1782465,-3182,-4838,112411,2831957,156843,37440,2828775,903618,475873,570437,75555,9455,152005,158963,29546,20091,680290,2011
11,"Bland, VA",113793,6432,18616,12080,112492,-474,-843,12472,200889,8505,29577,200415,11171,30274,57649,6776,814,7662,24656,2867,2053,81475,2011
12,"Botetourt, VA",505964,29126,56065,53496,904858,-259,-1436,55874,1368916,71116,41473,1368657,454768,224858,238941,33001,4115,69680,82813,13454,9339,353471,2011
13,"Brunswick, VA",185538,11508,26366,20356,231794,5522,3937,21686,459071,10528,27139,464593,67942,67288,165511,17119,1255,14465,36544,5802,4547,134529,2011
14,"Buchanan, VA",533574,31325,59977,59342,392558,-313,-358,60996,760808,32149,31907,760495,-80020,94304,273633,23835,1246,31791,89648,10061,8815,412135,2011
15,"Buckingham, VA",180016,10525,24209,17282,241553,6909,5935,19166,415690,22814,24545,422599,80703,62350,118696,17217,1345,28749,32850,4763,3418,118417,2011
16,"Campbell + Lynchburg, VA*",3790577,184741,416189,431416,2397175,1311,-469,400449,4336203,234234,33007,4337514,-992953,701983,1238356,131413,12054,233765,631897,84317,72263,2924915,2011
17,"Caroline, VA",302218,17173,43440,32044,656162,3576,1932,33195,992135,32213,34728,995711,387139,144701,194848,28672,2562,34145,59462,8372,5810,208611,2011
18,"Carroll + Galax, VA*",542550,33242,67215,59216,542200,4448,2668,62850,1065247,62629,28960,1069695,62500,144507,382988,36937,3352,65297,96823,16312,12960,380430,2011
19,"Charles City, VA",96846,5576,10325,9672,154190,4965,3925,10412,248313,13642,35178,253278,67756,42289,56799,7200,538,17567,15161,2196,1658,64118,2011
20,"Charlotte, VA",131214,8972,18134,12466,170713,4328,2839,15205,344037,21060,27876,348365,54704,58586,119066,12497,1924,23899,24367,4845,2921,82948,2011
21,"Chesapeake (Independent City), VA",5328484,249261,596790,596850,6801187,7766,3671,547686,9774458,409945,43407,9782224,2020389,1623524,1357513,225360,20778,413616,895215,122009,101231,4019653,2011
22,"Chesterfield, VA",7186141,341305,809199,794722,9953773,1169,439,738666,14122768,542421,44090,14123937,3506298,2345907,1824257,320344,36693,542860,1206560,158757,122064,5436721,2011
23,"Clarke, VA",265518,13712,23035,24664,498013,7929,4409,26044,751053,62043,53461,758982,258539,175338,85631,14197,2755,66452,35367,6902,4147,163699,2011
24,"Craig, VA",36355,2923,4824,3396,91634,-669,-1091,4621,159731,8240,30766,159062,59900,26618,40810,5170,608,7149,6522,1338,730,22684,2011
25,"Culpeper, VA",882575,44461,98226,88786,1247606,4660,66,88854,1838669,145964,38932,1843329,453885,303679,292044,47347,6373,146030,142619,21888,15515,593926,2011
26,"Cumberland, VA",73266,4973,8765,6124,167604,9423,8505,8035,277511,12241,28731,286934,102373,40625,78705,9987,765,20746,11827,2191,1426,40693,2011
27,"Dickenson, VA",222703,14958,27152,23074,224001,-1656,-1711,26495,453888,18489,28662,452232,27793,50475,177756,15778,784,16778,38689,4960,4176,167236,2011
28,"Dinwiddie, Colonial Heights + Petersburg, VA*",1563767,80665,203750,176636,1490060,7529,6465,168983,2762523,81600,35745,2770052,95276,432946,847046,77495,7270,88065,292068,40780,33510,1183634,2011
29,"Essex, VA",179830,10120,20686,18588,216072,4757,4033,19414,379487,21147,34406,384244,55656,70025,98147,11168,1286,25180,29980,5332,4046,124670,2011
30,"Fairfax, Fairfax City + Falls Church, VA*",66170787,2894463,5612252,6968558,58373508,3522,1878,6378742,80061140,5284726,70311,80064662,-1418537,16750601,4940553,1138729,164309,5286604,9096531,838615,674306,51787652,2011
31,"Fauquier, VA",1501670,73562,140913,144620,2602793,-4345,-14701,145872,3918363,313415,59275,3914018,1246995,955067,356158,66032,10419,298714,213223,33041,22622,989733,2011
32,"Floyd, VA",146776,9958,16534,13286,281220,3736,309,16601,474031,36031,31016,477767,151045,77934,118613,15404,2500,36340,23177,5673,3173,87259,2011
33,"Fluvanna, VA",252357,15811,31775,24140,587642,-481,-983,27881,939645,47685,36179,939164,363166,190683,160839,25959,2856,46702,43845,7499,4643,161810,2011
34,"Franklin, VA",681378,42181,72615,67582,1080009,18717,14664,75972,1849281,128300,33156,1867998,474603,336672,451317,56339,6985,142964,106406,21093,14108,432008,2011
35,"Frederick + Winchester, VA*",2977775,140113,332165,328590,2963385,1825,-1966,304408,4317430,290474,40678,4319255,290018,728709,627161,106182,12957,288508,496460,65812,52855,2192807,2011
36,"Giles, VA",282378,16526,37350,30604,321702,-930,-1324,31828,559417,27930,32561,558487,71152,81091,155694,17152,1795,26606,52652,7128,5333,203120,2011
37,"Gloucester, VA",452478,26158,54949,44718,982175,2823,2311,48517,1548875,66421,42055,1551698,578214,311052,258471,36897,3720,68732,77308,13740,10020,306438,2011
38,"Goochland, VA",1093080,50538,95667,109668,1022711,1021,-533,105372,1645435,65002,76448,1646456,35003,452458,171287,21537,3505,64469,150501,15760,12255,878110,2011
39,"Grayson, VA",113363,9921,15199,11012,205555,1752,286,15427,419478,20776,27410,421230,107619,62924,152751,15368,2020,21062,20705,4645,2625,71596,2011
40,"Greene, VA",205998,11902,20423,19970,443095,1351,610,21887,662049,40849,35487,663400,258984,109794,110511,18694,1959,41459,30408,5812,3853,134131,2011
41,"Greensville + Emporia, VA*",357427,17849,50867,40912,259220,9555,8769,38305,461912,8450,26425,471467,-59902,63119,149128,17842,1059,17219,71323,9772,8713,268885,2011
42,"Halifax, VA",585278,33921,81247,63724,547287,7974,5013,65783,1041797,45890,29163,1049771,27792,166241,336243,35997,3428,50903,113109,16340,12912,421266,2011
43,"Hampton (Independent City), VA",4203178,178264,670845,515450,3056879,0,0,435989,5004658,154635,36623,5004658,-710310,899616,1048163,136652,9710,154635,928570,76136,66426,3119973,2011
44,"Hanover, VA",2523717,121871,258468,279326,3311534,10528,4461,261534,4706028,247558,47213,4716556,1049351,816972,588050,99899,13159,252019,398131,61402,48243,1873567,2011
45,"Henrico, VA",13022458,595448,1153647,1330582,10929359,1923,942,1260739,15469902,1888960,49845,15471825,-832360,2687114,1855352,310401,40134,1889902,1818938,223999,183865,9313618,2011
46,"Henry + Martinsville, VA*",1117840,67735,140519,128066,1027253,7101,6424,131768,2093725,91896,31285,2100826,41181,366548,707025,67152,5939,98320,204552,31797,25858,814968,2011
47,"Highland, VA",29374,1821,3376,2248,32400,5068,4526,2945,76695,5066,36178,81763,5971,27933,21430,2260,677,9592,4500,1266,589,15282,2011
48,"Isle of Wight, VA",571039,30861,58554,54638,1147764,12495,10974,58180,1646119,65233,46985,1658614,634905,249776,261074,35301,3578,76207,85873,13753,10175,408959,2011
49,"James City + Williamsburg, VA*",2159849,108542,243010,225234,2695456,-12,-488,221159,4493822,296861,54514,4493810,756766,1162626,635728,82434,10740,296373,355627,53506,42766,1507849,2011
50,"King George, VA",1089031,44567,171586,125684,774783,-2185,-2573,107409,1113454,69119,45775,1111269,-206839,215432,121054,24277,2309,66546,234428,13646,11337,788057,2011
51,"King William, VA",203828,11311,22243,21100,408777,4166,3319,21861,592566,23157,37265,596732,226810,85673,102282,16013,1731,26476,32793,5361,3630,144559,2011
52,"King and Queen, VA",76681,4609,8818,7152,150389,4797,4021,8185,237807,15352,34727,242604,81893,36523,55692,6986,737,19373,12394,1897,1160,44914,2011
53,"Lancaster, VA",238815,14608,25589,24126,199633,1487,1181,26671,511660,36599,45508,513147,-12511,186008,127506,11276,2002,37780,37652,7029,5027,163383,2011
54,"Lee, VA",275134,18568,40887,29024,347628,-1608,-2351,33080,686210,28771,26799,684602,105574,82411,254563,25546,2240,26420,55399,8028,5788,193315,2011
55,"Loudoun, VA",11263164,492742,1055773,1197048,17862928,-6147,-16076,1091266,21832892,1033533,66880,21826745,7691030,2978581,985236,326357,43157,1017457,1654297,190953,147796,8591410,2011
56,"Louisa, VA",592210,30705,79446,58906,758318,41,-1150,60158,1181176,63986,35445,1181217,226266,193020,229879,33325,3702,62836,108899,12543,8841,420475,2011
57,"Lunenburg, VA",124840,8146,16686,13268,168443,4688,3156,14780,340021,11913,26707,344709,58383,67619,108647,12907,969,15069,23320,3772,2803,86451,2011
58,"Madison, VA",163249,9885,17043,15392,293813,1389,-954,17581,485684,39753,37062,487073,148145,104809,88451,13142,2051,38799,24739,5279,3228,99711,2011
59,"Mathews, VA",88199,6754,8215,6862,210402,389,284,10185,423503,29989,47394,423892,132388,130713,82777,8944,1355,30273,11646,2969,1614,46280,2011
60,"Mecklenburg, VA",542562,31800,71933,61314,481719,4145,35,62457,963989,38973,29727,968134,1614,178047,308368,32567,3073,39008,102590,16065,12992,400964,2011
61,"Middlesex, VA",181090,11242,20590,15700,212637,2187,1266,19092,436114,42261,40378,438301,50639,117563,108101,10855,1755,43527,28440,5265,3510,109123,2011
62,"Montgomery + Radford, VA*",2499064,114000,377298,275018,1948941,4044,1492,251509,3208500,106784,28792,3212544,-298614,685115,578488,111578,10480,108276,514807,60038,49558,1875981,2011
63,"Nelson, VA",191235,12270,20418,17080,320957,2446,44,20810,581298,49379,38867,583744,150532,126887,135900,15019,2676,49423,28958,6374,3698,112854,2011
64,"New Kent, VA",204536,11774,23108,20308,839161,1407,1220,21928,1083898,37216,57843,1085305,656553,132651,113493,18763,2607,38436,33262,6592,3985,132838,2011
65,"Newport News (Independent City), VA",6729514,284697,963168,760158,4206635,0,0,664776,6567503,398988,36458,6567503,-1858103,1093520,1267348,180139,13840,398988,1343247,119929,106089,4987279,2011
66,"Norfolk (Independent City), VA",13211127,490282,2204381,1696576,4846825,0,0,1338570,8428774,355861,34587,8428774,-7025732,1860557,1721392,243701,19712,355861,3052669,210323,190611,9802597,2011
67,"Northampton, VA",257552,12722,26580,24698,229582,42118,31886,25071,415626,25828,36897,457744,-2899,99938,128224,12406,1706,57714,38929,6686,4980,160909,2011
68,"Northumberland, VA",137725,10713,14992,13380,187813,3800,3103,17403,484417,23134,39208,488217,67491,168255,132149,12452,1684,26237,21682,4406,2722,89806,2011
69,"Nottoway, VA",282357,15203,46818,33832,224882,4809,3121,32119,461739,10534,29359,466548,-25356,84559,157107,15891,1506,13655,63734,7621,6115,204968,2011
70,"Orange, VA",447923,26695,51025,43858,799457,9705,1355,48624,1325854,76947,39302,1335559,400158,275546,260556,33982,4265,78302,72954,13100,8835,296667,2011
71,"Page, VA",295645,17689,34545,30394,434872,23125,20963,32886,742041,45248,31940,765166,172113,132875,197419,23956,2676,66211,49742,8867,6191,179692,2011
72,"Patrick, VA",214899,14434,28137,22618,251731,2613,1027,25743,501452,31370,27486,504065,62575,81830,170504,18339,2269,32397,39446,7601,5332,143056,2011
73,"Pittsylvania + Danville, VA*",1789949,102341,224717,206386,1662849,20326,13873,205534,3128730,106928,29729,3149056,78434,477419,1008788,105926,9569,120801,327910,50292,40723,1341238,2011
74,"Portsmouth (Independent City), VA",3504498,144396,631821,425890,2002124,0,0,357341,3420267,109047,35714,3420267,-1145033,577345,840798,95767,6971,109047,844766,58015,51044,2550685,2011
75,"Powhatan, VA",368278,19972,45193,36208,814984,923,311,38076,1163510,55703,41383,1164433,484782,192898,156551,28138,3321,56014,63297,10212,6891,248967,2011
76,"Prince Edward, VA",406852,21022,54765,45396,306897,2991,2208,43720,571824,30927,25744,574815,-56235,99935,167983,22328,2205,33135,77463,11803,9598,296254,2011
77,"Prince George + Hopewell, VA*",2221648,84314,417687,279728,1157667,1034,717,224178,1946018,48975,32871,1947052,-839803,369602,419783,59234,3423,49692,557551,33901,30478,1614405,2011
78,"Prince William, Manassas + Manassas Park, VA*",9886478,434594,1128219,1082030,17691964,-30,-2305,975609,23015506,1129268,48625,23015476,8781095,3398109,1925403,473323,51094,1126963,1669234,201788,150694,7090281,2011
79,"Pulaski, VA",638299,35562,79236,73176,638598,3115,1971,72150,1118109,57248,32274,1121224,72449,167973,314653,34741,2641,59219,115824,15581,12940,463256,2011
80,"Rappahannock, VA",119937,7161,9417,8502,220010,-1519,-2943,11412,390247,44299,51983,388728,111485,115925,52793,7478,1667,41356,13668,3287,1620,64913,2011
81,"Richmond (Independent City), VA",11662573,509990,1322167,1204684,5411232,0,0,1112332,9303034,1126620,45054,9303034,-5139009,2192227,1699575,206487,21430,1126620,1924509,181036,159606,8611444,2011
82,"Richmond, VA",146202,7791,21125,15132,138654,4337,2620,15357,252772,10530,27934,257109,7809,50721,67734,9204,915,13150,28691,3979,3064,104361,2011
83,"Roanoke (Independent City), VA",3969888,186646,448760,472350,2027730,0,0,422821,3555924,312037,36738,3555924,-1519337,631963,896231,96791,8969,312037,684935,79751,70782,2972916,2011
84,"Roanoke + Salem, VA*",3713873,180643,427946,402884,3281835,223,-382,382085,5043841,382397,42793,5044064,-49953,897022,865207,117871,13174,382015,629388,76410,63236,2702470,2011
85,"Rockbridge, Buena Vista + Lexington, VA*",664022,36752,78745,74894,624721,-542,-2224,74199,1184100,83721,32748,1183558,34898,276584,282253,36141,4621,81497,116192,18803,14182,466333,2011
86,"Rockingham + Harrisonburg, VA*",3270959,148991,379402,337166,2585398,131382,116220,317574,3908437,310656,31855,4039819,-367987,737025,717396,126818,15628,426876,547985,78824,63196,2296098,2011
87,"Russell, VA",379025,24950,47377,42746,468176,-1180,-2595,46323,857904,41490,29871,856724,135474,100790,287758,28681,2539,38895,68750,10122,7583,271380,2011
88,"Scott, VA",227226,17342,29899,25020,336856,-3607,-4168,29852,664302,24160,28660,660695,139482,96502,227337,23053,2782,19992,42409,8082,5300,164825,2011
89,"Shenandoah, VA",674038,37413,77813,68026,877241,19729,16826,71426,1462751,95144,35075,1482480,274629,293074,312165,42266,5779,111970,111826,19994,14215,450242,2011
90,"Smyth, VA",577014,32981,78619,63818,514296,4058,2589,64890,947668,54293,29691,951726,2172,131797,305633,32054,3319,56882,110528,15631,12312,409604,2011
91,"Southampton + Franklin, VA*",393927,21164,52785,39444,477567,24301,20997,40886,843686,30888,32046,867987,124526,153147,237273,27086,2529,51885,72507,10962,8433,269535,2011
92,"Spotsylvania + Fredericksburg, VA*",2972236,141913,324835,330386,4527283,387,-845,307106,6519609,228939,43375,6519996,1862153,1152784,839929,150316,14433,228094,490028,73457,59024,2254114,2011
93,"Stafford, VA",2847109,123203,381445,317458,4746637,-2869,-3228,281932,6432827,241485,48619,6429958,2181460,1074467,608854,132251,12211,238257,540174,54515,42304,2068678,2011
94,"Suffolk (Independent City), VA",1565506,77432,184426,167948,2467011,15401,6748,161406,3691253,166656,43706,3706654,1062911,629248,610395,84808,8510,173404,268400,35183,26673,1123702,2011
95,"Surry, VA",243835,10697,41471,25088,149598,5184,4421,23241,233201,5364,34434,238385,-70996,35316,53471,6923,544,9785,54015,3047,2503,180035,2011
96,"Sussex, VA",188183,9635,26566,19534,182658,11154,9904,19402,310801,7995,26634,321955,13877,44704,94593,12088,842,17899,36333,4709,3867,133951,2011
97,"Tazewell, VA",814565,47097,102781,88368,799985,802,10,91281,1466417,72104,32799,1467219,76701,218541,448693,44733,3820,72114,146965,21520,17700,595486,2011
98,Virginia,272116862,12328968,30466061,29588324,261869982,606655,388840,27123130,385377798,24374362,47638,385984453,16876250,72698608,51415863,8102437,921009,24763202,45260223,4802678,3881669,202093437,2011
99,"Virginia Beach (Independent City), VA",11143035,487976,1460255,1288116,13387358,4022,2676,1132034,20514218,851578,46353,20518240,3376357,4439951,2690931,442654,48029,854254,2104313,241829,193800,8184468,2011
100,"Warren, VA",609945,31877,70147,65310,1002942,-1978,-2621,64532,1527094,79432,40503,1525116,457529,284037,238137,37654,4303,76811,102802,16709,12406,430332,2011
101,"Washington + Bristol, VA*",1791779,94677,200466,178952,1521216,2432,-276,184153,2687909,293791,37075,2690341,-86410,516921,652204,72565,8473,293515,289942,42037,33564,1208322,2011
102,"Westmoreland, VA",170549,11549,20397,16700,320056,9632,5372,19899,611489,25099,35213,621121,169406,150503,150562,17639,2046,30471,28747,5982,3936,111331,2011
103,"Wise + Norton, VA*",1109799,58647,135829,128758,768909,1035,949,123026,1419634,49148,31191,1420669,-217864,165695,486065,45548,2944,50097,200208,24192,21248,859494,2011
104,"Wythe, VA",521939,29269,70964,57736,472099,3012,822,58137,849333,45995,29186,852345,8297,124023,256223,29204,3382,46817,99832,15596,12214,375290,2011
105,"York + Poquoson, VA*",1304530,64124,166428,146342,2623489,833,179,137295,3904856,133058,50177,3905689,1456254,831929,450271,77839,6632,133237,239599,32731,26099,931694,2011
0,"Accomack, VA",686271,34773,89012,71102,619517,33910,26841,70324,1155672,68692,35749,1189582,3570,261375,308690,33276,3808,95533,124563,17588,13780,466175,2012
1,"Albemarle + Charlottesville, VA*",6425249,278159,745766,630378,4767788,7558,-4799,593348,8406308,933085,57584,8413866,-1064113,2821041,825037,146114,23325,928286,1060955,116265,92940,4436008,2012
2,"Alexandria (Independent City), VA",10183159,426710,1010887,1072508,8803589,0,0,962964,11951904,1511310,81096,11951904,-416606,2498919,649396,147379,21222,1511310,1547141,122492,101270,7124708,2012
3,"Alleghany + Covington, VA*",496216,27769,56890,52794,424957,-2172,-2607,54166,766235,23056,34919,764063,-17093,119784,219322,21881,1463,20449,83287,9957,8494,392480,2012
4,"Amelia, VA",163259,8637,14592,13444,288481,22276,17603,15359,434426,35975,35845,456702,140581,65995,102226,12741,1642,53578,21314,4255,2613,88367,2012
5,"Amherst, VA",466205,26648,62966,49788,594634,-812,-1783,51542,1021395,42913,31268,1020583,179971,165632,260317,32640,2850,41130,87860,12588,9738,337215,2012
6,"Appomattox, VA",145833,9916,19185,14856,281679,83,-1000,17344,484514,20456,31798,484597,153190,74054,128864,15240,1688,19456,26613,5079,3391,99764,2012
7,"Arlington, VA",20468349,830188,2259658,2224418,14231522,0,0,1942397,18580002,1948098,83839,18580002,-4294430,3563474,785006,221614,28965,1948098,3371867,212248,183283,15148384,2012
8,"Augusta, Staunton + Waynesboro, VA*",2589996,133874,303911,269600,2674449,33708,24351,268674,4371303,319415,37182,4405011,353127,813023,917539,118472,13232,343766,438711,61959,48727,1807519,2012
9,"Bath, VA",120612,6317,12631,11940,104143,41,-589,12287,230329,20845,49627,230370,-4182,81789,44438,4642,628,20256,18601,3012,2384,81755,2012
10,"Bedford, VA*",1033559,61273,109436,107844,1853787,-2085,-4380,115195,2978842,174373,39295,2976757,935423,543111,579859,75755,9466,169993,163358,29755,20289,700208,2012
11,"Bland, VA",114941,6373,18443,12132,114733,-47,-500,12439,203608,10384,30414,203561,12231,31530,57298,6693,800,9884,24509,2874,2074,80548,2012
12,"Botetourt, VA",552442,30492,61127,59188,925547,525,-1152,60086,1419429,79902,42872,1419954,433191,249702,244705,33121,3984,78750,90721,13837,9853,382971,2012
13,"Brunswick, VA",197539,11811,27375,21478,239258,7837,5466,22550,463176,13137,27669,471013,64269,72336,159419,17023,1231,18603,38114,5768,4537,140822,2012
14,"Buchanan, VA",544748,31165,64893,60684,398844,-99,-167,61507,766494,33909,32154,766395,-84397,96531,271020,23835,1242,33742,95235,10191,8949,415771,2012
15,"Buckingham, VA",191638,10899,25361,18670,246671,7110,5674,20234,424552,24626,25286,431662,75267,65106,119885,17071,1344,30300,34696,4886,3542,126642,2012
16,"Campbell + Lynchburg, VA*",3906492,187373,425190,441784,2487109,2468,-86,408265,4488340,275199,33978,4490808,-1011118,790883,1212816,132169,12061,275113,646082,84807,72746,2985297,2012
17,"Caroline, VA",305835,17303,42935,32212,674912,2426,23,33409,1045007,37376,36181,1047433,402486,172854,199667,28950,2658,37399,59041,8528,5870,209395,2012
18,"Carroll + Galax, VA*",551590,33056,68002,60240,556384,3924,1274,63176,1082507,69642,29547,1086431,67970,155931,374116,36770,3463,70916,98122,16369,12906,382552,2012
19,"Charles City, VA",100342,5620,10768,10550,158982,5803,4254,10895,259750,12010,37281,265553,69535,50624,55947,7123,520,16264,16043,2260,1740,68035,2012
20,"Charlotte, VA",139376,9081,18888,13296,177734,4523,2260,15729,351113,23594,28680,355636,54087,61775,116127,12400,1901,25854,25536,4900,2999,87986,2012
21,"Chesapeake (Independent City), VA",5472022,253173,605181,624282,6989519,7582,1955,565314,10059301,414931,44127,10066883,2082811,1693668,1383696,228134,20633,416886,917322,122642,102009,4137814,2012
22,"Chesterfield, VA",7650014,358589,834263,841862,10411153,1500,340,779520,14913476,656699,46042,14914976,3540659,2624635,1879188,323942,36786,657039,1255194,163408,126622,5737781,2012
23,"Clarke, VA",276303,13570,23671,25790,499676,12824,7829,26465,748897,61491,53435,761721,249838,174358,87687,14255,2691,69320,36566,6797,4106,170417,2012
24,"Craig, VA",37705,2939,4658,3410,97988,-599,-1251,4644,169667,9684,32899,169068,64927,29173,41907,5139,639,8433,6363,1357,718,22909,2012
25,"Culpeper, VA",946261,46007,101981,94072,1299315,7195,173,93043,1929944,169812,40484,1937139,446097,338980,298844,47850,6454,169985,149017,22484,16030,627259,2012
26,"Cumberland, VA",74649,4976,8827,6290,175247,8778,7431,8121,291937,13825,30545,300715,108719,44164,81304,9845,764,21256,11972,2166,1402,41421,2012
27,"Dickenson, VA",220684,14576,28113,23042,214696,-1884,-1961,26097,444110,19712,28153,442226,20109,52792,174738,15708,810,17751,39634,4889,4079,163299,2012
28,"Dinwiddie, Colonial Heights + Petersburg, VA*",1609811,81850,204541,180888,1531570,10923,9521,172294,2781639,97906,35983,2792562,94053,432468,828524,77607,7188,107427,294985,40585,33397,1207399,2012
29,"Essex, VA",184458,10183,21280,19320,219073,3983,2914,19843,392824,22580,35642,396807,54458,76402,101332,11133,1259,25494,30940,5419,4160,128024,2012
30,"Fairfax, Fairfax City + Falls Church, VA*",70057433,3046240,5851180,7291444,60490068,3271,774,6691962,83945004,6591018,72577,83948275,-2875403,18464677,4993530,1156684,167852,6591792,9496902,858111,690259,53968739,2012
31,"Fauquier, VA",1563210,73857,147281,150618,2702560,-406,-15277,149166,4118301,326816,61861,4117895,1288516,1051827,363508,66567,10384,311539,222590,33708,23324,1029081,2012
32,"Floyd, VA",153668,10004,17105,13922,293459,3526,-828,16965,495421,39477,32319,498947,156756,85242,120246,15438,2523,38649,24066,5732,3209,90953,2012
33,"Fluvanna, VA",258410,15785,31086,24042,604795,283,-417,27806,960940,53378,37129,961223,374191,191902,164526,25889,2877,52961,43107,7406,4529,162342,2012
34,"Franklin, VA",719991,43174,75833,73034,1092275,18268,12386,79691,1934137,130002,34683,1952405,451975,401303,458827,56293,6961,142388,112350,21482,14521,465253,2012
35,"Frederick + Winchester, VA*",3118424,143854,340810,341060,3103270,11124,6072,314384,4544216,339001,42470,4555340,299230,808934,643136,107259,13014,345073,511340,66467,53453,2262011,2012
36,"Giles, VA",289825,16670,37261,31146,334144,-725,-1350,32243,573761,32125,33660,573036,76562,84635,154257,17024,1706,30775,52834,7005,5299,206216,2012
37,"Gloucester, VA",464691,26376,55488,45354,1002252,2270,1480,49053,1574786,76040,42798,1577056,586614,307498,267306,36849,3761,77520,78165,13870,10109,309006,2012
38,"Goochland, VA",1197766,54797,99230,124158,1039414,2011,1,116876,1758981,66819,82143,1760992,-41476,556129,165449,21438,3457,66820,161309,16318,12861,969637,2012
39,"Grayson, VA",114520,9754,15408,11140,209074,1631,-418,15324,419690,22261,27817,421321,109878,65628,146619,15146,1979,21843,20978,4563,2584,71699,2012
40,"Greene, VA",216760,12183,20615,21012,462292,1086,-70,22689,691381,47594,36773,692467,268221,115535,114640,18831,1938,47524,31121,5760,3822,138115,2012
41,"Greensville + Emporia, VA*",348315,17426,49629,40400,249169,8055,6898,37626,459357,10318,26615,467412,-61520,63986,154257,17562,1095,17216,69829,9464,8369,261270,2012
42,"Halifax, VA",595828,34053,80967,66092,555503,8477,4210,67099,1072445,47662,30244,1080922,26774,189355,336064,35740,3332,51872,114013,16241,12909,429943,2012
43,"Hampton (Independent City), VA",4176014,177867,654348,513412,3087448,0,0,434573,5066199,171370,36920,5066199,-653993,897842,1080909,137222,9832,171370,911054,76460,66628,3093590,2012
44,"Hanover, VA",2651843,125416,263340,291338,3438457,14045,5301,271085,4891504,299629,48889,4905549,1057699,870234,596858,100340,13222,304930,409009,62307,49085,1937904,2012
45,"Henrico, VA",13911021,619299,1177718,1393542,11716757,2030,679,1316070,16635182,2357234,52720,16637212,-878194,3027518,1892937,315575,40172,2357913,1874489,230116,189944,9678619,2012
46,"Henry + Martinsville, VA*",1157979,68527,142599,133318,1072992,6014,5111,135186,2143584,104444,32268,2149598,50199,368364,708242,66616,5767,109555,209258,31880,26113,839166,2012
47,"Highland, VA",31691,1809,3638,2396,33764,6457,5649,3007,76774,4739,37256,83231,5080,28590,20877,2234,698,10388,4836,1308,610,16467,2012
48,"Isle of Wight, VA",602845,31774,63502,60826,1178772,9880,7832,62187,1702474,69782,48437,1712354,638114,268192,265390,35352,3534,77614,93915,14150,10616,431316,2012
49,"James City + Williamsburg, VA*",2264353,111153,251238,235032,2791609,-46,-771,228669,4735988,313328,56394,4735942,755925,1291448,652885,83979,10895,312557,368754,54533,43638,1583042,2012
50,"King George, VA",1107813,44942,178061,127164,795509,494,-58,108524,1153076,81356,46865,1153570,-203780,233295,124766,24615,2359,81298,241643,13562,11203,784872,2012
51,"King William, VA",211991,11580,22542,21834,426198,2510,1749,22497,632244,29452,39729,634754,236704,102056,106500,15977,1729,31201,33459,5403,3674,147331,2012
52,"King and Queen, VA",72095,4488,7679,6518,148746,3917,2701,7747,239311,15333,34707,243228,84398,38706,55776,7008,730,18034,10938,1873,1143,43123,2012
53,"Lancaster, VA",243699,14634,25901,24858,202978,12,-459,27063,537004,36605,48271,537016,-13658,203506,130532,11125,1958,36146,38330,7002,5044,169223,2012
54,"Lee, VA",263929,17875,39748,27840,334099,-2459,-3553,31795,674349,31083,26418,671890,101965,89398,248393,25433,2366,27530,53668,7908,5542,182731,2012
55,"Loudoun, VA",11783364,509942,1092733,1252710,18880461,-326,-15088,1136297,23428626,1052735,69335,23428300,8233394,3528008,1019831,337902,44494,1037647,1719088,195925,151431,9026629,2012
56,"Louisa, VA",592528,30646,72297,60538,761253,324,-1433,60915,1213566,73305,36391,1213890,229640,217338,235299,33357,3705,71872,102566,12568,8863,418090,2012
57,"Lunenburg, VA",128184,8285,17187,13906,170431,1973,-412,15238,343414,13010,27327,345387,57485,68999,105957,12639,991,12598,24140,3772,2781,91446,2012
58,"Madison, VA",201722,11032,17696,15878,340271,2487,-944,18971,543428,73265,41562,545915,157520,114164,91480,13135,2050,72321,25635,5307,3257,103766,2012
59,"Mathews, VA",89328,6572,8265,6738,215768,320,265,9941,425275,32193,47761,425595,136381,125257,84570,8911,1339,32458,11634,2953,1614,45236,2012
60,"Mecklenburg, VA",543727,31412,70361,61374,491094,8508,2430,62099,986969,43135,31405,995477,9466,190855,313528,31698,2973,45565,101048,15725,12752,397114,2012
61,"Middlesex, VA",183792,11004,20720,15578,216118,2332,980,18793,457776,47534,42402,460108,51119,132418,111572,10851,1795,48514,28509,5279,3484,106769,2012
62,"Montgomery + Radford, VA*",2639259,118483,393740,290530,2054349,4995,1383,263748,3349944,121248,29843,3354939,-321162,724118,576472,112418,10474,122631,539005,60766,50292,1977623,2012
63,"Nelson, VA",208367,12557,21628,17544,338133,4748,1362,21329,617365,57300,42029,622113,151095,148439,135541,14802,2709,58662,30400,6539,3830,119305,2012
64,"New Kent, VA",224070,12487,23920,21778,890540,1363,1105,23376,1166244,45896,60978,1167607,689846,158575,118492,19148,2724,47001,34809,6748,4024,142260,2012
65,"Newport News (Independent City), VA",7111851,295111,1031341,819202,4302405,0,0,704712,6718946,432695,37297,6718946,-2104734,1127669,1288872,180148,14051,432695,1440942,119956,105905,5238214,2012
66,"Norfolk (Independent City), VA",13325695,496707,2184906,1715038,5015645,0,0,1354226,8722547,437992,35422,8722547,-6955824,2021468,1685434,246247,19554,437992,3042425,207067,187513,9845278,2012
67,"Northampton, VA",259852,12475,26783,24318,242241,43459,29433,24634,440618,31722,39649,484077,7023,111531,130305,12209,1721,61155,38942,6522,4801,159755,2012
68,"Northumberland, VA",141467,10753,15718,13750,197666,2431,1405,17628,518635,27653,41950,521066,73827,186444,136956,12421,1682,29058,22593,4399,2717,89816,2012
69,"Nottoway, VA",284448,15202,47872,34258,217380,3755,1204,32331,456914,10965,29234,460669,-34737,87604,155685,15758,1479,12169,65001,7540,6061,207278,2012
70,"Orange, VA",485768,27735,54661,47104,851691,9140,-3006,51287,1437327,89064,42217,1446467,417210,319623,275153,34263,4320,86058,78213,13455,9135,321497,2012
71,"Page, VA",290296,17336,32792,30102,431223,20274,17019,32387,741313,47761,31944,761587,173314,134063,196301,23841,2654,64780,47843,8659,6005,177673,2012
72,"Patrick, VA",226867,14674,29082,23660,264002,3421,1324,26504,512155,36306,28114,515576,63639,80142,171432,18339,2254,37630,40912,7660,5406,148325,2012
73,"Pittsylvania + Danville, VA*",1843721,103334,226542,211868,1721579,24039,14732,209268,3200858,129561,30532,3224897,87126,490804,1012514,105625,9223,144293,332476,50050,40827,1366952,2012
74,"Portsmouth (Independent City), VA",3602306,147396,657345,443904,2005218,0,0,369348,3394242,103927,35168,3394242,-1227740,548345,840679,96516,7087,103927,879297,58573,51486,2619082,2012
75,"Powhatan, VA",404257,21167,48535,39662,854737,1067,172,40998,1241248,65340,44076,1242315,491478,223681,163897,28186,3286,65512,68366,10599,7313,270379,2012
76,"Prince Edward, VA",428807,21644,57030,46870,322332,3918,2776,45079,596548,38496,25897,600466,-61396,107950,170184,23187,2191,41272,80465,11789,9598,307070,2012
77,"Prince George + Hopewell, VA*",2414898,90097,454788,310964,1194355,939,444,245579,2000510,66179,33660,2001449,-974964,382128,424966,59461,3459,66623,610270,34979,31520,1738005,2012
78,"Prince William, Manassas + Manassas Park, VA*",10539797,455627,1170108,1143644,18167973,2810,-293,1027449,23720437,1358281,48873,23723247,8655625,3573602,1981672,485404,52760,1357988,1741930,208607,155847,7439879,2012
79,"Pulaski, VA",670264,36234,84557,78618,670759,3623,1944,75543,1164017,59972,33617,1167640,76038,176096,320785,34734,2693,61916,123866,16290,13597,484482,2012
80,"Rappahannock, VA",131534,7275,10443,8972,229454,327,-1809,11761,405990,46736,54804,406317,109681,123764,53099,7414,1680,44927,14929,3380,1700,71678,2012
81,"Richmond (Independent City), VA",11899012,509724,1336437,1225186,5783693,0,0,1122317,10236240,1289606,48531,10236240,-4993002,2764828,1687719,210922,21712,1289606,1949030,180453,158741,8660376,2012
82,"Richmond, VA",149007,7738,21105,15240,142594,4896,2230,15358,265342,12083,29775,270238,8945,57420,70224,9076,925,14313,28725,3917,2992,105969,2012
83,"Roanoke (Independent City), VA",4117480,190440,457186,494300,2103427,0,0,437590,3786396,326453,38623,3786396,-1576463,769742,913227,98034,9039,326453,704336,80666,71627,3086691,2012
84,"Roanoke + Salem, VA*",3838475,183021,432436,411388,3478106,910,-15,388715,5374027,456171,45565,5374937,28346,1002493,894338,117961,13012,456156,638130,76290,63278,2744189,2012
85,"Rockbridge, Buena Vista + Lexington, VA*",685227,36870,81932,75906,646313,-223,-2658,74823,1228543,95405,33967,1228320,35909,294996,287011,36162,4682,92747,119885,18981,14299,472595,2012
86,"Rockingham + Harrisonburg, VA*",3405798,153005,395822,352312,2703794,110490,87614,329161,4118789,354911,32917,4229279,-372843,793967,731518,128485,15568,442525,571978,79301,63733,2391295,2012
87,"Russell, VA",397302,25321,49054,44526,462138,-1852,-4050,47584,853632,46574,29962,851780,112420,109987,279655,28429,2512,42524,71317,10213,7701,283461,2012
88,"Scott, VA",228103,17072,29625,25170,338303,-3508,-4284,29657,660467,27652,28618,656959,139857,94140,224516,22956,2730,23368,42210,7960,5230,162525,2012
89,"Shenandoah, VA",710410,38180,78585,70542,926344,22249,17978,73451,1518647,115816,36229,1540896,289385,292996,321556,42532,5710,133794,113856,19804,14094,462760,2012
90,"Smyth, VA",589807,33154,80407,65692,532947,2336,226,66000,975835,60938,30653,978171,9140,141777,303447,31911,3214,61164,113253,15495,12281,415390,2012
91,"Southampton + Franklin, VA*",426953,22204,56172,44098,523425,24678,19767,44253,915559,32742,34831,940237,140725,177245,239567,26994,2499,52509,78221,11290,8791,296223,2012
92,"Spotsylvania + Fredericksburg, VA*",3179602,149271,332487,343348,4678271,2555,838,320945,6795798,329423,44417,6798353,1819614,1256150,863932,153057,14797,330261,504161,74568,59771,2345180,2012
93,"Stafford, VA",2991538,127949,404128,333718,4847358,-3295,-3824,294808,6624168,270734,49614,6620873,2150628,1144119,629396,133449,12220,266910,570987,55593,43373,2153641,2012
94,"Suffolk (Independent City), VA",1795570,86067,194834,194186,2543032,19875,7542,183160,3884419,190336,45761,3904294,930622,737918,623344,85320,8432,197878,291927,37098,28666,1305765,2012
95,"Surry, VA",233593,10433,35157,23882,151336,6527,5583,22374,234832,6076,35266,241359,-59883,36519,53504,6844,553,11659,47098,2937,2384,174836,2012
96,"Sussex, VA",195798,9824,26815,20482,183274,11800,10156,20065,311247,8751,27085,323047,7541,45837,93936,11927,778,18907,37056,4627,3849,139835,2012
97,"Tazewell, VA",813170,46053,103632,87598,807156,1274,53,89852,1492570,79500,33739,1493844,83838,246378,440310,44276,3756,79553,147431,21227,17471,586186,2012
98,Virginia,283275330,12672802,31077087,30649784,272126011,638401,325155,27997694,403541342,28366026,49366,404179743,16848375,80147376,51906356,8187456,930360,28691181,46401979,4856886,3926526,208182170,2012
99,"Virginia Beach (Independent City), VA",11621397,505528,1492137,1340640,13955085,2169,262,1175848,21508200,934154,48317,21510369,3509536,4837877,2717407,445189,48532,934416,2162457,244114,195582,8524524,2012
100,"Warren, VA",658948,33455,72760,70744,1041722,-1020,-1952,68827,1519970,93640,40080,1518950,451601,233137,244091,37898,4255,91688,108132,16879,12624,459128,2012
101,"Washington + Bristol, VA*",1936897,98429,207117,187846,1609791,-1031,-4926,192352,2894002,382140,39730,2892971,-134754,626521,656659,72816,8361,377214,301040,42303,33942,1258643,2012
102,"Westmoreland, VA",173156,11453,20349,16850,322526,10522,4513,19878,630759,27688,36613,641281,169248,162369,156386,17515,2035,32201,28774,5836,3801,112181,2012
103,"Wise + Norton, VA*",978545,52418,127838,111594,716661,2005,1896,108215,1370132,50971,30456,1372137,-153669,179871,475605,45053,2881,52867,183635,22342,19461,742043,2012
104,"Wythe, VA",537564,29553,72280,60188,473410,1954,-1249,59647,876466,49941,29949,878420,-4507,140552,264458,29331,3425,48692,102374,15646,12221,386498,2012
105,"York + Poquoson, VA*",1306137,63616,165104,146478,2679666,159,-814,136855,4007580,140547,51390,4007739,1510384,869543,458530,77987,6526,139733,238343,32245,25719,928061,2012
0,"Accomack, VA",707994,44437,97646,71912,630542,45312,38226,80393,1145692,64174,36111,1191004,2941,244894,315568,32982,3867,102400,133602,17687,13820,471992,2013
1,"Albemarle + Charlottesville, VA*",6476387,366903,841531,655168,4715302,734,-11880,694487,8316889,739477,56436,8317623,-1066598,2740868,861453,147381,24004,727597,1169115,117647,93643,4579675,2013
2,"Alexandria (Independent City), VA",9823818,548705,1059882,1086108,8391356,0,0,1091759,11516425,1053891,76896,11516425,-340703,2459903,665166,149767,21792,1053891,1602936,122829,101037,7166991,2013
3,"Alleghany + Covington, VA*",456430,32600,60714,52834,376669,-1976,-2417,59017,717666,27121,32893,715690,-20744,113249,225772,21758,1452,24704,87131,9880,8428,344595,2013
4,"Amelia, VA",174758,11080,15729,13230,314842,27069,22385,17695,459027,37601,38411,486096,157779,65257,105997,12655,1720,59986,22344,4298,2578,92428,2013
5,"Amherst, VA",471255,33608,69100,49788,591358,-1538,-2513,58502,1016888,41429,31405,1015350,178605,159749,264243,32331,2846,38916,93994,12533,9687,338345,2013
6,"Appomattox, VA",149269,12345,21346,14838,289294,-1150,-2232,19764,499754,21492,32557,498604,159789,74704,134606,15315,1727,19260,28765,5125,3398,101244,2013
7,"Arlington, VA",19730438,1084206,2311502,2227652,13448872,0,0,2198032,17865923,1202620,79362,17865923,-4083534,3604181,812870,225120,30191,1202620,3425328,212978,182787,15102490,2013
8,"Augusta, Staunton + Waynesboro, VA*",2666746,173096,338483,278004,2709531,49845,40146,312098,4419426,291267,37517,4469271,354883,811047,948693,119126,13316,331413,477485,62619,49303,1857848,2013
9,"Bath, VA",118918,8066,14463,12898,100770,462,-170,14515,214320,8940,46783,214782,-3633,69624,44388,4591,657,8770,20912,3079,2422,89236,2013
10,"Bedford, VA*",1035483,76749,119688,109094,1861277,-3505,-5900,131296,3018126,157525,39568,3014621,957090,552606,600738,76189,9537,151625,174235,29648,20111,709623,2013
11,"Bland, VA",117357,8033,20425,12304,113955,135,-319,14185,203241,9913,30473,203376,10783,31029,58392,6674,843,9594,26577,2877,2034,81186,2013
12,"Botetourt, VA",562198,39268,67559,60674,937823,-418,-2095,69605,1434093,70181,43451,1433675,445230,241354,254498,32995,4072,68086,97896,14407,10335,396216,2013
13,"Brunswick, VA",209901,15409,29920,22234,239065,6832,4456,26526,464683,14998,27775,471515,55690,69063,163387,16976,1281,19454,41037,5926,4645,149410,2013
14,"Buchanan, VA",503632,36630,65597,55616,370109,-185,-257,64438,740973,31576,31339,740788,-69085,92250,278429,23638,1202,31319,93405,9433,8231,378908,2013
15,"Buckingham, VA",191471,13617,28298,18498,243531,6245,4809,22866,428224,22798,25328,434469,74926,64786,126152,17154,1324,27607,37547,4849,3525,126317,2013
16,"Campbell + Lynchburg, VA*",3982085,247794,464820,455414,2469855,2673,47,475501,4434259,232455,33333,4436932,-1036729,708368,1258709,133108,12318,232502,692527,85483,73165,3057056,2013
17,"Caroline, VA",324351,22612,48282,34096,692087,3282,873,39660,1074855,37596,36856,1078137,407396,182287,203763,29253,2632,38469,65330,8792,6160,220552,2013
18,"Carroll + Galax, VA*",551808,40886,74974,59594,549097,3954,1220,70683,1076022,63293,29314,1079976,67972,150538,380341,36842,3427,64513,104771,16244,12817,382524,2013
19,"Charles City, VA",106694,7123,11943,10296,168044,9496,7941,12271,265186,14230,38863,274682,73621,49673,56965,7068,531,22171,17091,2294,1763,67432,2013
20,"Charlotte, VA",149393,11476,21547,13774,185294,4581,2315,18363,359012,25316,29606,363593,54264,59982,118317,12281,1925,27631,28434,5004,3079,93328,2013
21,"Chesapeake (Independent City), VA",5516147,333560,663068,635100,6946380,9468,3831,651110,10113904,349684,43935,10123372,2081343,1724975,1452017,230415,21243,353515,980618,123596,102353,4182014,2013
22,"Chesterfield, VA",7966160,485918,927957,881318,10577950,1395,234,926577,15124472,648725,46155,15125867,3538367,2558173,1989744,327721,37645,648959,1368616,168986,131341,5948585,2013
23,"Clarke, VA",278610,17533,26166,27002,495984,11050,6048,31034,752445,53422,53526,763495,248408,176878,90633,14264,2939,59470,39667,7079,4140,179473,2013
24,"Craig, VA",40113,3649,5297,3760,98529,-677,-1333,5529,172233,9015,33390,171556,63945,29112,43915,5138,657,7682,7177,1397,740,25254,2013
25,"Culpeper, VA",969286,60191,116455,98488,1290504,7274,235,109435,1928746,150128,39828,1936020,430653,332174,313342,48609,6644,150363,165699,23155,16511,653224,2013
26,"Cumberland, VA",79225,6148,9777,6326,180560,9824,8472,9311,297765,15722,31221,307589,110646,43427,83602,9852,817,24194,12940,2254,1437,42091,2013
27,"Dickenson, VA",225046,18053,31040,23356,208541,-1321,-1400,29731,441240,18235,28333,439919,13226,53210,178168,15527,790,16835,42718,4958,4168,165493,2013
28,"Dinwiddie, Colonial Heights + Petersburg, VA*",1624281,105335,224322,182872,1517906,6937,5474,196771,2793404,94668,35953,2800341,90396,432045,850390,77890,7374,100142,315758,40780,33406,1208381,2013
29,"Essex, VA",192269,13320,24059,20180,220974,1919,849,23410,398960,22872,35927,400879,52115,75073,104832,11158,1334,23721,34149,5472,4138,134399,2013
30,"Fairfax, Fairfax City + Falls Church, VA*",69860442,4073500,6228976,7426694,59162782,7243,4692,7786847,82189871,5996114,70324,82197114,-2910813,17832077,5202255,1168830,170743,6000806,9942323,857784,687041,53917313,2013
31,"Fauquier, VA",1500801,92054,158728,150260,2664171,3162,-11741,167184,4003948,261316,59674,4007110,1330554,963095,379844,67150,10777,249575,233858,33981,23204,1017368,2013
32,"Floyd, VA",153168,12236,18595,14174,291008,3139,-1228,19323,494366,35383,32112,497505,157163,81679,124818,15493,2526,34155,25682,5745,3219,93331,2013
33,"Fluvanna, VA",266038,20029,34341,25106,610922,-448,-1147,32582,979490,51612,37899,979042,377466,195910,172210,25833,2910,50465,46894,7491,4581,168679,2013
34,"Franklin, VA",740306,54644,87726,75546,1085336,15308,9410,92417,1924055,119905,34464,1939363,437447,378698,475329,56272,6884,129315,125499,22244,15360,485492,2013
35,"Frederick + Winchester, VA*",3220002,194213,378577,355730,3091643,-96,-5355,372078,4568821,314592,41983,4568725,243719,802174,674908,108822,13174,309237,556442,68031,54857,2354323,2013
36,"Giles, VA",282695,20395,39754,29872,335442,-738,-1366,35331,578377,28990,33995,577639,88078,83866,158331,16992,1719,27624,54690,6883,5164,200381,2013
37,"Gloucester, VA",469230,33207,62945,46612,983311,3435,2643,56513,1550970,63658,42262,1554405,570594,289799,281295,36780,3775,66301,86251,13915,10140,316678,2013
38,"Goochland, VA",1343668,81263,117367,139696,1018161,2457,437,151111,1710095,58287,78803,1712552,-174396,510104,184287,21732,3550,58724,187215,17429,13879,1097729,2013
39,"Grayson, VA",115587,11680,18246,11482,206914,-1128,-3183,17421,418189,20408,27563,417061,108748,60831,149316,15131,2007,17225,23987,4628,2621,74375,2013
40,"Greene, VA",202994,14548,22018,18782,462170,766,-399,23939,699210,46146,37087,699976,283115,119474,118332,18874,2043,45747,31409,5733,3690,125838,2013
41,"Greensville + Emporia, VA*",352029,22383,55001,40204,244385,6847,5655,42485,463607,9256,27058,470454,-65159,63699,162370,17387,1187,14911,75103,9313,8126,262015,2013
42,"Halifax, VA",620975,43767,89777,68760,559395,6066,1791,78147,1066292,46858,30302,1072358,16567,168120,344843,35389,3311,48649,124157,16253,12942,448169,2013
43,"Hampton (Independent City), VA",4152020,232097,673421,510542,3058958,0,0,487368,5093399,147691,37068,5093399,-605694,908574,1125867,137406,10323,147691,928692,76166,65843,3075637,2013
44,"Hanover, VA",2765209,169122,293367,304812,3499812,16093,7329,321528,4968507,305071,49316,4984600,1056131,860151,624637,101075,13491,312400,445773,64292,50801,2007036,2013
45,"Henrico, VA",14694999,853392,1298061,1447366,12176961,2538,1184,1577075,17021628,2761573,53427,17024166,-940963,2871678,1975527,318646,40717,2762757,2021744,231935,191218,9910498,2013
46,"Henry + Martinsville, VA*",1166786,85529,156066,132868,1070436,6896,5973,151963,2125977,95166,32228,2132873,55613,344580,717857,66181,5733,101139,222500,32263,26530,843147,2013
47,"Highland, VA",30755,2121,3966,2438,31780,6492,5683,3340,75665,3179,37259,82157,4365,29139,21238,2205,710,8862,5185,1323,613,16708,2013
48,"Isle of Wight, VA",691691,45786,75421,66166,1185295,9383,7328,78869,1720810,65045,48680,1730193,572473,267602,277296,35542,3564,72373,108504,14778,11214,510814,2013
49,"James City + Williamsburg, VA*",2275804,144056,274237,238988,2810724,-650,-1415,263550,4809064,266853,56378,4808414,798470,1309876,687814,85289,11240,265438,393731,54717,43477,1616635,2013
50,"King George, VA",1168678,63050,189901,132754,817555,-109,-659,129427,1188231,101356,47699,1188122,-221696,237667,132900,24909,2368,100697,256278,13956,11588,811703,2013
51,"King William, VA",223194,15261,24937,22772,434094,1922,1163,26647,643063,32810,40071,644985,237547,99961,110930,16096,1729,33973,36323,5447,3718,152898,2013
52,"King and Queen, VA",72549,5540,8270,6586,152754,4193,2974,8833,245999,13977,35594,250192,89038,39185,58253,7029,741,16951,11563,1874,1133,44035,2013
53,"Lancaster, VA",240780,17997,27979,25116,197768,1023,550,30555,526463,28731,48128,527486,-12457,197059,132659,10960,2021,29281,40537,6988,4967,170962,2013
54,"Lee, VA",254381,21129,41572,26836,313125,-117,-1214,34547,657178,26362,26184,657061,93291,86853,257083,25094,2379,25148,54990,7587,5208,174243,2013
55,"Loudoun, VA",12512992,723419,1217662,1330476,19215955,4306,-10482,1388657,23732779,1105946,67820,23737085,8091620,3440843,1080287,350001,46683,1095464,1882900,203895,157212,9534628,2013
56,"Louisa, VA",606325,39931,80561,61760,753406,167,-1597,70811,1228783,69630,36306,1228950,217892,225315,250229,33850,3748,68033,111441,12790,9042,426851,2013
57,"Lunenburg, VA",129405,10165,18980,13974,168960,1710,-683,17152,341466,12582,27380,343176,56707,63639,110577,12534,1032,11899,25967,3809,2777,91539,2013
58,"Madison, VA",215261,14487,19844,16688,348426,2500,-941,22831,558326,79906,42834,560826,155996,110948,101452,13093,2055,78965,28188,5398,3343,108108,2013
59,"Mathews, VA",86503,7655,9200,6616,213553,614,560,10963,415896,28561,46804,416510,138013,114187,88770,8899,1378,29121,12508,2951,1573,44874,2013
60,"Mecklenburg, VA",528469,38571,72015,59390,478955,6850,759,68266,980603,41616,31600,987453,18752,180652,327846,31249,3123,42375,101710,15201,12078,384384,2013
61,"Middlesex, VA",183338,13505,23764,16322,208189,3248,1894,21666,443063,37137,41398,446311,46517,123481,114641,10781,1821,39031,31925,5311,3490,112382,2013
62,"Montgomery + Radford, VA*",2754706,159133,448108,296010,2121530,5317,1612,307138,3415452,140565,30064,3420769,-326038,705336,593903,113782,10654,142177,596113,61876,51222,2016416,2013
63,"Nelson, VA",211640,15710,24932,18350,340580,2866,-527,24885,634399,54051,43061,637265,153825,156587,140098,14799,2693,53524,34107,6716,4023,124009,2013
64,"New Kent, VA",223984,15702,27210,22156,941254,1521,1264,26780,1229160,41416,63060,1230681,744050,165301,124126,19516,2761,42680,38288,6882,4121,143016,2013
65,"Newport News (Independent City), VA",7391404,405800,1096144,849750,4313984,0,0,830675,6753508,435098,37232,6753508,-2246745,1110345,1329179,181388,14181,435098,1521019,122239,108058,5435287,2013
66,"Norfolk (Independent City), VA",13146346,660182,2188761,1673610,4892491,0,0,1496987,8627186,330646,35127,8627186,-6756868,1993851,1740844,245598,20012,330646,3025566,206771,186759,9790134,2013
67,"Northampton, VA",258589,15350,28881,24316,241292,44154,30096,27508,431120,27687,39511,475274,10211,102385,131597,12029,1806,57783,41039,6618,4812,159767,2013
68,"Northumberland, VA",146557,12979,16951,13808,205839,6273,5246,19883,509416,26963,41933,515689,79165,169448,140402,12298,1697,32209,23855,4321,2624,90493,2013
69,"Nottoway, VA",294926,19359,53385,33986,212282,7288,4731,36352,444300,11310,28870,451588,-46292,82003,157303,15642,1448,16041,70378,7558,6110,208507,2013
70,"Orange, VA",517877,36188,63596,50974,878703,12231,58,61675,1453922,80005,42366,1466153,422501,304160,283290,34607,4395,80063,89083,14153,9758,348731,2013
71,"Page, VA",293094,20981,35662,29434,427871,29185,25922,35698,730858,41394,32037,760043,170475,131728,200444,23724,2712,67316,50379,8644,5932,175399,2013
72,"Patrick, VA",226073,17950,31004,23284,261295,1490,-612,29592,510238,36394,28031,511728,64814,76371,174062,18256,2231,35782,42646,7446,5215,147645,2013
73,"Pittsylvania + Danville, VA*",1878405,131555,247026,212464,1741504,23837,14208,237787,3247474,140481,31092,3271311,100886,479659,1050148,105214,9419,154689,353258,50250,40831,1370458,2013
74,"Portsmouth (Independent City), VA",3661853,196606,685371,453784,1955723,0,0,423498,3381948,82723,35184,3381948,-1282632,555697,870528,96123,7152,82723,912263,59595,52443,2666867,2013
75,"Powhatan, VA",414959,27403,54848,40956,873735,1361,469,47881,1258700,63749,44502,1260061,506657,213313,173013,28315,3357,64218,75326,10835,7478,275415,2013
76,"Prince Edward, VA",435727,27938,63130,47222,316514,3495,2351,51549,593658,36320,26268,597153,-67664,104312,176327,22733,2171,38671,86741,11535,9364,310315,2013
77,"Prince George + Hopewell, VA*",2433377,120964,461366,310140,1198784,1436,928,276034,2017401,69247,33909,2018837,-958559,377113,442940,59537,3504,70175,616436,35647,32143,1746766,2013
78,"Prince William, Manassas + Manassas Park, VA*",10832480,614482,1286867,1175678,18031547,1811,-1457,1202321,23851672,1316788,48200,23853483,8401388,3727434,2094502,494882,54514,1315331,1874706,213801,159287,7642443,2013
79,"Pulaski, VA",689123,46792,92259,79656,664654,4476,2792,86620,1157137,53235,33620,1161613,62151,172935,324024,34551,2685,56027,132087,16305,13620,501009,2013
80,"Rappahannock, VA",130485,9097,11202,8988,225577,-853,-2995,13591,407200,45556,54668,406347,108683,125215,55555,7433,1729,42561,15696,3423,1694,72228,2013
81,"Richmond (Independent City), VA",11992122,675796,1481523,1249434,5801780,0,0,1300513,9776386,1165025,45680,9776386,-4889829,2240925,1733681,214020,22643,1165025,2106240,180763,158120,8720857,2013
82,"Richmond, VA",152674,9908,23882,15620,145952,3767,1094,17718,267456,11720,30311,271223,10996,57696,67575,8948,959,12814,31692,3978,3019,108168,2013
83,"Roanoke (Independent City), VA",4229568,255343,507910,508302,2084567,0,0,509494,3692069,284487,37337,3692069,-1635507,665228,942274,98884,8903,284487,762061,81124,72221,3183020,2013
84,"Roanoke + Salem, VA*",3778714,233990,459310,402616,3437112,91,-857,435298,5256440,410581,44290,5256531,93696,906415,913004,118684,13008,409724,660618,74982,61974,2708372,2013
85,"Rockbridge, Buena Vista + Lexington, VA*",691073,46761,89377,76110,642552,581,-1937,84816,1231369,89072,34076,1231950,36295,297928,291470,36153,4710,87135,127432,18900,14190,476506,2013
86,"Rockingham + Harrisonburg, VA*",3549793,202166,434233,357574,2810785,188094,164698,380953,4142983,341777,33572,4331077,-358055,781907,738385,129009,15833,506475,613020,79920,64087,2430298,2013
87,"Russell, VA",392236,30789,53052,44034,430891,2155,-48,52806,817882,34247,28939,820037,91461,106902,282244,28337,2630,34199,75069,10203,7573,282968,2013
88,"Scott, VA",222527,20178,31785,24128,327767,-3143,-3918,32242,651596,25108,28480,648453,137482,92388,228298,22769,2780,21190,43849,7858,5078,157488,2013
89,"Shenandoah, VA",725306,48448,86789,71868,943004,26852,22574,84382,1528978,108428,36596,1555830,302080,282507,330319,42514,5804,131002,122723,20089,14285,471581,2013
90,"Smyth, VA",623331,42721,88845,67118,555288,9033,6916,76280,984248,65121,31246,993281,8237,127917,310076,31789,3212,72037,122404,15526,12314,428890,2013
91,"Southampton + Franklin, VA*",418083,27747,61936,42236,525481,16426,11394,48865,924440,33673,35009,940866,156263,169160,246225,26875,2499,45067,83054,11128,8629,289962,2013
92,"Spotsylvania + Fredericksburg, VA*",3272348,199416,370971,351770,4694666,2613,841,375301,6833141,335471,44021,6835754,1797619,1229396,911692,155284,15490,336312,546856,75497,60007,2389180,2013
93,"Stafford, VA",3017401,171403,422306,338520,4850346,-2808,-3335,340663,6667360,240025,48992,6664552,2173608,1139814,674392,136034,12697,236690,591566,56846,44149,2189145,2013
94,"Suffolk (Independent City), VA",1838163,113417,220568,201910,2513606,19343,6982,214372,3836384,152801,44922,3855727,889815,698142,643979,85832,8456,159783,321523,37384,28928,1356857,2013
95,"Surry, VA",218726,12560,38819,22138,150800,6067,5122,23629,235459,6681,35560,241526,-44297,34897,55829,6792,574,11803,49888,2847,2273,157035,2013
96,"Sussex, VA",205404,12746,30338,21206,183872,13261,11610,23349,310617,10389,27529,323878,1817,44729,95277,11765,814,21999,40941,4721,3907,142464,2013
97,"Tazewell, VA",812276,57433,111649,86952,781141,4811,3588,100909,1451798,76093,33081,1456609,69774,224996,450472,44031,3758,79681,155125,20836,17078,577470,2013
98,Virginia,285869187,16801339,33313310,31169978,270094615,772951,456370,32386328,400911320,26066811,48654,401684271,16611756,77717740,53871916,8255861,950936,26523181,48898299,4898765,3947829,210447707,2013
99,"Virginia Beach (Independent City), VA",11749618,669260,1538032,1322862,13883889,4303,2390,1330691,21440977,1153055,47877,21445280,3464962,4716480,2844911,447922,49752,1155445,2199463,247262,197510,8394710,2013
100,"Warren, VA",730779,47074,84856,78846,1034765,-1596,-2527,86497,1519439,84397,39410,1517843,390483,229266,253812,38514,4240,81870,124279,17188,12948,524630,2013
101,"Washington + Bristol, VA*",1860766,120207,219986,181690,1540567,5864,1845,211052,2729004,348677,37873,2734868,-109147,532564,661737,72211,8395,350522,310831,41141,32746,1199413,2013
102,"Westmoreland, VA",168735,13572,22336,16998,314766,13484,7457,22071,626508,18284,36461,639992,168102,165454,159772,17553,2069,25741,30835,5822,3753,112159,2013
103,"Wise + Norton, VA*",881853,60911,132344,98600,654362,1064,941,110211,1305962,45557,29183,1307026,-117280,172653,480011,44788,2889,46498,181644,21014,18125,653711,2013
104,"Wythe, VA",542026,37185,78533,60172,458017,5149,1937,67271,849275,43473,29176,854424,-16738,126219,270188,29285,3418,45410,108619,15533,12115,387997,2013
105,"York + Poquoson, VA*",1325463,83055,174362,146892,2695133,863,-143,156501,4058756,142960,51954,4059619,1526171,889569,474917,78139,6713,142817,247808,32168,25455,934838,2013
0,"Accomack, VA",721844,45980,104395,74114,639478,31914,24210,83037,1196347,65931,37229,1228261,671,260195,328588,32992,3920,90141,141452,17737,13817,490251,2014
1,"Albemarle + Charlottesville, VA*",6780785,385447,883127,685758,4975377,-4514,-18255,728326,8871049,755942,59358,8866535,-1077082,2989173,901985,149373,24677,737687,1226006,120623,95946,4817092,2014
2,"Alexandria (Independent City), VA",10052670,560641,1101254,1110892,8749913,0,0,1116087,12085870,1015235,79752,12085870,-186670,2635845,700112,151544,22887,1015235,1656700,123962,101075,7380735,2014
3,"Alleghany + Covington, VA*",458083,32700,61325,51830,381626,-1812,-2296,58615,735145,28739,34282,733333,-17842,118327,233380,21391,1487,26443,87240,9789,8302,344400,2014
4,"Amelia, VA",180052,11739,16748,13562,321486,24081,19003,18520,475710,42013,39313,499791,159954,68595,109710,12713,1709,61016,23529,4323,2614,95507,2014
5,"Amherst, VA",476682,34197,70694,50370,609162,-1151,-2212,59382,1055704,39993,32777,1054553,191862,167023,278368,32174,2857,37781,95879,12477,9620,343022,2014
6,"Appomattox, VA",152555,12690,21762,14684,302735,-1147,-2349,20032,519831,23684,33806,518684,170212,76646,139303,15343,1675,21335,29104,5085,3410,102116,2014
7,"Arlington, VA",20043970,1105171,2333630,2249988,14076009,0,0,2230165,18839913,1176522,83262,18839913,-3737796,3907195,856709,226274,31419,1176522,3458624,213861,182442,15408824,2014
8,"Augusta, Staunton + Waynesboro, VA*",2787892,181445,350755,282936,2813123,61743,51194,322913,4608976,325773,39086,4670719,348144,858628,998968,119498,13567,376967,492223,63206,49639,1918702,2014
9,"Bath, VA",126162,8336,15603,13062,106377,932,241,14867,223770,10539,49537,224702,-4918,73783,44542,4536,657,10780,22134,3168,2511,93248,2014
10,"Bedford, VA*",1088224,80776,125754,112386,1918317,-4201,-6809,136969,3139322,166880,40687,3135121,967062,580549,636255,77054,9520,160071,181947,29963,20443,746206,2014
11,"Bland, VA",120557,8215,20886,12656,112312,1234,729,14543,202503,8933,30935,203737,6298,32134,59291,6586,801,9662,27214,2878,2077,83681,2014
12,"Botetourt, VA",581612,40979,71206,62452,958847,-905,-2722,72205,1490286,66596,45015,1489381,449440,259282,271252,33086,4135,63874,102432,14632,10497,415306,2014
13,"Brunswick, VA",206635,15417,30441,22238,239034,4725,2155,26536,474939,13300,28526,479664,58935,70671,169959,16815,1335,15455,41560,5833,4498,149620,2014
14,"Buchanan, VA",490209,36059,64486,53272,358489,-253,-330,62695,737348,30470,31817,737095,-69025,97494,281112,23167,1224,30140,91122,9095,7871,368947,2014
15,"Buckingham, VA",194277,14046,29393,19216,247791,5159,3592,23654,440885,20663,26337,446044,77168,66351,131902,16936,1359,24255,39001,4904,3545,131021,2014
16,"Campbell + Lynchburg, VA*",4097442,255045,483725,465264,2540905,3185,317,487677,4635635,209728,34740,4638820,-1068860,813281,1284634,133528,12783,210045,716357,86706,73923,3171040,2014
17,"Caroline, VA",323850,23184,49921,34514,712136,-2503,-5118,40441,1125188,36243,37741,1122685,428727,193746,216803,29747,2596,31125,67178,8702,6106,225547,2014
18,"Carroll + Galax, VA*",570359,41965,78166,60924,579208,5714,2751,72427,1133203,62949,31107,1138917,81276,161688,398021,36613,3425,65700,108628,16298,12873,396031,2014
19,"Charles City, VA",106483,7522,12722,10556,164409,4188,2494,12800,277262,14876,40351,281450,70726,56000,61041,6975,584,17370,18000,2439,1855,71113,2014
20,"Charlotte, VA",153547,11840,22649,14406,189192,3154,684,19043,363366,25667,30099,366520,54688,61956,115372,12177,1880,26351,29852,5026,3146,97344,2014
21,"Chesapeake (Independent City), VA",5594707,338951,683532,639338,7153748,4500,-1605,658620,10540978,330131,45167,10545478,2217661,1844303,1547427,233477,21762,328526,1003201,124495,102733,4262980,2014
22,"Chesterfield, VA",8200769,501718,958396,896070,10831357,176,-1092,949753,15687132,681225,47219,15687308,3580341,2721641,2134310,332221,38599,680133,1406431,172283,133684,6114205,2014
23,"Clarke, VA",273296,17579,27626,26916,494770,7040,1609,31037,778457,50869,54819,785497,252511,193912,96815,14329,2981,52478,41084,7233,4252,179734,2014
24,"Craig, VA",41346,3803,5618,3900,99792,-811,-1522,5753,175410,8766,33726,174599,64199,30566,44241,5177,666,7244,7568,1414,748,26534,2014
25,"Culpeper, VA",978577,61510,119423,99308,1319718,2401,-5238,111164,1998395,150890,40631,2000796,452305,357046,324032,49243,6807,145652,169077,23267,16460,663848,2014
26,"Cumberland, VA",82321,6359,10342,6534,187412,11028,9560,9626,311912,15161,32809,322940,114717,46243,89285,9843,855,24721,13609,2312,1457,43991,2014
27,"Dickenson, VA",218988,17833,30857,22696,202110,-1412,-1498,29181,442950,16613,28774,441538,12303,55973,183455,15345,791,15115,42205,4928,4137,161668,2014
28,"Dinwiddie, Colonial Heights + Petersburg, VA*",1651119,107677,225580,184654,1526523,2331,741,200004,2791907,91310,35925,2794238,75408,436140,831575,77780,7644,92051,317907,41098,33454,1241161,2014
29,"Essex, VA",187198,13552,24445,20592,219597,-5365,-6525,23848,411939,21775,36741,406574,56247,80437,106540,11066,1357,15250,34741,5551,4194,137207,2014
30,"Fairfax, Fairfax City + Falls Church, VA*",70876369,4125780,6331171,7431282,61034324,6697,3917,7841421,86168008,6616000,73429,86174705,-2000624,19635478,5504903,1173577,176894,6619917,10046812,860180,683286,54209640,2014
31,"Fauquier, VA",1560689,96308,166078,153426,2704206,138,-16030,173021,4123471,276313,60521,4123609,1316538,1004351,415052,68135,11017,260283,242791,34279,23262,1057615,2014
32,"Floyd, VA",156775,12796,19724,14614,297566,459,-4283,20103,517692,36141,33347,518151,160894,89987,130598,15538,2520,31858,27031,5815,3295,97886,2014
33,"Fluvanna, VA",270424,20709,36872,26364,612858,-1909,-2669,33891,1013275,43117,38929,1011366,376325,212477,186031,25980,3031,40448,50054,7794,4763,179922,2014
34,"Franklin, VA",781373,57277,94688,79532,1112554,18791,12377,97043,2001339,117998,35904,2020130,428224,408805,498771,56265,6969,130375,134454,22897,15928,516544,2014
35,"Frederick + Winchester, VA*",3389104,203462,411879,366060,3196807,-2397,-8105,386492,4771851,339395,43306,4769454,194195,849545,723102,110133,13483,331290,594909,70528,57045,2462905,2014
36,"Giles, VA",286331,20640,40930,30390,346600,-353,-1039,35835,598935,27092,35518,598582,96104,89411,162571,16853,1716,26053,56125,6781,5065,204153,2014
37,"Gloucester, VA",470383,33923,64590,47210,992831,1281,404,57528,1601707,59091,43280,1602988,579976,303616,306541,37038,3750,59495,88195,13846,10096,322693,2014
38,"Goochland, VA",1502153,90405,129626,156076,1074952,-542,-2735,168443,1819576,67830,82608,1819034,-258758,556722,187360,22020,3573,65095,207664,18555,14982,1229394,2014
39,"Grayson, VA",127769,12355,21340,12648,216939,-982,-3216,18679,438734,20200,27488,437752,107849,67454,153359,15925,1971,16984,27664,4757,2786,83121,2014
40,"Greene, VA",210137,15091,22852,18932,481738,1151,-113,24557,731673,49820,38306,732824,296158,120676,130410,19131,2068,49707,32318,5758,3690,128112,2014
41,"Greensville + Emporia, VA*",364838,23289,57591,41892,253985,3772,2481,44235,473026,7521,27763,476798,-66618,63306,159507,17174,1262,10002,78537,9376,8114,276299,2014
42,"Halifax, VA",629462,44545,91937,69342,568335,2179,-2474,79216,1105561,48289,31465,1107740,18089,173486,365919,35205,3429,45815,126608,16337,12908,457039,2014
43,"Hampton (Independent City), VA",4261092,238436,690632,516724,3138642,0,0,496798,5236703,141706,38008,5236703,-625652,938024,1160037,137778,10617,141706,948994,75378,64761,3170392,2014
44,"Hanover, VA",2982365,182187,311992,319952,3721801,7300,-2214,342163,5320138,371127,52363,5327438,1081599,930963,674674,101740,13721,368913,471968,65976,52255,2141484,2014
45,"Henrico, VA",15577599,904366,1337491,1468404,13021775,1415,-53,1638568,18277745,3256050,56792,18279160,-917256,3138572,2118813,321863,42306,3255997,2071693,234757,192451,10249909,2014
46,"Henry + Martinsville, VA*",1192030,87220,158947,132306,1100471,7653,6656,153373,2196207,99471,33607,2203860,61814,363370,740019,65578,5646,106127,225100,31883,26237,860803,2014
47,"Highland, VA",32459,2162,4284,2516,33709,7740,6857,3420,80915,2660,39613,88655,4670,32448,22498,2238,716,9517,5542,1349,633,17400,2014
48,"Isle of Wight, VA",646753,43462,78133,66798,1186021,3391,1157,76861,1748615,61230,48820,1752006,616129,274747,291238,35887,3708,62387,111532,15198,11490,472834,2014
49,"James City + Williamsburg, VA*",2332462,148723,283573,241830,2873382,-2746,-3577,269638,5018626,273776,57833,5015880,810558,1408824,733674,86731,11463,270199,404488,55080,43617,1657775,2014
50,"King George, VA",1220238,66385,197845,139174,842748,-1771,-2371,135972,1232378,99548,48671,1230607,-241518,245667,142192,25284,2412,97177,267432,14191,11779,855629,2014
51,"King William, VA",232119,16096,26677,24120,406155,-823,-1657,28156,631374,31038,39036,630551,202192,107492,116904,16153,1781,29381,38737,5578,3797,164001,2014
52,"King and Queen, VA",68518,5607,8578,6516,154097,720,-601,8865,255968,13223,36235,256688,94444,40915,61676,7084,773,12622,11836,1892,1119,44060,2014
53,"Lancaster, VA",241087,18263,28149,25062,198968,-210,-724,30794,539544,28071,49649,539334,-11325,212104,128262,10863,2077,27347,40680,7013,4936,173060,2014
54,"Lee, VA",237343,20365,40802,24812,299658,6,-1200,32771,651936,23349,26347,651942,95086,91439,260845,24744,2438,22149,53208,7377,4939,161986,2014
55,"Loudoun, VA",13064389,755859,1277196,1364368,20078799,-3815,-19891,1438043,25036907,1241514,69089,25033092,8452453,3760963,1193330,362330,49627,1221623,1959380,209683,160056,9883386,2014
56,"Louisa, VA",625812,41683,84981,64844,778929,-717,-2638,74105,1294422,58955,37858,1293705,227222,246515,268261,34173,3857,56317,117403,13298,9441,452092,2014
57,"Lunenburg, VA",131367,10344,20055,14106,173994,1401,-1186,17397,356584,11333,28685,357985,60024,66516,117475,12480,1088,10147,27108,3962,2874,94112,2014
58,"Madison, VA",243084,16082,21114,17508,377754,1284,-2461,24836,598337,102818,46004,599621,159506,119572,102295,13034,2098,100357,29868,5497,3399,112859,2014
59,"Mathews, VA",88274,7967,9668,6932,216090,242,178,11433,433475,27365,49213,433717,139249,124257,93370,8813,1402,27543,13134,2991,1589,47597,2014
60,"Mecklenburg, VA",533384,39258,73999,59634,475938,5229,-1383,69075,999718,38278,32296,1004947,11629,193214,335795,31117,3157,36895,103816,15401,12244,392673,2014
61,"Middlesex, VA",183953,13770,24146,16630,210496,1462,-5,22085,451438,35809,42514,452900,48628,127839,114565,10653,1848,35804,32461,5279,3431,115688,2014
62,"Montgomery + Radford, VA*",2870473,165311,466199,305658,2223909,6383,2351,318140,3625207,163317,31693,3631590,-328424,781716,625965,114588,10912,165668,619028,62398,51486,2085777,2014
63,"Nelson, VA",222195,16601,27806,19526,329938,1872,-1817,26364,646799,53281,43632,648671,134107,170166,148567,14867,2671,51464,37569,6862,4191,133162,2014
64,"New Kent, VA",238430,16937,28852,22826,991160,-438,-716,28350,1309871,47656,65403,1309433,781080,180409,137864,20021,2953,46940,40265,7108,4155,151225,2014
65,"Newport News (Independent City), VA",7592055,418206,1124542,867438,4348125,0,0,851925,6848167,351265,37698,6848167,-2392005,1140156,1359886,181661,14640,351265,1558261,123428,108788,5682529,2014
66,"Norfolk (Independent City), VA",13704839,691083,2281403,1737318,5084881,0,0,1559742,8915068,330962,36129,8915068,-7060216,2049024,1781163,246756,20465,330962,3150062,207913,187448,10223815,2014
67,"Northampton, VA",252422,15808,30656,25510,234005,30735,15507,28563,450958,26979,40028,481693,10146,112009,135679,12034,1821,42486,43411,6869,5048,166525,2014
68,"Northumberland, VA",144074,13286,17980,14374,203890,1588,473,20473,543987,23762,44515,545575,80289,189296,152389,12256,1782,24235,25167,4390,2608,94672,2014
69,"Nottoway, VA",302537,19729,55406,34774,220694,8127,5341,37116,461852,10756,30292,469979,-44727,85101,164184,15515,1452,16097,72793,7596,6144,213647,2014
70,"Orange, VA",523456,36982,64998,52010,901015,10482,-2730,62987,1507084,78656,43468,1517566,440546,328200,288351,34912,4425,75926,91003,14364,9939,356527,2014
71,"Page, VA",304774,21630,37504,30126,444715,34153,30600,36693,761702,38965,33458,795855,176634,140603,210537,23787,2704,69565,52567,8717,6013,182642,2014
72,"Patrick, VA",232321,18372,32886,23908,269003,2054,-230,30326,530496,34488,29285,532550,67008,80339,183208,18185,2184,34258,44840,7475,5291,153223,2014
73,"Pittsylvania + Danville, VA*",1918648,134058,255444,215240,1784588,27624,17175,241678,3363216,131784,32392,3390840,107618,504667,1101585,104681,9688,148959,363064,50760,41072,1406625,2014
74,"Portsmouth (Independent City), VA",3788225,203500,708075,468060,2001213,0,0,437530,3440929,79932,35886,3440929,-1349482,585750,853966,95886,7306,79932,942105,59922,52616,2766188,2014
75,"Powhatan, VA",438589,29215,58535,43204,911257,716,-258,50817,1331613,65918,46742,1332329,523485,238504,182568,28504,3378,65660,80137,11077,7699,292792,2014
76,"Prince Edward, VA",441230,28278,64500,47286,323475,4041,2797,51921,615118,37971,26927,619159,-65834,109264,186420,22994,2244,40768,88143,11505,9261,312319,2014
77,"Prince George + Hopewell, VA*",2444107,123678,462652,312892,1205197,-1699,-2257,280124,2060704,50351,34558,2059005,-958786,380612,473196,59582,3580,48094,619098,35895,32315,1776915,2014
78,"Prince William, Manassas + Manassas Park, VA*",11330617,642445,1363621,1216764,18562217,-1875,-5425,1250827,24765920,1386851,49423,24764045,8482427,3947548,2254280,501067,58010,1381426,1972003,221245,163235,7977188,2014
79,"Pulaski, VA",743908,49915,99746,86406,687234,5215,3379,93118,1199306,51117,35073,1204521,36444,183131,334156,34343,2678,54496,142949,16774,14096,546463,2014
80,"Rappahannock, VA",132501,9460,11874,9304,218262,-2129,-4456,14112,411737,43961,55775,409608,99873,131762,59584,7344,1816,39505,16526,3537,1721,76470,2014
81,"Richmond (Independent City), VA",12377238,700406,1522041,1275894,6112797,0,0,1338353,10328668,1190081,47545,10328668,-4926088,2478922,1736949,217238,24261,1190081,2159988,183795,159534,9027169,2014
82,"Richmond, VA",154230,10107,25164,15956,149189,1419,-1480,18085,280252,12078,31720,281671,13044,60396,72086,8880,965,10598,33142,4027,3062,110490,2014
83,"Roanoke (Independent City), VA",4278711,259410,511509,510866,2113028,0,0,514843,3807746,257883,38278,3807746,-1650840,727411,967307,99475,9449,257883,766942,81715,72266,3253886,2014
84,"Roanoke + Salem, VA*",3837732,238590,469362,405040,3497514,-491,-1529,441110,5445741,391953,45809,5445250,100892,986324,961412,118869,12907,390424,671882,75230,62323,2775426,2014
85,"Rockbridge, Buena Vista + Lexington, VA*",727523,48773,95204,79036,674342,3714,975,88291,1295114,91882,35940,1298828,35110,317508,306978,36139,4674,92857,134722,18847,14173,499944,2014
86,"Rockingham + Harrisonburg, VA*",3695064,207966,452455,364540,2958576,234669,209234,390236,4338683,356480,35049,4573352,-346252,823842,790934,130486,16155,565714,634725,80908,64753,2494625,2014
87,"Russell, VA",392131,30891,52615,43834,426453,4277,1875,52808,824597,31275,29516,828874,87130,112044,290377,28082,2559,33150,74532,10006,7447,284449,2014
88,"Scott, VA",230831,20659,33312,25416,326395,-2232,-3083,33367,665226,23115,29439,662994,128931,97961,238638,22521,2668,20032,46020,7816,5148,164779,2014
89,"Shenandoah, VA",758167,50661,93249,74378,992241,26210,21525,87850,1631719,110195,38794,1657929,321924,318079,347609,42737,5787,131720,130438,20667,14880,496009,2014
90,"Smyth, VA",657992,44588,94304,69882,578733,12519,10219,79529,1024724,63484,32831,1037243,270,139772,318738,31593,3189,73703,129245,15796,12607,455044,2014
91,"Southampton + Franklin, VA*",399686,27786,62493,41374,520839,1145,-4311,48473,944957,36055,35537,946102,169626,175913,249350,26623,2537,31744,83180,11088,8551,284762,2014
92,"Spotsylvania + Fredericksburg, VA*",3360568,205617,381062,355618,4797066,1441,-490,383426,7084896,362621,45091,7086337,1819924,1300835,988436,157157,16201,362131,558871,76703,60502,2439566,2014
93,"Stafford, VA",3042608,176072,421670,333452,4923922,-3422,-3996,342798,6878417,234837,49483,6874995,2224112,1206475,744598,138937,13309,230841,588396,57736,44427,2223371,2014
94,"Suffolk (Independent City), VA",1902422,117816,233140,209466,2601116,13175,-198,222549,3981957,147613,45934,3995132,921243,714860,679156,86976,8722,147415,337873,37995,29273,1417134,2014
95,"Surry, VA",234841,13632,42177,24326,157586,1896,865,25795,250441,6786,37201,252337,-51460,35288,59463,6783,591,7651,54340,2989,2398,172850,2014
96,"Sussex, VA",207408,13231,31744,22248,177101,6929,5129,24355,312427,9956,27240,319356,-5952,45004,97251,11724,869,15085,42868,4909,4040,149455,2014
97,"Tazewell, VA",800728,56903,111303,85528,761890,6749,5411,99667,1455032,71766,33682,1461781,60829,233257,466634,43399,3793,77177,154067,20555,16762,569484,2014
98,Virginia,293734833,17291151,34325940,31679344,279115524,673870,329780,33130823,418655729,27341131,50428,419329599,18511514,83664869,56549206,8315430,980916,27670911,50165612,4953354,3972438,215898310,2014
99,"Virginia Beach (Independent City), VA",12203470,697080,1571897,1349064,14539612,-2542,-4632,1371612,22531497,1313131,50160,22528955,3707754,4976989,3012354,449139,51408,1308499,2246429,250531,199123,8648542,2014
100,"Warren, VA",740216,47857,88166,80554,1047608,-2054,-3069,88134,1564437,81260,38917,1562383,395526,248108,266667,40147,4165,78191,128443,17465,13300,533582,2014
101,"Washington + Bristol, VA*",1666215,112428,219382,177416,1372605,15072,10690,201136,2641384,156264,36970,2656456,-92474,592083,691768,71855,8471,166954,308090,40631,32160,1191171,2014
102,"Westmoreland, VA",168031,13858,23152,17160,320199,10898,4351,22438,650660,18663,37933,661558,174606,172628,168731,17440,2074,23014,31732,5852,3778,113285,2014
103,"Wise + Norton, VA*",850901,59458,129345,94726,636709,934,798,106821,1315499,41520,29882,1316433,-107371,185564,494160,44055,2863,42318,176708,20223,17360,631875,2014
104,"Wythe, VA",563365,38175,82050,61154,482941,10931,7435,68752,889685,43895,30992,900616,-11672,136063,281612,29060,3483,51330,112627,15637,12154,399408,2014
105,"York + Poquoson, VA*",1397008,87502,184464,154700,2788209,307,-784,164852,4225026,146822,53749,4225333,1556053,927708,509416,78612,6730,146038,261814,32424,25694,989156,2014
0,"Accomack, VA",751303,48015,106385,77234,663844,33464,27204,86632,1235993,66350,38550,1269457,-827,268930,336683,32930,3955,93554,145002,18019,14064,512747,2015
1,"Albemarle + Charlottesville, VA*",7244441,412689,963144,740628,5304676,-5382,-16484,783003,9473982,732251,62467,9468600,-1156762,3210384,953540,151578,25459,715767,1333458,124844,99385,5195216,2015
2,"Alexandria (Independent City), VA",10223260,573443,1140448,1147078,8932999,0,0,1146982,12502135,907067,81257,12502135,-143279,2816255,752881,153859,24325,907067,1713987,126918,102593,7602206,2015
3,"Alleghany + Covington, VA*",483734,34309,63319,56064,400428,-1314,-1704,62341,762063,27556,36049,760749,-20965,120695,239626,21103,1514,25852,91351,9961,8447,366531,2015
4,"Amelia, VA",187371,12267,17768,14206,340728,24010,19874,19370,506566,45296,41503,530576,172727,71725,118123,12784,1714,65170,24871,4387,2673,97330,2015
5,"Amherst, VA",483704,34771,72416,51496,619489,-837,-1700,60519,1080143,38438,33882,1079306,196304,171583,288234,31855,2783,36738,98164,12305,9522,348802,2015
6,"Appomattox, VA",159818,13253,22778,15184,315760,-1588,-2541,20845,548902,25597,35345,547314,176787,83131,148423,15485,1720,23056,30370,5146,3426,106392,2015
7,"Arlington, VA",21306347,1182815,2434167,2406150,14620599,0,0,2385890,19646826,1219198,85836,19646826,-4299858,4107334,918893,228887,32956,1219198,3637242,221671,188715,16449907,2015
8,"Augusta, Staunton + Waynesboro, VA*",2867325,185363,366059,294378,2892203,53341,44823,332552,4767154,311828,40151,4820495,357430,888720,1039572,120059,13690,356651,513248,64144,50454,1997426,2015
9,"Bath, VA",129809,8571,16076,13484,111025,995,439,15313,238266,10715,53610,239261,-3471,80807,47429,4463,643,11154,22818,3128,2485,95837,2015
10,"Bedford, VA*",1140615,84777,131981,117360,1976817,-5052,-7147,143457,3294548,178608,42361,3289496,979659,636718,675961,77653,9837,171461,190661,30512,20675,778493,2015
11,"Bland, VA",128939,8724,22238,13234,118579,454,58,15341,211559,12856,32438,212013,4981,33180,60254,6536,800,12914,28855,2872,2072,87170,2015
12,"Botetourt, VA",610368,42959,75880,65590,990358,-1207,-2688,75754,1556166,65876,46568,1554959,455744,275625,288976,33391,4157,63188,108675,15044,10887,438505,2015
13,"Brunswick, VA",207369,15769,31127,22496,249465,2346,251,27017,496514,12639,29627,498860,69113,72464,176931,16838,1283,12890,42375,5746,4463,152104,2015
14,"Buchanan, VA",449807,33912,63939,49708,337440,-259,-319,58766,714540,26502,31374,714281,-53601,92547,284294,22767,1216,26183,88793,8588,7372,334831,2015
15,"Buckingham, VA",199203,14579,31244,19920,257394,2319,1053,24539,462615,21083,27314,464934,82730,69008,138532,17022,1352,22136,41204,4946,3594,135863,2015
16,"Campbell + Lynchburg, VA*",4147231,259443,498343,474054,2584125,514,-1796,496470,4703852,194912,34941,4704366,-1066636,811148,1309093,134637,12569,193116,735370,87095,74526,3218745,2015
17,"Caroline, VA",336761,24222,53189,36466,819437,-4646,-6776,42455,1260122,33713,41979,1255476,525131,206133,229906,29907,2737,26937,71422,8948,6211,238402,2015
18,"Carroll + Galax, VA*",595097,43492,82231,63852,606614,7353,4951,75418,1178740,64240,32342,1186093,86935,170581,408898,36673,3414,69191,114157,16561,13147,411749,2015
19,"Charles City, VA",112361,8061,13494,11224,170162,2305,934,13673,293053,15808,41936,295358,71474,57637,67559,7043,561,16742,19106,2411,1850,76513,2015
20,"Charlotte, VA",162709,12708,24122,15586,198822,-540,-2547,20501,391389,26578,32084,390849,56614,64726,127301,12182,1845,24031,31915,5039,3194,106763,2015
21,"Chesapeake (Independent City), VA",5864676,356303,724110,671618,7456421,3672,-1308,692112,11041623,322041,46951,11045295,2283857,1934058,1654816,235253,22682,320733,1059919,127558,104876,4484024,2015
22,"Chesterfield, VA",8763352,537103,1019164,955172,11421140,73,-955,1014689,16591184,750746,49512,16591257,3672477,2877923,2292194,335093,40056,749791,1496750,180781,140725,6516811,2015
23,"Clarke, VA",275492,18105,27928,26786,511974,4136,-289,31498,828702,51962,58437,832838,267980,217891,102973,14252,2984,51673,41321,7127,4143,182498,2015
24,"Craig, VA",41904,3854,5993,3958,102696,-865,-1444,5833,184956,8348,35815,184091,66625,33068,48327,5140,630,6904,7972,1386,756,27028,2015
25,"Culpeper, VA",1010270,63985,123656,102804,1370567,-566,-6785,115387,2093949,154421,42240,2093383,475684,372539,350277,49559,6981,147636,175058,23717,16736,687576,2015
26,"Cumberland, VA",83993,6569,11241,6798,195071,9834,8641,9968,324612,15041,34274,334446,121046,47049,92326,9758,778,23682,14640,2271,1493,45671,2015
27,"Dickenson, VA",213550,17491,32293,22202,202759,-1037,-1107,28592,448808,16240,29459,447771,17801,54407,190605,15200,732,15133,43394,4676,3944,155023,2015
28,"Dinwiddie, Colonial Heights + Petersburg, VA*",1690074,110757,230838,192010,1562058,-1441,-2725,206762,2889210,92612,37262,2887769,78746,473368,852343,77498,7684,89887,326843,41879,34195,1273344,2015
29,"Essex, VA",182891,13606,24097,20118,220727,-8069,-9014,23665,423929,22773,37495,415860,61501,82913,112220,11091,1370,13759,34156,5429,4059,134976,2015
30,"Fairfax, Fairfax City + Falls Church, VA*",73298696,4300682,6632634,7689848,62997123,5936,3688,8145606,89563615,6515620,76031,89569551,-2155967,20702347,5870081,1178064,184591,6519308,10477558,877357,692766,56301830,2015
31,"Fauquier, VA",1658792,102384,175695,162238,2817069,-2760,-15933,183503,4371241,304377,63821,4368481,1341780,1108882,442530,68449,11520,288444,256814,35233,23713,1113534,2015
32,"Floyd, VA",161277,13272,20575,15234,308320,-119,-3979,20889,540363,36199,34709,540244,167932,94970,136954,15565,2584,32220,28192,5931,3347,100865,2015
33,"Fluvanna, VA",285433,21774,39277,28034,649059,-2327,-2948,35791,1067758,42950,40752,1065431,399417,222882,193490,26144,3026,40002,53294,7880,4854,192137,2015
34,"Franklin, VA",784680,58700,97102,81072,1158114,5949,740,99236,2110071,119213,37629,2116020,472670,448653,509253,56234,6627,119953,137638,22416,15789,527089,2015
35,"Frederick + Winchester, VA*",3562609,215100,431137,381376,3380031,-6317,-10929,405788,5061563,365644,45533,5055246,223210,906017,769198,111025,13429,354715,621825,71689,58260,2586069,2015
36,"Giles, VA",286697,20777,41536,30420,352513,99,-453,35987,608917,25789,36320,609016,101803,89671,166832,16768,1723,25336,56746,6816,5093,204615,2015
37,"Gloucester, VA",481224,34952,66776,48446,1033971,748,53,59175,1667856,58196,45058,1668604,611922,316288,318345,37032,3775,58249,90999,13871,10096,331976,2015
38,"Goochland, VA",1703707,102905,146664,171504,1175248,-3442,-5230,188657,1990998,76455,88953,1987556,-339802,618717,193591,22344,3681,71225,232416,19582,15901,1400066,2015
39,"Grayson, VA",135128,12892,22930,13296,226274,-2949,-4762,19540,454567,22845,28297,451618,110686,69944,155400,15960,2012,18083,29578,4851,2839,87467,2015
40,"Greene, VA",224908,16041,24941,20402,504624,525,-502,26242,775181,53693,40391,775706,305958,132725,138357,19205,2098,53191,35142,6004,3906,136575,2015
41,"Greensville + Emporia, VA*",373743,24128,59704,43186,255439,-525,-1574,45721,492051,5615,28312,491526,-72583,68512,167575,17361,1349,4041,81297,9514,8165,288405,2015
42,"Halifax, VA",646050,45832,95668,71182,584961,-727,-4506,81423,1138798,51966,32420,1138071,20334,178145,374965,35104,3387,47460,131259,16511,13124,467331,2015
43,"Hampton (Independent City), VA",4203034,236868,690159,516584,3206346,0,0,495160,5373683,133887,39403,5373683,-501528,977445,1189892,136379,11367,133887,948451,75674,64307,3120696,2015
44,"Hanover, VA",3223176,196920,331458,337256,3983124,4949,-2795,365548,5720883,447346,55539,5725832,1125496,1025635,717073,103095,13956,444551,500086,67704,53748,2278539,2015
45,"Henrico, VA",16402895,953447,1430456,1549606,13664034,1033,-162,1728250,19225677,3371299,59264,19226710,-1010611,3360144,2202532,324424,43871,3371137,2205259,244126,200255,10826499,2015
46,"Henry + Martinsville, VA*",1231769,89843,164498,135402,1131215,6985,6173,157544,2279457,109302,35050,2286442,56990,379202,776025,65233,5420,115475,232199,31747,26327,884095,2015
47,"Highland, VA",32529,2218,4396,2492,33514,7092,6378,3464,82069,3149,40602,89161,4449,32933,22714,2196,717,9527,5642,1313,596,17360,2015
48,"Isle of Wight, VA",702973,47460,81027,71838,1237641,-1309,-3126,83379,1834815,69398,50670,1833506,618047,288284,307581,36185,3891,66272,116946,15634,11743,519755,2015
49,"James City + Williamsburg, VA*",2424538,155281,297477,252720,3014250,-3879,-4550,281641,5335993,282988,60775,5332114,871353,1527330,790534,87735,12037,278438,423837,56417,44380,1722263,2015
50,"King George, VA",1319361,72070,205327,143124,936212,-1648,-2138,143632,1349383,170851,52973,1347735,-239517,258457,153066,25442,2526,168713,276889,14463,11937,873759,2015
51,"King William, VA",251475,17393,28330,26496,437753,-2226,-2899,30641,676822,36923,41419,674596,216919,112508,124335,16287,1747,34024,41578,5757,4010,175873,2015
52,"King and Queen, VA",69759,5786,9038,6760,161949,-264,-1339,9166,269652,13408,38001,269388,101356,42483,64956,7089,741,12069,12418,1883,1142,45272,2015
53,"Lancaster, VA",245602,18658,28884,25114,203011,-611,-1030,31215,565470,31941,52167,564859,-11376,215850,145998,10828,2015,30911,41441,6888,4873,173250,2015
54,"Lee, VA",240698,20734,42514,25352,301969,-1427,-2399,33410,664080,23575,26911,662653,94681,91467,269217,24624,2373,21176,55190,7315,4942,164332,2015
55,"Loudoun, VA",13881758,805271,1376796,1442286,21367043,-1028,-14105,1526414,26752456,1307756,71494,26751428,9011699,4051671,1332714,374176,53554,1293651,2097939,220455,166901,10490168,2015
56,"Louisa, VA",685813,45277,91649,72914,836695,-788,-2346,81734,1370299,63451,39725,1369511,232616,249820,282996,34475,3783,61105,128106,13948,10165,496602,2015
57,"Lunenburg, VA",135239,10699,21181,14320,182308,912,-1205,17859,362545,11832,29434,363457,64928,67823,113326,12348,1027,10627,28341,3900,2873,96271,2015
58,"Madison, VA",249012,16581,22054,17930,383475,-910,-3950,25546,614399,105467,46996,613489,160009,128213,101801,13054,2087,101517,31019,5520,3433,116476,2015
59,"Mathews, VA",90895,8261,10050,7162,222813,412,362,11842,450288,27660,51025,450700,143760,129806,98081,8833,1348,28022,13631,2954,1606,49242,2015
60,"Mecklenburg, VA",564721,41337,78242,64314,498044,3101,-2281,73494,1031895,35823,33458,1034996,6817,193501,343451,30934,3155,33542,110399,15765,12610,420780,2015
61,"Middlesex, VA",191373,14299,25828,17330,219960,717,-483,22964,480249,37390,45022,480966,51551,136858,124148,10683,1863,36907,34493,5366,3503,119973,2015
62,"Montgomery + Radford, VA*",3015624,172957,499748,319450,2359943,4430,1174,332682,3807904,187936,33229,3812334,-322999,817412,634979,114728,10874,189110,659473,63192,52318,2167041,2015
63,"Nelson, VA",231150,17300,28774,20602,343318,1804,-1201,27601,676598,54724,45950,678402,139769,175221,159863,14764,2799,53523,39075,7054,4255,138552,2015
64,"New Kent, VA",253201,18082,30786,24196,1034292,-1144,-1368,30180,1383605,50024,67828,1382461,811271,197248,150921,20382,3006,48656,42884,7363,4357,161661,2015
65,"Newport News (Independent City), VA",7769411,429450,1153732,897138,4521762,0,0,878019,7083384,335806,39109,7083384,-2369630,1158447,1403175,181121,15521,335806,1602301,123799,108278,5831304,2015
66,"Norfolk (Independent City), VA",14332476,727591,2419938,1839268,5177024,0,0,1647225,9122280,274794,36982,9122280,-7508227,2117495,1827761,246667,20718,274794,3339572,211487,190769,10718110,2015
67,"Northampton, VA",270380,16769,32570,27392,251775,33396,20966,30465,477290,27916,42300,510686,11860,117887,141024,12073,1802,48882,46266,7026,5224,175232,2015
68,"Northumberland, VA",150698,13884,18773,15282,210709,317,-594,21525,560226,24327,45785,560543,81536,198721,151113,12243,1772,23733,26414,4397,2625,100551,2015
69,"Nottoway, VA",325339,20937,60139,37810,233630,10004,7745,39842,484046,10915,31644,494050,-51867,90796,169624,15613,1443,18660,79044,7790,6347,227635,2015
70,"Orange, VA",539933,37902,68501,52562,945723,14116,3353,64183,1576629,81654,45226,1590745,469973,331346,313676,35173,4423,85007,94782,14362,9939,360144,2015
71,"Page, VA",321230,22734,39470,31864,466899,34710,31826,38666,803271,42867,35407,837981,184335,151930,219152,23667,2672,74693,55402,8746,6074,191135,2015
72,"Patrick, VA",241040,18988,34481,24826,278214,1731,-124,31401,548310,34363,30605,550041,68575,85709,186118,17972,2144,34239,46894,7637,5493,159907,2015
73,"Pittsylvania + Danville, VA*",1978854,138981,267960,221566,1832366,15496,7040,249764,3494375,125386,33745,3509871,103276,539219,1138286,104011,9741,132426,378743,51253,41512,1467685,2015
74,"Portsmouth (Independent City), VA",3911245,211281,734709,485750,2061915,0,0,454156,3547748,78615,36800,3547748,-1395174,601775,884058,96407,7171,78615,977584,60430,53259,2855046,2015
75,"Powhatan, VA",445933,30109,58507,43154,957749,343,-447,51686,1420992,67567,50639,1421335,563502,263414,200172,28068,3563,67120,80084,11215,7652,298729,2015
76,"Prince Edward, VA",469201,29883,69724,50002,344118,2546,1535,54884,643005,42243,27899,645551,-70199,112831,188602,23139,2243,43778,94725,11851,9608,330698,2015
77,"Prince George + Hopewell, VA*",2515434,126589,479502,328640,1231389,-3165,-3611,290909,2128810,38155,35107,2125645,-993136,406600,487656,60547,3622,34544,643822,36512,32890,1837068,2015
78,"Prince William, Manassas + Manassas Park, VA*",11776446,669517,1430715,1272704,19176025,-3527,-6391,1305869,25690072,1400480,50485,25686545,8705448,4067770,2442750,508796,61700,1394089,2067067,228558,166858,8315290,2015
79,"Pulaski, VA",781710,52121,109372,90498,712276,4307,2818,97370,1249597,50763,36496,1253904,27936,188902,352726,34357,2565,53581,154621,17441,14876,573508,2015
80,"Rappahannock, VA",146246,10325,13143,10076,223312,-2348,-4242,15363,423263,45124,56811,420915,92429,134692,62911,7409,1721,40882,18181,3465,1744,87183,2015
81,"Richmond (Independent City), VA",12990792,738498,1594210,1337700,6493827,0,0,1407348,11011119,1218875,49805,11011119,-5089617,2712727,1804565,221084,25000,1218875,2263060,186071,161071,9508857,2015
82,"Richmond, VA",160355,10557,26185,16768,154676,751,-1613,18941,291594,12603,33300,292345,13262,64234,73435,8779,1001,10990,34569,4089,3088,114796,2015
83,"Roanoke (Independent City), VA",4449021,269542,531977,527300,2228073,0,0,533192,4001638,275472,40120,4001638,-1687756,783803,989762,99741,9447,275472,795627,81492,72045,3377922,2015
84,"Roanoke + Salem, VA*",4122325,257157,498117,420084,3692517,-768,-1603,467199,5738532,416223,48291,5737764,37391,1030737,1014510,118817,13128,414620,708159,76199,63071,2999546,2015
85,"Rockbridge, Buena Vista + Lexington, VA*",744551,50055,99308,81866,694140,791,-1422,90988,1330590,90251,36855,1331381,40577,325398,311843,36125,4651,88829,140241,19007,14356,515481,2015
86,"Rockingham + Harrisonburg, VA*",3872617,220104,469815,382260,3119619,214142,193545,411234,4583723,400778,36567,4797865,-341764,852618,825628,131208,16353,594323,660945,82108,65755,2617349,2015
87,"Russell, VA",412346,32455,55451,48108,424332,1776,-175,56509,840726,24391,30237,842502,68495,114651,303519,27863,2425,24216,79505,10196,7771,308625,2015
88,"Scott, VA",239648,21283,35868,26280,334608,-2099,-2785,34423,679496,22570,30379,677397,129383,99375,243414,22298,2581,19785,49008,7838,5257,170855,2015
89,"Shenandoah, VA",795333,53359,97619,78660,1037566,23208,19429,92689,1722464,107042,40727,1745672,334922,333384,374722,42863,5688,126471,136949,20934,15246,531913,2015
90,"Smyth, VA",667396,45424,99767,70568,585973,8408,6539,80708,1052263,63333,33732,1060671,-715,142832,331866,31444,3085,69872,135051,15996,12911,462473,2015
91,"Southampton + Franklin, VA*",404317,28964,66211,42834,528643,-12033,-16461,50381,986476,37787,36802,974443,174707,184874,260926,26478,2433,21326,87628,11379,8946,295363,2015
92,"Spotsylvania + Fredericksburg, VA*",3524002,216358,402229,372274,4967982,139,-1416,402495,7379762,378814,46674,7379901,1846475,1357007,1054912,158117,16857,377398,588366,78689,61832,2558238,2015
93,"Stafford, VA",3095126,181698,430891,336194,5135169,-3426,-3895,349795,7204032,233697,51055,7200606,2389838,1244334,821103,141035,14099,229802,598988,59304,45205,2266336,2015
94,"Suffolk (Independent City), VA",2025326,125166,256915,225016,2730091,10794,-133,237674,4213574,159540,47901,4224368,942439,767060,727217,88190,9131,159407,369423,39711,30580,1496496,2015
95,"Surry, VA",277003,16279,46085,29770,171829,-1750,-2585,31164,272299,7004,40538,270549,-74010,38491,60229,6674,669,4419,60970,3354,2685,211614,2015
96,"Sussex, VA",205097,13485,33258,22452,176061,767,-691,24711,326261,9884,27970,327028,-4325,49298,101669,11692,861,9193,44484,4929,4068,151420,2015
97,"Tazewell, VA",794508,57103,115025,84866,744538,6518,5435,99536,1454165,70334,34025,1460683,49566,232799,483346,42930,3683,75769,157458,20172,16489,561281,2015
98,Virginia,306244872,18112689,36017008,33091254,290546779,505545,226205,34658316,437767212,27833826,52379,438272757,18960223,88219366,59506612,8367303,1011334,28060031,52562635,5060290,4048956,225622206,2015
99,"Virginia Beach (Independent City), VA",12752638,732348,1627341,1405158,15197098,-4712,-6405,1434927,23597008,1457387,52353,23592296,3879387,5197746,3197452,450635,53217,1450982,2329920,255345,202128,8971736,2015
100,"Warren, VA",702678,45711,87722,76442,1080389,-1807,-2632,83932,1627156,76230,41953,1625349,461643,259716,285244,38742,4396,73598,125943,17331,12935,503137,2015
101,"Washington + Bristol, VA*",1660865,116943,230228,182694,1356889,10109,6576,208290,2632388,115788,36961,2642497,-95686,570432,715176,71494,8254,122364,321575,40319,32065,1216926,2015
102,"Westmoreland, VA",176499,14294,24343,17524,334550,13337,8009,23056,672246,21023,39058,685583,181107,175418,175615,17553,2115,29032,33105,5925,3810,114362,2015
103,"Wise + Norton, VA*",844947,59312,133036,95182,631993,349,241,106903,1317433,39250,30218,1317782,-106051,181563,504226,43609,2733,39491,180627,19858,17125,624829,2015
104,"Wythe, VA",587227,39731,85719,63376,506715,10141,7304,71419,926828,45178,32192,936969,-9093,143118,287136,29106,3400,52482,117407,15731,12331,417338,2015
105,"York + Poquoson, VA*",1461366,91706,195473,163002,2838583,679,-205,173207,4348839,143410,54425,4349518,1550424,970606,540329,79918,6920,143205,276974,33142,26222,1041187,2015
0,"Accomack, VA",845991,52881,128688,91406,710353,24931,17865,98584,1328923,64464,41147,1353854,-37054,299253,344248,32903,3801,82329,174391,18612,14811,589271,2016
1,"Albemarle + Charlottesville, VA*",7529609,433158,993360,751614,5507074,-5609,-18085,808965,10098274,836157,65691,10092665,-1213570,3589005,996586,153638,26991,818072,1369167,128766,101775,5342370,2016
2,"Alexandria (Independent City), VA",10309655,580197,1167248,1140802,9090789,0,0,1150598,12825150,912487,81887,12825150,-68268,2935212,799149,156621,25705,912487,1737649,127045,101340,7659519,2016
3,"Alleghany + Covington, VA*",477152,34635,64037,55830,393876,-1089,-1526,62550,770397,19484,36503,769308,-20726,123913,251519,21075,1524,17958,91952,9933,8409,367242,2016
4,"Amelia, VA",164396,11941,18128,14286,332600,15396,10719,19084,513682,30566,41318,529078,187288,74011,122467,12805,1681,41285,25271,4411,2730,97840,2016
5,"Amherst, VA",470750,35272,70007,49642,620441,-1872,-2844,60093,1098357,35224,34369,1096485,209784,172811,303233,31903,2970,32380,94828,12148,9178,343542,2016
6,"Appomattox, VA",160890,13922,23383,15516,319666,-3006,-4062,21680,560383,22878,35879,557377,180456,83225,154486,15535,1768,18816,31141,5294,3526,110933,2016
7,"Arlington, VA",22040503,1220142,2524614,2448002,14854712,0,0,2444143,20198584,1287387,87136,20198584,-4741648,4386558,957314,231805,34625,1287387,3748615,227324,192699,17004501,2016
8,"Augusta, Staunton + Waynesboro, VA*",2895380,191203,379907,300584,2928024,26362,16802,341495,4913582,281155,40876,4939944,374139,939864,1072056,120852,14075,297957,530199,65224,51149,2067224,2016
9,"Bath, VA",132251,8906,16772,14082,111698,724,99,15947,249098,7327,56675,249822,-4606,87629,50495,4408,626,7426,23813,3092,2466,101012,2016
10,"Bedford, VA*",1121882,86884,134026,116514,1981559,-7827,-10172,145141,3341913,151129,42732,3334086,1004818,642642,709885,78024,9913,140957,192283,30483,20570,788642,2016
11,"Bland, VA",125266,8836,21794,13382,111587,-476,-910,15527,212766,9398,32746,212290,1848,35390,65313,6483,743,8488,28485,2821,2078,88293,2016
12,"Botetourt, VA",611979,44432,76005,64442,981568,-2841,-4515,76653,1580479,62107,47379,1577638,446242,288452,307618,33298,4286,57592,108226,15314,11028,446161,2016
13,"Brunswick, VA",210433,16508,31371,23278,252558,1242,-1130,28147,505903,10751,30538,507145,70272,74935,179652,16607,1363,9621,43010,5786,4423,157802,2016
14,"Buchanan, VA",395768,31909,59295,43920,300376,-297,-366,53869,690173,20298,31035,689876,-41523,93094,296406,22229,1263,19932,81255,8224,6961,294581,2016
15,"Buckingham, VA",200915,15343,32434,20210,258573,-841,-2267,25448,470295,20497,27544,469454,83106,70375,140506,17044,1496,18230,42539,5150,3654,140146,2016
16,"Campbell + Lynchburg, VA*",4166055,264636,505339,472846,2553923,-2719,-5312,501059,4713233,169584,34825,4710514,-1111073,804705,1351886,135262,12609,164272,741762,87201,74592,3260021,2016
17,"Caroline, VA",346682,25444,54974,36932,756989,-3505,-5914,43910,1204561,31956,39914,1201056,454217,208175,235892,30091,2878,26042,73440,9191,6313,247200,2016
18,"Carroll + Galax, VA*",600827,45296,83818,64150,608212,2867,161,77371,1191891,60273,32820,1194758,84756,177113,409433,36403,3825,60434,115893,17214,13389,424500,2016
19,"Charles City, VA",110786,8278,13727,11362,171652,2615,1069,13959,300244,10971,43105,302859,74825,60849,70358,7026,728,12040,19408,2580,1852,79338,2016
20,"Charlotte, VA",168330,13591,24974,16624,204596,-3015,-5274,21903,404051,24831,33108,401036,58169,66700,129740,12113,1774,19557,33286,5081,3307,115487,2016
21,"Chesapeake (Independent City), VA",5973251,368266,733064,673456,7678167,4162,-1484,704994,11377244,324839,47890,11381406,2409910,1972938,1730301,237656,23684,323355,1069792,130010,106326,4580104,2016
22,"Chesterfield, VA",8990786,558580,1060217,972532,11695065,217,-943,1044846,17120682,727435,50552,17120899,3749125,3016510,2409324,338677,41079,726492,1546483,185375,144296,6717811,2016
23,"Clarke, VA",272966,18612,28513,26678,542949,2450,-2552,31951,884762,48506,62004,887212,301934,234707,109556,14309,2754,45954,41852,6975,4221,185160,2016
24,"Craig, VA",41194,4005,6384,3926,97188,-1583,-2235,5968,180419,6985,34807,178836,61962,32756,48892,5138,647,4750,8347,1417,770,28097,2016
25,"Culpeper, VA",1031761,66816,125588,102924,1445045,-1806,-8835,118278,2202220,155961,43714,2200414,531562,386559,368810,50337,6548,147126,177050,23169,16621,707585,2016
26,"Cumberland, VA",85149,7134,11849,7406,198442,6559,5213,10837,332759,13695,34830,339318,124130,49302,91574,9742,1020,18908,15552,2554,1534,50689,2016
27,"Dickenson, VA",189696,16661,29562,20260,189499,-789,-867,26791,438928,12324,29172,438139,26594,54280,194360,15019,730,11457,39692,4393,3663,138547,2016
28,"Dinwiddie, Colonial Heights + Petersburg, VA*",1731411,115118,238843,194254,1543056,-2863,-4305,212245,2873580,79617,37168,2870717,23890,453347,874314,77237,6405,75312,335970,41064,34659,1320129,2016
29,"Essex, VA",187092,14205,25113,20644,224222,-7628,-8697,24527,433564,20114,38466,425936,61657,88870,112844,11073,1350,11417,35435,5483,4133,140240,2016
30,"Fairfax, Fairfax City + Falls Church, VA*",74346374,4432450,6744312,7834244,63333122,4527,2001,8349572,90940532,5711856,76947,90945059,-2663680,21576801,6035136,1181911,188947,5713857,10661434,893525,704578,57971083,2016
31,"Fauquier, VA",1708638,107641,183436,164534,2932592,-4031,-18927,189908,4501488,298892,65341,4497457,1413862,1100291,464574,68831,12061,279965,265703,36207,24146,1162970,2016
32,"Floyd, VA",160796,13945,21668,15682,311293,-3073,-7435,21786,558949,33290,35440,555876,172283,102387,142196,15685,2652,25855,29509,6088,3436,105432,2016
33,"Fluvanna, VA",274664,22002,39669,26114,668971,-3013,-3715,35059,1090275,43489,41456,1087262,429366,219019,199272,26227,3000,39774,52726,7556,4556,182164,2016
34,"Franklin, VA",789204,61453,98400,81590,1167308,-310,-6187,102248,2157813,115079,38412,2157503,480352,460612,529583,56167,6756,108892,139195,22654,15898,541117,2016
35,"Frederick + Winchester, VA*",3686448,225348,446748,389420,3550864,-5989,-11176,420058,5326627,379908,47290,5320638,284474,961335,808439,112511,13812,368732,641458,72849,59037,2676258,2016
36,"Giles, VA",279162,21091,40487,29894,348679,-1673,-2292,36038,620569,23870,36719,618896,105555,93809,176408,16855,1649,21578,55434,6735,5086,202150,2016
37,"Gloucester, VA",495462,36892,69382,49712,1087695,689,-84,61748,1736045,56683,46786,1736734,653981,325066,323973,37121,3871,56599,94238,14001,10130,344625,2016
38,"Goochland, VA",1759634,107007,152518,176390,1152675,-5101,-7120,195202,2056367,81277,90504,2051266,-411757,698621,199970,22665,4424,74157,240713,20699,16275,1444764,2016
39,"Grayson, VA",131517,13747,24108,13762,226375,-11186,-13232,20628,474507,22073,29195,463321,115486,74470,162476,15870,2096,8841,30989,5020,2924,91687,2016
40,"Greene, VA",241394,17639,25785,21122,524859,-153,-1315,28200,803913,62339,41618,803760,311665,137071,141830,19313,2286,61024,36346,6289,4003,144024,2016
41,"Greensville + Emporia, VA*",387139,25192,62331,43788,264407,576,-609,47086,497681,4446,29306,498257,-75646,67140,166710,17002,1196,3837,84225,9430,8234,299077,2016
42,"Halifax, VA",654071,47637,98714,71416,594073,-3593,-7860,83345,1174624,50183,33455,1171031,23347,192442,384516,35003,3385,42323,134422,16393,13008,477326,2016
43,"Hampton (Independent City), VA",4265648,241639,713526,516126,3197284,0,0,499702,5407022,120158,39897,5407022,-568662,983244,1226494,135525,11984,120158,971589,76158,64174,3173901,2016
44,"Hanover, VA",3293419,205060,340006,342170,4112610,5190,-3567,376145,5958627,418842,57155,5963817,1195336,1093238,757969,104345,14959,415275,511091,69455,54496,2367053,2016
45,"Henrico, VA",16803782,989321,1456538,1560502,14006701,1067,-285,1769572,19860830,3551355,60893,19861897,-1027509,3551914,2303282,326178,43855,3551070,2236789,246887,203032,11015923,2016
46,"Henry + Martinsville, VA*",1249580,93075,167956,135542,1145423,6614,5696,160846,2310357,100972,35822,2316971,56689,377399,794149,64681,5207,106668,235727,31856,26649,907185,2016
47,"Highland, VA",30005,2341,4495,2532,30942,3857,3053,3607,84834,3042,40077,88691,4544,34379,23370,2213,702,6095,5761,1295,593,18149,2016
48,"Isle of Wight, VA",702871,48667,83031,72166,1273663,-2387,-4438,84750,1903044,59016,52144,1900657,655542,306905,320089,36450,3992,54578,119114,15812,11820,529179,2016
49,"James City + Williamsburg, VA*",2519707,164238,312974,261508,3135233,-4622,-5376,294992,5567778,269468,62529,5563156,910518,1603027,824896,88969,11541,264092,443728,56826,45285,1811887,2016
50,"King George, VA",1309128,71310,227041,150952,900858,-1564,-2115,146786,1328221,73171,51061,1326657,-261484,264790,161009,25982,2509,71056,302517,15256,12747,935555,2016
51,"King William, VA",255066,18167,29771,26554,478748,-2281,-3038,31444,726589,31807,44122,724308,255126,118640,126920,16416,1819,28769,43048,6017,4198,183249,2016
52,"King and Queen, VA",69845,6037,9077,6728,165461,-189,-1403,9401,279561,12850,39577,279372,105017,45645,68266,7059,754,11447,12441,1899,1145,45957,2016
53,"Lancaster, VA",256639,19796,29919,25760,211959,-136,-612,32676,585924,35348,54360,585788,-12004,225484,148345,10776,1965,34736,42799,6888,4923,179104,2016
54,"Lee, VA",244950,21707,43808,25536,299377,-3267,-4353,34475,665745,24122,27377,662478,88902,90713,272388,24198,2430,19769,56576,7351,4921,168605,2016
55,"Loudoun, VA",14413547,838396,1415654,1484628,22892461,2313,-12452,1580710,28701870,1443075,74411,28704183,10059624,4355512,1456210,385750,57298,1430623,2157968,229519,172221,10824956,2016
56,"Louisa, VA",678470,45820,95518,69712,853905,-1275,-3031,80676,1407325,68935,39942,1406050,256111,253640,298505,35202,4161,65904,130374,13967,9806,482192,2016
57,"Lunenburg, VA",136742,11230,21483,14268,184827,-120,-2522,18364,376025,11248,30462,375905,66449,71896,119182,12340,1131,8726,28617,4018,2887,99399,2016
58,"Madison, VA",238102,16753,22477,18552,390011,-3448,-6875,26029,637521,89368,48414,634073,177938,135593,108469,13097,2305,82493,31753,5699,3394,123856,2016
59,"Mathews, VA",92321,8711,10400,7178,227955,579,523,12300,457767,27540,52197,458346,147934,132443,97948,8781,1360,28063,13989,2987,1627,50269,2016
60,"Mecklenburg, VA",572380,42876,80244,64198,503995,1606,-4479,74975,1047790,34163,34055,1049396,6590,200682,344719,30815,3055,29684,112343,15617,12562,430353,2016
61,"Middlesex, VA",195077,15054,26849,17778,224333,737,-624,23943,496080,34016,46216,496817,53199,143872,128612,10750,1743,33392,35738,5327,3584,125947,2016
62,"Montgomery + Radford, VA*",3130407,181581,519361,326562,2404581,1893,-1768,344862,3928220,201173,33991,3930113,-380964,867332,658200,115623,10561,199405,682642,63956,53395,2248360,2016
63,"Nelson, VA",235745,18307,29532,21120,354773,1606,-1789,28867,697329,50372,47219,698935,147895,180813,163349,14802,2577,48583,40092,6795,4218,147070,2016
64,"New Kent, VA",270968,19902,32090,25114,1015807,-1570,-1824,32459,1385574,56445,65858,1384004,777298,207805,160392,21015,3049,54621,44647,7584,4535,171700,2016
65,"Newport News (Independent City), VA",7483867,421550,1104050,856912,4454730,0,0,850006,7094057,285826,39308,7094057,-2179131,1190235,1449092,180472,16159,285826,1532506,122232,106073,5665535,2016
66,"Norfolk (Independent City), VA",14765230,746629,2539191,1851664,5227277,0,0,1672461,9291230,266906,37763,9291230,-7865492,2188663,1875290,246042,21457,266906,3465023,219880,198423,11033301,2016
67,"Northampton, VA",269334,17105,32998,26616,283260,35329,21252,30413,517875,28053,46089,553204,44339,121888,148056,12003,1845,49305,46306,6957,5112,173723,2016
68,"Northumberland, VA",157615,14680,19836,16100,221117,990,-41,22730,585873,23678,48206,586863,86232,209492,156254,12174,1833,23637,27886,4534,2701,106092,2016
69,"Nottoway, VA",316770,20959,61041,36124,227785,8253,5706,39021,491074,6849,32210,499327,-49964,95236,176306,15502,1350,12555,79103,7535,6185,225112,2016
70,"Orange, VA",575852,40818,73367,56394,985500,16644,4474,69015,1633172,82103,46646,1649816,478663,344486,319830,35369,4314,86577,101564,14743,10429,387711,2016
71,"Page, VA",319636,23997,41509,32894,470339,24430,21180,40444,824244,40161,35911,848674,191147,151637,226698,23633,2688,61341,57956,8841,6153,200339,2016
72,"Patrick, VA",235608,19376,34178,24770,274428,1541,-552,31761,550578,28235,30966,552119,70581,87470,190221,17830,2109,27683,46563,7499,5390,161362,2016
73,"Pittsylvania + Danville, VA*",2008496,144654,274016,224080,1854292,11463,1945,256694,3539003,114053,34329,3550466,102490,522758,1173416,103426,9808,115998,386056,51625,41817,1506442,2016
74,"Portsmouth (Independent City), VA",3945920,211584,775205,480778,2026236,0,0,451973,3503984,56964,36773,3503984,-1467711,573797,903951,95287,7547,56964,1015594,60852,53305,2873362,2016
75,"Powhatan, VA",465272,32294,59873,44488,1023896,-228,-1120,54538,1506972,69670,52937,1506744,613162,275507,207341,28463,3891,68550,82117,11733,7842,314605,2016
76,"Prince Edward, VA",485804,31488,73866,51638,353486,1634,492,57307,663485,38673,28857,665119,-75011,116511,195122,23049,2065,39165,99685,11970,9905,346954,2016
77,"Prince George + Hopewell, VA*",2370568,122852,446718,294402,1241974,-2703,-3202,270053,2123490,46198,35002,2120787,-858541,378190,500623,60591,4046,42996,593919,35686,31640,1733653,2016
78,"Prince William, Manassas + Manassas Park, VA*",12054958,699241,1434743,1275308,19814770,-4273,-7485,1336895,26524117,1428986,51548,26519844,9096707,4128470,2576604,514470,65172,1421501,2072397,236044,170872,8561060,2016
79,"Pulaski, VA",724165,50541,103607,80416,700893,306,-1371,90749,1261785,49806,36830,1262091,67477,196111,365087,34268,2950,48435,143815,16972,14022,531915,2016
80,"Rappahannock, VA",142922,10630,13265,10510,232390,-3353,-5491,15885,436645,40525,58680,433292,105353,136642,64260,7384,1951,35034,18520,3752,1801,89368,2016
81,"Richmond (Independent City), VA",13361681,762268,1659215,1362882,6674446,0,0,1443709,11335985,1259089,50233,11335985,-5243526,2821486,1840053,225669,28126,1259089,2340656,193558,165432,9761936,2016
82,"Richmond, VA",165503,11112,27331,17296,160592,1508,-1164,19760,303405,10880,34827,304913,14849,68376,75945,8755,969,9716,35979,4130,3161,119808,2016
83,"Roanoke (Independent City), VA",4546407,276290,547382,526530,2168976,0,0,539555,3947144,277382,39716,3947144,-1837876,771903,1006265,99383,9197,277382,810647,81833,72636,3458378,2016
84,"Roanoke + Salem, VA*",3904368,247973,489309,410206,3671874,-950,-1882,453076,5805902,395505,48868,5804952,220582,1075551,1057527,118788,12976,393623,694412,75898,62922,2816333,2016
85,"Rockbridge, Buena Vista + Lexington, VA*",748350,51603,102630,81754,691871,-2439,-4924,92480,1352319,85818,37379,1349880,36001,339827,318182,36113,4662,80894,143507,19147,14485,523949,2016
86,"Rockingham + Harrisonburg, VA*",3891020,228657,489703,390428,3101507,144208,121030,423871,4704687,376545,36434,4848895,-365642,894868,852520,133086,16227,497575,684917,84320,68093,2708528,2016
87,"Russell, VA",412231,33481,55727,46954,408946,-2288,-4483,56958,841184,27448,30591,838896,53673,118653,311297,27423,2495,22965,79204,10196,7701,310062,2016
88,"Scott, VA",231073,21709,35196,25178,329237,-3953,-4725,34298,684835,21543,30851,680882,132462,104062,247583,22070,2559,16818,47785,7657,5098,166470,2016
89,"Shenandoah, VA",801126,55823,99159,78818,1055138,13623,9386,95232,1757904,106227,41235,1771527,349244,338059,378330,42962,5631,115613,138568,20710,15079,546945,2016
90,"Smyth, VA",668506,47014,102305,71558,580342,557,-1553,82793,1075135,52045,34540,1075692,-5371,153544,341806,31143,3019,50492,138084,16441,13422,479930,2016
91,"Southampton + Franklin, VA*",404754,29692,67394,43062,529110,-9470,-14465,51223,1013027,29818,38158,1003557,175579,199880,274567,26300,2439,15353,88925,11287,8848,300476,2016
92,"Spotsylvania + Fredericksburg, VA*",3583253,223431,417683,373902,5127829,18,-1726,410382,7643733,376980,47812,7643751,1954958,1404724,1111198,159870,18032,375254,604634,80991,62959,2603365,2016
93,"Stafford, VA",3185204,189046,452651,340874,5355657,-3771,-4298,359483,7461237,229978,51917,7457466,2529936,1233626,868183,143641,14772,225680,623088,61061,46289,2336436,2016
94,"Suffolk (Independent City), VA",2084421,130529,268820,228308,2820725,12081,-306,244683,4387508,162452,49234,4399589,980987,815869,762995,89360,9323,162146,382974,41291,31968,1539301,2016
95,"Surry, VA",245030,14343,48858,25868,159575,-1716,-2658,27277,261565,4620,39611,259849,-58178,36229,64045,6560,695,1962,61792,3198,2503,181276,2016
96,"Sussex, VA",200095,13517,33485,21950,171050,-325,-1968,24492,320773,7633,28048,320448,-4553,47683,101715,11425,836,5665,44460,4838,4002,149970,2016
97,"Tazewell, VA",736821,56360,112230,79918,681376,1142,-74,96319,1405623,50104,33315,1406765,40874,233787,491602,42226,3611,50030,152189,19396,15785,534602,2016
98,Virginia,311566614,18663880,36969072,33423844,296120034,258043,-57008,35375802,449572063,26839062,53439,449830106,19929222,91993130,61716942,8417651,1042791,26782054,53680994,5156641,4113850,231103566,2016
99,"Virginia Beach (Independent City), VA",13300405,765949,1748165,1466546,15444863,-5381,-7283,1499222,24299094,1362716,53805,24293713,3643680,5537995,3310855,451510,54935,1355433,2481438,266272,211337,9463534,2016
100,"Warren, VA",704542,46824,90361,76484,1148346,-2173,-3103,85066,1711849,71329,43618,1709676,528870,268341,292989,39197,4442,68226,128603,17429,12987,507713,2016
101,"Washington + Bristol, VA*",1549048,115410,230953,177978,1251899,-2049,-6016,204399,2559097,32889,35854,2557048,-92750,566499,738650,71318,8492,26873,319942,40485,31993,1202233,2016
102,"Westmoreland, VA",190258,15369,25722,18206,356338,17061,11041,24472,703464,23600,40835,720525,190552,184592,179595,17645,2203,34641,34825,6090,3887,120792,2016
103,"Wise + Norton, VA*",789418,57850,128114,87606,584967,-243,-364,101653,1286418,33472,29876,1286175,-102798,186587,514621,43051,2633,33108,171917,18875,16242,584393,2016
104,"Wythe, VA",586938,41258,87055,63184,495955,-501,-3705,72850,940373,44402,32524,939872,-18133,145158,298759,28898,3298,40697,118647,15726,12428,427594,2016
105,"York + Poquoson, VA*",1486437,95131,199819,164902,2918763,1039,42,177582,4452698,131630,55773,4453737,1609908,971528,563446,79854,8081,131672,282270,35008,26927,1072495,2016
0,"Accomack, VA",986168,59694,152088,110926,789373,31252,24155,115157,1438191,64196,44897,1469443,-81638,321957,358113,32729,3782,88351,207551,19360,15578,690266,2017
1,"Albemarle + Charlottesville, VA*",8029618,467248,1033059,804174,5865414,1620,-10881,869335,11041499,906185,70988,11043119,-1294869,4134568,1043137,155563,27594,895304,1435146,132145,104551,5699168,2017
2,"Alexandria (Independent City), VA",10388774,597764,1194080,1156800,9315742,0,0,1176164,13253775,829092,83477,13253775,103132,3105267,832766,158772,26829,829092,1772480,127192,100363,7787202,2017
3,"Alleghany + Covington, VA*",478344,35480,63569,55636,394905,-506,-948,63298,781109,18418,37524,780603,-20141,128314,257384,20803,1484,17470,91387,9829,8345,369487,2017
4,"Amelia, VA",169112,12511,18446,14938,339759,17658,12955,19980,527342,28808,42007,545000,190627,76121,129120,12974,1788,41763,25915,4538,2750,101434,2017
5,"Amherst, VA",464023,36063,66164,49276,634062,-162,-1140,60701,1126554,36409,35318,1126392,230740,177504,314826,31893,2996,35269,90802,11849,8853,337952,2017
6,"Appomattox, VA",166767,14682,23708,16146,333063,-2021,-3077,22755,581627,22872,36882,579606,189051,86864,159679,15715,1804,19795,31781,5369,3565,115191,2017
7,"Arlington, VA",23134430,1294824,2653609,2595288,15580620,0,0,2592468,21259091,1193632,90390,21259091,-4961342,4676182,1002289,235193,35939,1193632,3951253,233632,197693,17989545,2017
8,"Augusta, Staunton + Waynesboro, VA*",2999220,201833,380386,310424,3032185,39577,30008,357045,5110857,299789,42246,5150434,390010,1002372,1115877,121915,14285,329797,535598,65109,50824,2133825,2017
9,"Bath, VA",134169,9138,16607,14176,113422,1504,878,16226,258342,7668,60854,259846,-4521,95479,50945,4270,601,8546,23695,3055,2454,101928,2017
10,"Bedford, VA*",1132115,90225,135790,117540,2077484,-7265,-9613,148995,3502046,148879,44551,3494781,1094364,676634,740663,78445,10203,139266,194560,30585,20382,798289,2017
11,"Bland, VA",130568,9349,22180,14244,116980,149,-280,16471,223396,9758,35143,223545,2883,36133,70432,6361,716,9478,29302,2818,2102,91788,2017
12,"Botetourt, VA",640071,47101,78586,67192,989117,-2105,-3787,80697,1609968,64986,48205,1607863,429743,298501,320245,33355,4212,61199,112182,15316,11104,466690,2017
13,"Brunswick, VA",206450,16869,30347,22838,255529,1579,-807,28288,515653,11014,31211,517232,77367,79998,181705,16572,1311,10207,41766,5457,4146,154477,2017
14,"Buchanan, VA",432546,34451,61730,46764,328627,-301,-370,57833,719851,30910,33279,719550,-46086,86332,304591,21622,1263,30540,85112,8352,7089,316894,2017
15,"Buckingham, VA",202651,15915,31409,20682,269251,202,-1224,26256,488411,21838,28664,488613,92856,72378,146984,17046,1554,20614,41750,5126,3572,140287,2017
16,"Campbell + Lynchburg, VA*",4369412,281165,516008,495288,2603951,-145,-2742,528809,4844581,177108,35619,4844436,-1236652,848294,1392191,136007,13241,174366,763652,88979,75738,3431394,2017
17,"Caroline, VA",365672,27214,55266,38594,793696,542,-1876,46511,1259303,35590,41386,1259845,474535,217644,248505,30441,3198,33714,74563,9498,6300,257395,2017
18,"Carroll + Galax, VA*",608087,47070,83352,66012,627196,3804,1084,80076,1228362,58676,33923,1232166,99185,180183,424787,36322,3741,59760,116358,16911,13170,431969,2017
19,"Charles City, VA",116788,8878,14150,12272,174719,3716,2170,15014,310426,8887,44724,314142,72945,65507,73916,7024,750,11057,20286,2623,1873,85445,2017
20,"Charlotte, VA",168408,13936,24891,16656,205264,-1630,-3897,22264,412102,25868,33985,410472,59120,68589,136619,12078,1728,21971,33219,5009,3281,113218,2017
21,"Chesapeake (Independent City), VA",6266367,392287,755128,701518,7899938,6051,370,743046,11707591,338298,48722,11713642,2376617,2008850,1804854,240416,25680,338668,1105887,133277,107597,4821812,2017
22,"Chesterfield, VA",9440773,595388,1094803,1012512,12191519,1379,217,1101644,17916430,814721,52162,17917809,3852390,3179991,2546299,343500,42936,814938,1601059,188769,145833,7024776,2017
23,"Clarke, VA",293428,20290,29787,28814,563869,2552,-2475,34697,910444,53762,63105,912996,305138,230468,118659,14468,2709,51287,44194,7089,4380,197947,2017
24,"Craig, VA",42853,4302,6169,4036,101303,-1439,-2098,6320,188343,7931,36865,186904,64770,33822,51779,5070,658,5833,8187,1428,770,28833,2017
25,"Culpeper, VA",1069650,70401,127080,106522,1509795,1601,-5469,123662,2291411,162560,44732,2293012,563807,397693,385524,51261,6811,157091,180341,23634,16823,732218,2017
26,"Cumberland, VA",93160,7795,11966,7990,208246,7749,6397,11790,350041,16486,36361,357790,126876,51847,97697,9840,1058,22883,15961,2578,1520,54316,2017
27,"Dickenson, VA",194538,17498,31106,20852,192224,-421,-500,27924,444976,10694,30184,444555,25610,49974,202357,14728,726,10194,41532,4350,3624,142812,2017
28,"Dinwiddie, Colonial Heights + Petersburg, VA*",1755530,119432,235693,198896,1565858,-892,-2336,218880,2944313,69940,38213,2943421,29208,469333,908230,77026,6562,67604,335141,40908,34346,1352785,2017
29,"Essex, VA",192075,14728,24718,20648,231230,-3806,-4885,25052,446709,21350,40411,442903,64207,93031,118642,10960,1371,16465,35042,5387,4016,140568,2017
30,"Fairfax, Fairfax City + Falls Church, VA*",76867292,4655226,7047066,8267188,64783278,9664,7136,8788820,93459161,4957890,78751,93468825,-3295194,22400637,6284910,1186893,191361,4965026,11180660,905772,714411,60721606,2017
31,"Fauquier, VA",1777668,112920,185442,170460,3114083,5792,-9175,198150,4726982,326359,68044,4732774,1534565,1133108,485583,69555,12236,317184,270672,36419,24183,1189812,2017
32,"Floyd, VA",169245,14924,21880,16756,316216,-1205,-5584,23302,577763,33045,36530,576558,170273,110671,149671,15783,2592,27461,30258,6167,3575,111526,2017
33,"Fluvanna, VA",289832,23628,38801,26452,703493,-2088,-2791,36854,1148065,55772,43217,1145977,450515,232305,210179,26517,3092,52981,52027,7617,4525,184824,2017
34,"Franklin, VA",826457,65373,101165,84588,1199021,3460,-2443,107667,2215501,122110,39384,2218961,480231,475331,544609,56341,6736,119667,143459,22931,16195,563331,2017
35,"Frederick + Winchester, VA*",3903280,241270,466382,411476,3736772,-1530,-6727,447008,5611740,405871,48905,5610210,280500,1022149,851289,114716,14078,399144,672120,74537,60459,2832016,2017
36,"Giles, VA",276158,21630,38914,29312,355558,-549,-1169,36286,634609,25129,37834,634060,115686,98648,179854,16759,1656,23960,53570,6590,4934,198628,2017
37,"Gloucester, VA",514625,39241,69460,51616,1121272,1102,334,65049,1795798,62093,48133,1796900,671696,336220,339408,37332,3956,62427,95268,14075,10119,356930,2017
38,"Goochland, VA",2050560,125595,167281,205160,1276959,-4092,-6115,228175,2222628,102046,96909,2218536,-545426,740151,201426,22893,4490,95931,269861,21602,17112,1684768,2017
39,"Grayson, VA",140823,14772,24774,14668,230496,-9730,-11781,22106,482730,23596,30129,473000,111779,73679,168825,15699,2036,11815,32108,5168,3132,96900,2017
40,"Greene, VA",249286,18484,26108,21414,541199,579,-589,29191,840873,66028,42914,841452,321104,151230,149023,19608,2415,65439,36815,6450,4035,147032,2017
41,"Greensville + Emporia, VA*",413213,27213,62739,47038,279747,2763,1576,50732,517308,5135,30519,520071,-82734,67354,172970,17041,1250,6711,86258,9623,8373,320244,2017
42,"Halifax, VA",671776,49998,96850,73430,607636,-1567,-5852,86713,1199798,54239,34639,1198231,22573,198803,391792,34592,3366,48387,133565,16366,13000,489824,2017
43,"Hampton (Independent City), VA",4479176,258235,741831,540854,3242673,0,0,528662,5511596,117003,40825,5511596,-707841,1003349,1265574,135007,12279,117003,1012258,77128,64849,3349915,2017
44,"Hanover, VA",3419406,216090,353428,354984,4233515,8658,-141,393582,6186168,400672,58592,6194826,1207691,1159571,801740,105729,15314,400531,530920,70445,55131,2487955,2017
45,"Henrico, VA",17670838,1046430,1519107,1628524,14677821,1732,372,1860692,20860034,3764609,63601,20861766,-1132325,3787498,2396447,328008,45561,3764981,2333369,252963,207402,11572488,2017
46,"Henry + Martinsville, VA*",1260140,95952,168445,135644,1155579,7502,6575,163774,2349755,104322,36719,2357257,59213,385832,815846,64197,5192,110897,236267,31552,26360,912976,2017
47,"Highland, VA",32117,2513,4430,2614,32913,5456,4650,3820,88783,3448,42546,94239,4616,35671,25655,2215,663,8098,5737,1256,593,18282,2017
48,"Isle of Wight, VA",732323,51476,84413,74278,1308211,3736,1681,88615,1949229,61343,53130,1952965,664503,309204,335550,36758,4229,63024,121552,15933,11704,547747,2017
49,"James City + Williamsburg, VA*",2593123,172285,320535,274112,3163844,-4259,-5017,309341,5765525,248196,63717,5761266,880062,1734839,862583,90419,11948,243179,457591,57938,45990,1892353,2017
50,"King George, VA",1365232,74830,241319,157968,934355,-449,-1000,153814,1377998,70746,52221,1377549,-277063,275557,167637,26379,2621,69746,320303,15410,12789,975183,2017
51,"King William, VA",265126,19165,30477,27354,505510,-47,-807,32842,763436,31399,45695,763389,273226,124072,133807,16706,1883,30592,44154,6160,4277,190380,2017
52,"King and Queen, VA",73829,6451,9154,7074,174500,1306,85,9988,289261,13041,41450,290567,110659,47029,69038,7010,817,13126,12691,1981,1164,48012,2017
53,"Lancaster, VA",266234,20876,29943,26714,219660,296,-181,34233,617068,37096,57568,617364,-12341,248593,149111,10724,1986,36915,43300,6904,4918,186019,2017
54,"Lee, VA",244591,22567,43663,25258,303476,-4227,-5310,35196,674179,27007,27992,669952,94081,83482,282994,23934,2361,21697,56292,7132,4771,166602,2017
55,"Loudoun, VA",15195627,894124,1487783,1570984,24031218,8308,-6523,1679616,30265376,1419374,76219,30273684,10515207,4717275,1525191,397192,60013,1412851,2273275,237388,177375,11509501,2017
56,"Louisa, VA",720919,49646,94847,74150,912020,-761,-2525,86721,1507220,78194,42076,1506459,277822,280609,313830,35803,4366,75669,131922,14728,10362,513328,2017
57,"Lunenburg, VA",140816,11845,21632,14620,188152,579,-1842,19155,385601,11982,31262,386180,66491,74505,123523,12353,1214,10140,28942,4104,2890,101734,2017
58,"Madison, VA",212708,15823,22254,19068,366768,-1556,-4998,25357,620647,58767,46837,619091,179417,140720,111603,13218,2325,53769,31788,5760,3435,127151,2017
59,"Mathews, VA",93893,9138,10476,7550,232836,860,802,12913,468778,28163,53957,469638,151856,132175,104627,8704,1374,28965,14251,3003,1629,50677,2017
60,"Mecklenburg, VA",586697,44958,79283,64690,517739,2500,-3608,77303,1081456,38643,35302,1083956,8345,206675,359542,30705,3032,35035,111628,15374,12342,440034,2017
61,"Middlesex, VA",211174,16378,28064,19116,240137,1179,-194,25936,522702,37379,49358,523881,54899,152067,131677,10614,1720,37185,37622,5478,3758,136367,2017
62,"Montgomery + Radford, VA*",3231357,190231,523667,339294,2484017,4234,570,359878,4078167,213510,35284,4082401,-387462,912955,685429,115700,10882,214080,693314,64532,53650,2323963,2017
63,"Nelson, VA",238076,19252,28826,21738,363625,3563,156,30121,719164,47293,48833,722727,155670,192616,166486,14800,2494,47449,39695,6655,4161,150932,2017
64,"New Kent, VA",279061,21135,32501,25826,1101481,-1663,-1918,34048,1501551,58221,69346,1499888,856468,222647,175760,21629,3172,56303,45414,7728,4556,177344,2017
65,"Newport News (Independent City), VA",7745425,443578,1121380,904052,4511555,0,0,895604,7219257,251913,40165,7219257,-2338266,1220312,1487390,179738,16818,251913,1573406,124759,107941,5920106,2017
66,"Norfolk (Independent City), VA",14507789,758972,2442971,1824954,5346318,0,0,1671449,9496221,200147,38775,9496221,-7490022,2207305,1942598,244908,23164,200147,3355448,215589,192425,10952194,2017
67,"Northampton, VA",258915,16728,29352,24994,315404,42414,28262,29225,555894,30150,50418,598308,85714,129616,153288,11867,1832,58412,41849,6534,4702,158654,2017
68,"Northumberland, VA",168959,15780,20538,16698,233868,2209,1168,24129,607118,28021,49660,609327,89038,213772,161687,12270,1819,29189,28887,4477,2658,110883,2017
69,"Nottoway, VA",318643,21575,59597,36508,232637,11549,8991,39829,500342,6150,33156,511891,-46177,98573,180681,15439,1404,15141,77851,7422,6018,225651,2017
70,"Orange, VA",600829,43077,73560,57716,1029917,25470,13241,71935,1698213,86822,48038,1723683,501023,365723,328043,35882,4430,100063,102418,14867,10437,398348,2017
71,"Page, VA",332082,25434,41805,33764,487707,28096,24831,42316,847034,41807,36769,875130,197941,152033,235390,23801,2684,66638,58687,8803,6119,206757,2017
72,"Patrick, VA",240257,20248,34192,25108,280323,2718,620,32802,568952,27634,32249,571670,72868,93220,198127,17727,2072,28254,46746,7394,5322,165257,2017
73,"Pittsylvania + Danville, VA*",2041758,150236,273386,226948,1885403,14561,5017,263710,3631105,116640,35598,3645666,107355,551030,1209233,102412,9735,121657,386860,51198,41463,1533241,2017
74,"Portsmouth (Independent City), VA",4069708,222431,791160,495110,2092282,0,0,469986,3629574,76832,38221,3629574,-1507440,605579,931713,94964,8400,76832,1038715,60618,52218,2954161,2017
75,"Powhatan, VA",470000,33512,56999,44104,1076257,530,-365,55564,1584770,78977,55195,1585300,661821,289617,219426,28722,4049,78612,79051,11782,7733,312337,2017
76,"Prince Edward, VA",502174,33181,73718,54186,363176,2625,1481,60274,689664,36374,30500,692289,-78724,123006,206107,22698,2057,37855,100811,12121,10064,363508,2017
77,"Prince George + Hopewell, VA*",2432544,128068,451774,303334,1276832,-1579,-2079,279735,2200936,46698,36304,2199357,-875977,392772,529753,60582,4308,44619,603441,37106,32798,1784484,2017
78,"Prince William, Manassas + Manassas Park, VA*",12492824,735712,1463248,1303200,20543447,-2421,-5634,1387312,27711185,1546119,53104,27708764,9437935,4453329,2711988,521780,68448,1540485,2114848,241305,172857,8837491,2017
79,"Pulaski, VA",746066,52975,104226,81218,711672,1417,-269,93584,1288620,52372,37660,1290037,59190,204081,374284,34255,2863,52103,144835,16656,13793,549128,2017
80,"Rappahannock, VA",152309,11373,13471,11060,233617,-2597,-4741,16903,454706,43642,61022,452109,98211,151512,66980,7409,1965,38901,19001,3766,1801,94407,2017
81,"Richmond (Independent City), VA",13815164,796343,1693533,1424880,7011758,0,0,1508783,11933735,1225326,52428,11933735,-5294623,3006185,1915792,227620,30126,1225326,2405973,197122,166996,10183865,2017
82,"Richmond, VA",168761,11503,27027,17482,166010,3474,785,20244,312942,11015,35624,316416,17493,71466,78940,8882,1011,11800,35768,4144,3133,121193,2017
83,"Roanoke (Independent City), VA",4516751,278506,546129,524192,2164808,0,0,540602,4020316,265384,40614,4020316,-1811341,814550,1040958,98989,9622,265384,808225,81197,71575,3443142,2017
84,"Roanoke + Salem, VA*",3940031,255194,488435,413046,3694620,-472,-1399,461717,5926289,404602,49687,5925817,216306,1137035,1094162,119262,13444,403203,694958,75903,62459,2841870,2017
85,"Rockbridge, Buena Vista + Lexington, VA*",771421,54178,101114,84424,709263,664,-1828,96390,1400532,88115,38517,1401196,34232,362827,329106,36379,4767,86287,143326,19424,14657,541808,2017
86,"Rockingham + Harrisonburg, VA*",4072057,241448,490325,404818,3262892,172234,148996,443857,4944744,425419,38114,5116978,-365308,956346,897740,134255,16412,574415,692734,85321,68909,2804908,2017
87,"Russell, VA",417372,34747,55803,48514,416382,2,-2201,59004,846363,23432,31284,846365,58014,112611,317372,27054,2399,21231,80060,9966,7567,316081,2017
88,"Scott, VA",243428,23147,35462,26634,338197,-2408,-3183,36464,688172,24162,31318,685764,131233,97699,249868,21897,2523,20979,48779,7573,5050,173670,2017
89,"Shenandoah, VA",821895,58514,99627,82854,1091915,16816,12571,99941,1816848,106425,42329,1833664,369961,345419,396330,43319,5657,118996,141054,20481,14824,561845,2017
90,"Smyth, VA",650801,47340,100710,69364,567045,999,-1124,82022,1075823,44407,34994,1076822,-1734,155373,354404,30772,2977,43283,135392,15945,12968,472126,2017
91,"Southampton + Franklin, VA*",421467,30537,65184,43544,551429,10007,4996,52309,1022922,28745,39731,1032929,182271,201019,280481,25998,2521,33741,86956,11105,8584,300770,2017
92,"Spotsylvania + Fredericksburg, VA*",3782103,239219,433786,396784,5320048,1392,-350,437611,7946295,388885,49179,7947687,1975556,1465187,1162452,161607,19415,388535,632178,84148,64733,2761390,2017
93,"Stafford, VA",3345379,201913,467333,357716,5604219,-3022,-3549,380771,7836469,239107,53337,7833447,2639611,1298240,930988,146868,15934,235558,646191,62993,47059,2463630,2017
94,"Suffolk (Independent City), VA",2172822,138052,277323,237980,2905176,19256,6791,257042,4498967,164413,50076,4518223,989396,816451,796596,90228,9725,171204,396313,42715,32990,1605305,2017
95,"Surry, VA",254691,15463,43745,28228,169642,49,-892,29577,275842,4858,42393,275891,-55472,38926,67323,6508,711,3966,57859,3276,2565,192866,2017
96,"Sussex, VA",203157,14056,32284,21972,177215,1338,-311,25042,331699,8966,29293,333037,-900,49331,106491,11369,868,8655,43270,4711,3843,151232,2017
97,"Tazewell, VA",813392,61392,115898,87120,744886,3550,2336,104952,1483300,72270,35947,1486850,36446,237638,504326,41362,3526,74606,159458,19444,15918,579328,2017
98,Virginia,322968435,19638663,37881106,34821992,306338411,514932,198726,37049659,466922719,26670599,55181,467437651,20419635,96852878,64246362,8471011,1077432,26869325,55292102,5229033,4151601,240807008,2017
99,"Virginia Beach (Independent City), VA",13828256,804832,1802447,1532304,15857085,-2722,-4627,1570984,25124692,1394983,55775,25121970,3599813,5828296,3436589,450417,58104,1390356,2568599,272430,214326,9869301,2017
100,"Warren, VA",735421,49905,91177,79628,1177619,-1565,-2500,89719,1752668,76859,44356,1751103,531917,270105,303379,39478,4603,74359,130991,17820,13217,530071,2017
101,"Washington + Bristol, VA*",1648905,117147,225691,177062,1381277,3098,-872,205678,2728899,145289,38393,2731997,-61950,587439,763281,71158,8414,144417,314222,39983,31569,1190266,2017
102,"Westmoreland, VA",198546,16208,26134,18638,370712,22393,16348,25527,725344,23603,42190,747737,197693,189245,187780,17723,2185,39951,35453,6103,3918,123142,2017
103,"Wise + Norton, VA*",801864,60244,126820,89536,597109,-513,-630,105012,1296573,37445,30481,1296060,-99743,171940,527011,42520,2694,36815,171588,18978,16284,593461,2017
104,"Wythe, VA",607859,43302,87231,65274,514079,4030,815,75939,967103,48115,33682,971133,-17841,148492,308562,28832,3238,48930,119868,15559,12321,439061,2017
105,"York + Poquoson, VA*",1522165,99388,201696,167418,2964489,1552,555,183097,4573197,142430,57072,4574749,1625421,1022521,587739,80158,8268,142985,285405,35254,26986,1093775,2017
0,"Accomack, VA",1048492,64186,164864,118196,809850,26915,20098,123284,1487331,59456,46445,1514246,-115358,332528,371868,32603,3924,79554,223962,19890,15966,744976,2018
1,"Albemarle + Charlottesville, VA*",8371238,492131,1084544,828344,6101827,-7375,-19402,906303,11664297,917181,74603,11656922,-1363108,4446318,1108777,156253,28194,897779,1498716,134520,106326,5974743,2018
2,"Alexandria (Independent City), VA",10595890,610440,1228993,1163500,9835738,0,0,1192190,13899351,846872,87761,13899351,432038,3180275,883338,158377,27685,846872,1810743,126029,98344,7938275,2018
3,"Alleghany + Covington, VA*",496378,37511,65000,57372,407335,-702,-1125,66197,805813,19775,38939,805111,-22846,132979,264797,20676,1476,18650,93686,9736,8260,384042,2018
4,"Amelia, VA",163803,13105,18791,14736,341554,12648,8127,20473,539668,26149,42496,552316,198224,76348,134414,12997,1803,34276,26159,4599,2796,103368,2018
5,"Amherst, VA",470945,38165,66059,49602,649675,-2286,-3225,62966,1165526,36607,36613,1163240,241696,184684,328881,31771,2947,33382,90860,11668,8721,346703,2018
6,"Appomattox, VA",169310,15710,24283,16322,349110,-3133,-4148,23871,608706,20554,38149,605573,203671,89762,166701,15874,1857,16406,32444,5401,3544,120460,2018
7,"Arlington, VA",24441065,1366746,2815553,2675786,16352972,0,0,2704639,22485727,1213255,95012,22485727,-5383454,5067199,1065556,236662,36632,1213255,4153446,237177,200545,19074364,2018
8,"Augusta, Staunton + Waynesboro, VA*",3130258,214899,395684,317810,3161889,27143,17929,373804,5304302,318968,43388,5331445,405435,998711,1170845,122879,14320,336897,554589,65922,51602,2238772,2018
9,"Bath, VA",128767,9007,17256,13294,109434,1246,639,15654,262698,6488,61741,263944,-3679,101694,52816,4275,600,7127,23903,3029,2429,97737,2018
10,"Bedford, VA*",1168381,96408,141752,121534,2139277,-8838,-11100,157175,3650546,147220,46031,3641708,1128071,722233,780198,79115,10543,136120,202519,31222,20679,829742,2018
11,"Bland, VA",136749,9977,23328,14570,119220,-148,-562,17262,228392,8895,36258,228244,-267,36125,72899,6295,713,8333,30613,2864,2151,97803,2018
12,"Botetourt, VA",685761,51446,83449,72158,1013934,-4208,-5822,87525,1672629,60772,49935,1668421,415698,318177,336310,33412,4329,54950,119528,15913,11584,511283,2018
13,"Brunswick, VA",190272,16701,29444,20766,249652,-400,-2689,27084,515665,8960,31633,515265,86464,79315,186298,16289,1415,6271,39827,5377,3962,144174,2018
14,"Buchanan, VA",455573,36888,65058,47524,342172,-331,-398,60650,742531,30806,34726,742200,-52751,88777,311251,21373,1271,30408,88820,8422,7151,336345,2018
15,"Buckingham, VA",205126,16674,32398,20474,276489,586,-790,26911,500962,20887,29430,501548,98274,72292,152767,17042,1600,20097,42635,5174,3574,142394,2018
16,"Campbell + Lynchburg, VA*",4550305,293419,537636,508436,2718347,-2367,-4861,547637,5039675,188529,36870,5037308,-1284321,884231,1434730,136622,13802,183668,791854,90667,76865,3574783,2018
17,"Caroline, VA",371269,28722,57817,38890,811927,-1548,-3873,48167,1296131,33056,42078,1294583,488825,221795,260861,30766,3192,29183,77262,9638,6446,264824,2018
18,"Carroll + Galax, VA*",606751,48999,83820,64726,639120,366,-2245,81362,1266808,56359,35078,1267174,113731,188434,439620,36124,3789,54114,116183,16587,12798,436454,2018
19,"Charles City, VA",120536,9516,14593,12532,172147,2648,1156,15782,316046,8907,45639,318694,67393,69294,77253,6983,745,10063,20859,2624,1879,89614,2018
20,"Charlotte, VA",163335,14266,24929,16178,202344,-2522,-4698,22355,415275,22229,34668,412753,61364,70582,139827,11906,1662,17531,33018,4847,3185,112786,2018
21,"Chesapeake (Independent City), VA",6564439,414743,793396,726824,7956060,5599,143,778155,11862332,348981,48890,11867931,2169776,1997658,1914213,242748,26547,349124,1156808,136139,109592,5058507,2018
22,"Chesterfield, VA",9865540,630213,1148237,1045190,12586420,887,-231,1152808,18639962,812847,53458,18640849,3873688,3338064,2716365,348704,44725,812616,1670832,193665,148940,7382092,2018
23,"Clarke, VA",292603,20995,30679,28312,578868,1251,-3574,35151,932550,53444,64325,933801,321416,227971,126962,14517,2744,49870,44835,7037,4293,197898,2018
24,"Craig, VA",43483,4618,6503,4038,105139,-1831,-2460,6637,196605,8197,38154,194774,68293,35836,53799,5105,633,5737,8522,1425,792,29224,2018
25,"Culpeper, VA",1111613,74642,132804,109528,1573447,190,-6601,129406,2398624,168966,46323,2398814,591240,414508,410859,51785,6918,162365,187568,23994,17076,761680,2018
26,"Cumberland, VA",87992,8061,11623,7358,210778,6172,4872,11740,356277,16633,36748,362449,134526,50791,100880,9863,1046,21505,15302,2476,1430,51185,2018
27,"Dickenson, VA",198303,18556,32421,20334,195647,-538,-616,28723,459367,9919,31639,458829,26067,55116,208066,14502,701,9303,42588,4294,3593,146412,2018
28,"Dinwiddie, Colonial Heights + Petersburg, VA*",1817614,125850,243804,205498,1586713,-4061,-5454,228599,3000396,63160,39061,2996335,-2302,469916,939706,76710,6725,57706,346553,41545,34820,1413355,2018
29,"Essex, VA",187547,15262,24728,20210,230585,-6879,-7913,25367,456580,20445,41299,449701,68405,94712,124404,10889,1372,12532,34833,5306,3934,140182,2018
30,"Fairfax, Fairfax City + Falls Church, VA*",81092029,4902196,7413010,8574376,67982475,7472,5036,9189384,98412510,5487036,82888,98419982,-3920170,23754704,6682803,1187385,197205,5492072,11700198,929138,731933,63899759,2018
31,"Fauquier, VA",1863056,120716,195175,174472,3245031,918,-13458,207952,4942899,338340,69905,4943817,1589927,1178147,520639,70722,12617,324882,282411,37379,24762,1255763,2018
32,"Floyd, VA",179232,16374,23171,17260,337177,-2663,-6873,25004,608723,35357,38387,606060,182949,111932,156951,15788,2673,28484,31801,6425,3752,118947,2018
33,"Fluvanna, VA",305441,25781,40271,27824,730694,-2106,-2784,39693,1207044,57198,44742,1204938,464946,250894,223350,26931,3294,54414,54183,7922,4628,196844,2018
34,"Franklin, VA",846665,69818,105328,86304,1216939,-2909,-8582,112970,2283588,118481,40512,2280679,483244,494120,569620,56297,6878,109899,148480,23285,16407,588286,2018
35,"Frederick + Winchester, VA*",4078193,254969,490464,423356,3899993,-7328,-12327,466647,5852132,425612,50271,5844804,288447,1042468,902343,116267,14426,413285,702142,76227,61801,2962766,2018
36,"Giles, VA",290116,23333,40597,30412,372267,-1427,-2027,38539,662358,24903,39273,660931,120690,101938,186726,16829,1692,22876,55803,6690,4998,211437,2018
37,"Gloucester, VA",534537,42152,72537,53446,1111096,754,12,68875,1818077,61518,48634,1818831,645434,348301,359434,37398,4033,61530,99260,14392,10359,373747,2018
38,"Goochland, VA",2097285,128532,175537,204732,1312574,-5481,-7431,230898,2331176,111835,99291,2325695,-553813,789069,224052,23423,4717,104404,277903,22082,17365,1714978,2018
39,"Grayson, VA",140191,15800,25897,14620,232627,-13946,-15920,23110,501848,22564,31234,487902,115546,80324,174951,15621,2011,6644,33207,5265,3254,100340,2018
40,"Greene, VA",253470,19645,27058,21408,578865,17,-1110,30349,888279,67621,45048,888296,355744,150417,159014,19719,2461,66511,37762,6458,3997,149197,2018
41,"Greensville + Emporia, VA*",414635,27940,64237,46042,278220,66,-1074,50961,523636,5787,31217,523702,-85454,67462,178020,16776,1224,4713,87258,9527,8303,322664,2018
42,"Halifax, VA",672212,51807,97088,71624,613370,-3737,-7850,87619,1218645,51985,35511,1214908,28777,195903,405635,34212,3423,44135,132900,16104,12681,495177,2018
43,"Hampton (Independent City), VA",4465642,261118,745419,535568,3261397,0,0,528902,5552548,118573,41191,5552548,-675343,978438,1312713,134800,12549,118573,1013203,77373,64824,3333866,2018
44,"Hanover, VA",3560325,227204,370472,365716,4363351,8359,-94,410062,6407660,428164,60063,6416019,1213088,1199140,853528,106821,15919,428070,553330,72748,56829,2578925,2018
45,"Henrico, VA",18049377,1077843,1560747,1645088,15097194,1421,111,1900387,21579359,3869615,65413,21580780,-1051796,3952044,2531542,329917,47378,3869726,2383291,254114,206736,11796360,2018
46,"Henry + Martinsville, VA*",1299290,101086,175693,137290,1189564,8697,7809,169731,2406148,99607,37923,2414845,60005,387675,837606,63677,5039,107416,244338,31682,26643,947536,2018
47,"Highland, VA",30341,2662,4489,2502,31285,4032,3252,3913,88698,3258,42035,92730,4857,34797,26648,2206,674,6510,5740,1245,571,18091,2018
48,"Isle of Wight, VA",735669,53599,83203,74224,1322310,2541,563,90711,2006864,50849,54012,2009405,677352,330658,356437,37203,4339,51412,120315,15767,11428,563942,2018
49,"James City + Williamsburg, VA*",2653497,180154,332430,282294,3105075,-4625,-5354,321301,5768384,217750,63189,5763759,772879,1738329,920355,91215,12221,212396,473577,58991,46770,1967524,2018
50,"King George, VA",1406733,77594,255358,162068,953906,-495,-1026,158628,1410396,62867,52859,1409901,-294199,278382,177613,26673,2577,61841,336392,15608,13031,1008500,2018
51,"King William, VA",269769,20255,31862,28058,518941,-1840,-2571,34284,788060,27354,46352,786220,283456,126188,141091,16962,1934,24783,45891,6291,4357,199095,2018
52,"King and Queen, VA",74476,6873,9567,7082,180220,155,-1022,10414,300189,13334,42705,300344,116158,47962,72162,7033,760,12312,13108,1968,1208,49056,2018
53,"Lancaster, VA",269146,21872,30624,26502,224390,-568,-1028,35123,620735,37380,58003,620167,-9633,240490,155287,10692,1978,36352,43875,6906,4928,188919,2018
54,"Lee, VA",239440,23634,43325,24490,304944,-6014,-7060,35879,692320,27504,28954,686306,101383,89232,292130,23703,2326,20444,55570,7002,4676,163426,2018
55,"Loudoun, VA",16377021,961559,1598666,1638896,25580339,5569,-8680,1781007,32179387,1563510,79280,32184956,10984325,4936767,1667850,405964,63490,1554830,2418114,246582,183092,12404077,2018
56,"Louisa, VA",766841,53885,99109,77866,960119,-684,-2376,92818,1593208,81447,43445,1592524,286096,298802,333603,36656,4611,79071,138042,15034,10423,549728,2018
57,"Lunenburg, VA",140434,12462,22353,14474,188799,-1458,-3778,19699,391809,11215,31847,390351,68064,74164,127388,12257,1229,7437,29590,4102,2873,103407,2018
58,"Madison, VA",187351,15249,22345,18152,356674,-4205,-7516,24325,621143,39681,46745,616938,193648,143641,116623,13198,2536,32165,31421,5871,3335,123765,2018
59,"Mathews, VA",99284,10010,11126,7962,235392,807,750,13991,479325,28783,54772,480132,150099,135924,108816,8766,1377,29533,15107,3087,1710,54644,2018
60,"Mecklenburg, VA",598944,47543,81250,64666,527598,-3443,-9315,79876,1114277,43580,36175,1110834,8530,210363,372873,30707,3072,34265,113583,15494,12422,451096,2018
61,"Middlesex, VA",207974,16994,28310,19164,239284,771,-543,26576,538989,32024,50365,539760,57886,163042,137434,10717,1734,31481,37892,5365,3631,138601,2018
62,"Montgomery + Radford, VA*",3382697,201633,547106,347206,2608027,2335,-1195,375236,4304427,223184,36906,4306762,-399434,976615,722120,116694,11188,221989,720709,64692,53504,2439999,2018
63,"Nelson, VA",245703,20742,30787,22500,357896,1875,-1405,31992,744178,46068,50287,746053,144185,211697,176460,14836,2600,44663,42037,6841,4241,159003,2018
64,"New Kent, VA",294411,23089,34577,27232,1217752,-2700,-2947,36705,1644699,60753,73715,1641999,960046,234261,189986,22275,3393,57806,48193,8138,4745,188412,2018
65,"Newport News (Independent City), VA",8110823,465738,1184661,935202,4454791,0,0,933339,7217889,256042,40345,7217889,-2722693,1215433,1547665,178904,17534,256042,1652262,130190,112656,6202519,2018
66,"Norfolk (Independent City), VA",13644651,744246,2243362,1667380,5299188,0,0,1577936,9342405,110736,38262,9342405,-6767527,2033600,2009617,244168,23922,110736,3077052,201340,177418,10456863,2018
67,"Northampton, VA",246636,16625,28748,21988,333552,46047,32458,27619,577825,26700,52920,623872,114535,129319,161001,11789,1927,59158,39742,6437,4510,147736,2018
68,"Northumberland, VA",182378,17404,22628,18110,246515,635,-362,26459,617910,27719,50817,618545,90596,203769,168261,12172,1780,27357,31683,4530,2750,123338,2018
69,"Nottoway, VA",326672,22739,62356,37176,236513,9006,6551,41327,509682,5396,33723,518688,-48832,96589,185586,15381,1433,11947,80944,7626,6193,233781,2018
70,"Orange, VA",611890,45483,76152,57744,1069756,24178,12431,74355,1774206,85430,49109,1798384,532221,377624,351004,36620,4513,97861,105024,15050,10537,409005,2018
71,"Page, VA",338731,27193,43659,34830,502970,24271,21130,44608,881014,38372,37712,905285,208847,158319,243996,24005,2718,59502,61074,8932,6214,218155,2018
72,"Patrick, VA",235055,20960,33709,23850,282021,1981,-38,32885,579746,26770,32942,581727,79851,94061,205645,17659,2129,26732,45634,7219,5090,162689,2018
73,"Pittsylvania + Danville, VA*",2113256,159516,280205,230718,1945848,7101,-2081,274875,3738236,115868,36858,3745337,107467,544509,1254980,101615,9563,113787,395564,50890,41327,1603905,2018
74,"Portsmouth (Independent City), VA",4103703,229783,792930,485554,2112302,0,0,472560,3664519,100455,38623,3664519,-1518841,588971,963246,94879,8656,100455,1035707,60714,52058,2967541,2018
75,"Powhatan, VA",479551,35350,57118,45966,1116304,43,-821,58333,1671524,76656,57247,1671567,695086,321538,233725,29199,4256,75835,80101,12198,7942,323615,2018
76,"Prince Edward, VA",513574,34572,77122,55694,363893,2301,1204,62419,698709,28493,30640,701010,-87262,122874,214243,22879,2080,29697,104969,12423,10343,378908,2018
77,"Prince George + Hopewell, VA*",2503602,132846,473538,306842,1300521,-3166,-3652,286267,2251369,44515,37053,2248203,-916814,393173,554509,60676,4359,40863,626959,36995,32636,1835780,2018
78,"Prince William, Manassas + Manassas Park, VA*",13144142,781254,1538304,1367624,21352524,-2506,-5603,1465066,28775121,1575692,54733,28772615,9673448,4531209,2888882,525694,73036,1570089,2222116,249351,176315,9351937,2018
79,"Pulaski, VA",824126,58899,112997,91954,749274,751,-867,104876,1347992,49722,39556,1348743,30024,211544,387925,34097,2928,48855,158974,17559,14631,616297,2018
80,"Rappahannock, VA",119790,9917,10646,8734,241323,-3537,-5601,14284,485979,47136,65434,482442,135817,171601,69518,7373,1914,41535,15013,3606,1692,63242,2018
81,"Richmond (Independent City), VA",13995024,825621,1754267,1450870,6987338,0,0,1551056,12132940,941696,52839,12132940,-5456630,3165381,1980221,229621,31511,941696,2479702,200153,168642,10573626,2018
82,"Richmond, VA",183711,12600,30449,18904,177484,2044,-536,22052,330528,10559,37026,332572,15825,71607,83481,8982,1012,10023,39901,4219,3207,133787,2018
83,"Roanoke (Independent City), VA",4643564,288001,560128,532804,2270926,0,0,554403,4173414,271169,42171,4173414,-1818235,829084,1073404,98964,9796,271169,826530,81560,71764,3545865,2018
84,"Roanoke + Salem, VA*",4018407,264382,503618,418750,3756078,-628,-1521,473757,6100929,385926,51078,6100301,211428,1198117,1146106,119432,13582,384405,712993,76226,62644,2921009,2018
85,"Rockbridge, Buena Vista + Lexington, VA*",780128,56489,104334,84276,716723,-2082,-4482,98627,1430835,85559,39023,1428753,35222,368929,343101,36613,4711,81077,146472,19529,14818,552579,2018
86,"Rockingham + Harrisonburg, VA*",4227209,256031,514470,414430,3383481,131493,109138,463246,5199734,461365,39471,5331227,-380482,1001296,946450,135068,16996,570503,721685,86458,69462,2935021,2018
87,"Russell, VA",416033,36228,56454,48362,423319,-1842,-3958,60409,877782,21250,32660,875940,67695,124666,327955,26820,2406,17292,80635,9888,7482,318106,2018
88,"Scott, VA",256118,25075,38187,27172,345248,-3808,-4553,38661,715785,25559,32915,711977,127791,108276,258453,21631,2482,21006,51773,7823,5341,183339,2018
89,"Shenandoah, VA",870876,63374,107494,85350,1151944,10712,6628,106049,1917009,111266,44352,1927721,387117,359953,415824,43464,5735,117894,150169,21136,15401,602813,2018
90,"Smyth, VA",647728,48906,102635,69622,563253,-3422,-5459,83717,1100502,35267,35959,1097080,-758,168273,365554,30509,2868,29808,137446,15829,12961,480474,2018
91,"Southampton + Franklin, VA*",423209,32038,66436,43650,562571,4455,-366,53863,1048112,26358,40813,1052567,193225,200229,289767,25790,2573,25992,88261,11270,8697,308956,2018
92,"Spotsylvania + Fredericksburg, VA*",3973683,254146,455952,413824,5543966,1059,-626,461058,8278124,395465,50610,8279183,2031341,1498449,1236768,163589,19764,394839,662864,85370,65606,2915980,2018
93,"Stafford, VA",3559051,216862,498100,376156,5884787,-4189,-4698,404940,8216333,250015,54787,8212144,2730676,1323093,1004264,149891,17025,245317,686178,65743,48718,2627556,2018
94,"Suffolk (Independent City), VA",2231688,144475,288164,244158,2960159,16885,4924,266554,4593687,141217,50591,4610572,995025,808600,841813,91135,10245,146141,410243,44258,34013,1675304,2018
95,"Surry, VA",281127,17272,46830,29508,172942,-1236,-2140,32026,283109,4555,43803,281873,-76159,38383,70548,6435,770,2415,61584,3405,2635,217128,2018
96,"Sussex, VA",202270,14480,32733,21662,176694,35,-1549,25311,338895,7829,30278,338930,-265,51961,110275,11194,931,6280,43564,4740,3809,152426,2018
97,"Tazewell, VA",844376,65314,119115,89178,765589,1802,627,109903,1520033,69926,36981,1521835,31116,236627,519619,41152,3485,70553,163704,19378,15893,610119,2018
98,Virginia,334435477,20565737,39168914,35490844,316992086,287856,-16156,38311159,484648971,27175205,56978,484936827,20867768,100361594,67583147,8510920,1111606,27159049,56914336,5298892,4187286,250362092,2018
99,"Virginia Beach (Independent City), VA",13756874,820580,1780859,1494560,15810698,-3910,-5741,1567860,25214658,1371838,55963,25210748,3621684,5780772,3619278,450488,59745,1366097,2528139,269425,209680,9862638,2018
100,"Warren, VA",786688,54085,97255,83666,1225031,-1945,-2843,95918,1831382,79769,45672,1829437,534261,284252,320154,40056,4719,76926,139088,18422,13703,570674,2018
101,"Washington + Bristol, VA*",1679991,122272,231926,176950,1417175,-1780,-5604,210747,2806587,153854,39541,2804807,-52069,591232,796400,70935,8425,148250,320401,40056,31631,1211340,2018
102,"Westmoreland, VA",205088,17724,26838,18540,386175,20430,14618,26994,752699,26142,43390,773129,208081,190164,196790,17818,2158,40760,36108,6075,3917,128220,2018
103,"Wise + Norton, VA*",819242,63390,129228,89872,611913,-702,-817,108326,1334276,42406,31879,1333574,-99003,176876,544785,41833,2687,41589,174164,18838,16151,603489,2018
104,"Wythe, VA",608575,45219,88044,64536,522410,-2700,-5790,77487,998955,49804,34762,996255,-8678,152372,321473,28659,3272,44014,120312,15448,12176,444249,2018
105,"York + Poquoson, VA*",1565472,104669,208629,169760,3005432,1436,479,189549,4664047,141455,58119,4665483,1629509,1038254,621797,80274,8472,141934,293509,35601,27129,1130029,2018
0,"Accomack, VA",1119986,67460,181644,129706,858335,25567,20126,132313,1580822,57189,49695,1606389,-129338,355088,392966,32325,3801,77315,246497,19926,16125,796174,2019
1,"Albemarle + Charlottesville, VA*",8516598,503727,1099244,847618,6196611,-1492,-11201,927536,11925057,861952,75885,11923565,-1392451,4541613,1185341,157126,27056,850751,1523053,136653,109597,6142794,2019
2,"Alexandria (Independent City), VA",10464576,610359,1205799,1148492,10129189,0,0,1184605,14296000,794110,89884,14296000,849218,3239706,927105,159050,26977,794110,1780045,124505,97528,7890421,2019
3,"Alleghany + Covington, VA*",501496,38180,65423,58456,412284,-444,-783,67408,821559,18452,40015,821115,-21804,131915,276916,20520,1424,17669,94651,9760,8336,389176,2019
4,"Amelia, VA",170244,13804,19010,15622,353626,12812,9223,21615,559980,24982,43865,572792,204997,78275,140891,13058,1813,34205,26821,4615,2802,109218,2019
5,"Amherst, VA",469950,38937,64076,49606,661161,-787,-1537,63740,1190613,35007,37560,1189826,254951,182621,346044,31678,2935,33470,88879,11571,8636,347601,2019
6,"Appomattox, VA",173150,16319,24220,16908,356267,-2546,-3399,24773,624064,20654,39084,621518,207890,88961,176290,15902,1757,17255,32674,5308,3551,123221,2019
7,"Arlington, VA",26118990,1456928,2994913,2799020,17124579,0,0,2856438,23390078,1412876,98116,23390078,-6137973,5132688,1132811,238392,35307,1412876,4394423,241448,206141,20311691,2019
8,"Augusta, Staunton + Waynesboro, VA*",3215529,223273,396442,331416,3267718,25425,17967,388981,5519631,319772,44917,5545056,441170,1037180,1240158,123452,13897,337739,562150,66458,52561,2315640,2019
9,"Bath, VA",135703,9449,17580,14588,114862,1488,999,16743,272339,6350,65682,273827,-4098,105319,53646,4169,594,7349,24874,2986,2392,103480,2019
10,"Bedford, VA*",1189208,100154,136570,122348,2180296,-5660,-7505,161328,3727551,147709,46857,3721891,1152416,722491,819104,79431,10292,140204,197744,30939,20647,851260,2019
11,"Bland, VA",138487,10278,22522,14820,120812,258,-91,17688,232125,8699,36933,232383,13,35741,75830,6292,668,8608,29932,2821,2153,99947,2019
12,"Botetourt, VA",731961,54930,86862,78130,1036106,-2306,-3588,93995,1711398,56513,51018,1709092,398140,319912,353074,33500,4283,52925,125927,16612,12329,553109,2019
13,"Brunswick, VA",198299,17557,29509,21816,255914,-792,-2600,28465,535511,8072,33056,534719,86080,81478,197327,16176,1360,5472,40417,5364,4004,152410,2019
14,"Buchanan, VA",495288,39893,62281,51070,367404,-296,-351,65428,773354,47883,36758,773058,-62456,87464,318190,21031,1106,47532,87816,8084,6978,359940,2019
15,"Buckingham, VA",213881,17509,32501,21530,284436,2029,925,28274,519497,20267,30438,521526,98829,74072,163018,17134,1553,21192,43266,5158,3605,149423,2019
16,"Campbell + Lynchburg, VA*",4670118,302204,531780,522744,2788659,57,-1971,563576,5169824,209356,37702,5169881,-1317883,891779,1489443,137124,13302,207385,793152,90810,77508,3669581,2019
17,"Caroline, VA",385963,30089,58319,40376,847477,2353,502,50277,1341030,33655,43694,1343383,511791,219950,275956,30745,3090,34157,78507,9712,6622,273299,2019
18,"Carroll + Galax, VA*",601741,49830,80197,64844,648234,648,-1446,82252,1291416,54536,35549,1292064,128745,182962,460868,36346,3657,53090,112619,16386,12729,436032,2019
19,"Charles City, VA",122030,9676,14366,12454,181328,4558,3364,15903,328231,9561,47753,332789,75201,70563,80898,6969,758,12925,20593,2587,1829,88512,2019
20,"Charlotte, VA",163439,14467,24165,16738,205157,-831,-2572,22836,423473,18742,35669,422642,64554,72017,145468,11849,1615,16170,32534,4766,3151,114735,2019
21,"Chesapeake (Independent City), VA",6844595,435812,802678,753614,8205304,5390,1074,812619,12266703,367816,50008,12272093,2173328,2023864,2042925,245403,26296,368890,1179485,137671,111375,5296220,2019
22,"Chesterfield, VA",10066532,650937,1133676,1062236,13109606,2177,1280,1182055,19455611,876338,55063,19457788,4225129,3438154,2910028,353376,45044,877618,1664794,193488,148444,7524120,2019
23,"Clarke, VA",303632,22004,30811,28680,606319,2828,-1001,36344,969580,58243,66713,972408,339031,234620,131469,14576,2606,57242,45151,6973,4367,201239,2019
24,"Craig, VA",45137,4865,6589,4202,107791,-1451,-1956,6966,200429,7876,38810,198978,69620,35685,55502,5127,642,5920,8690,1452,810,30527,2019
25,"Culpeper, VA",1169965,79429,133658,115120,1645902,3341,-2054,136989,2494940,183565,47386,2498281,612926,414541,437838,52722,6562,181511,191218,23843,17281,797236,2019
26,"Cumberland, VA",86337,8128,11270,7314,219094,6230,5192,11785,374119,15992,38161,380349,144542,52260,108995,9967,1028,21184,14927,2404,1376,50226,2019
27,"Dickenson, VA",209001,19685,31731,21944,205200,-354,-421,30657,479579,9635,33524,479225,26856,54857,219168,14295,703,9214,42703,4475,3772,157084,2019
28,"Dinwiddie, Colonial Heights + Petersburg, VA*",1856197,129819,238657,210662,1650933,-2502,-3632,235150,3112517,65660,40661,3110015,29886,477328,981754,76486,6963,62028,343988,41676,34713,1450181,2019
29,"Essex, VA",192916,15735,24431,20744,238063,-3699,-4518,26107,471169,18773,42746,467470,71254,97329,132078,10936,1289,14255,34803,5178,3889,143858,2019
30,"Fairfax, Fairfax City + Falls Church, VA*",86066941,5166567,7675958,8914642,71279737,14822,12854,9623888,102379618,6387410,86031,102394440,-5163316,24048682,7066021,1190204,189384,6400264,12133279,935200,745816,67533398,2019
31,"Fauquier, VA",1921075,125435,197482,177416,3380659,11507,97,214143,5116670,348058,71927,5128177,1673727,1189989,557529,71297,12218,348155,286190,36841,24623,1286730,2019
32,"Floyd, VA",186821,17322,23033,18394,345484,-1201,-4552,26519,621266,33726,39255,620065,185182,107035,167546,15796,2560,29174,32230,6400,3840,125417,2019
33,"Fluvanna, VA",321422,27505,40718,29124,752406,-975,-1511,42067,1246102,60048,45666,1245127,473051,252520,240201,27266,3196,58537,55280,7873,4677,207605,2019
34,"Franklin, VA",876246,72881,105317,88204,1256632,1186,-3344,116983,2351037,125793,41866,2352223,497369,494303,601288,56185,6595,122449,149419,22879,16284,604378,2019
35,"Frederick + Winchester, VA*",4299769,271097,496876,447390,4056851,-5606,-9640,494792,6105645,447038,51907,6100039,251874,1075441,967747,117519,14139,437398,720571,76886,62747,3141800,2019
36,"Giles, VA",290150,23572,40730,30300,380791,-746,-1231,38722,675977,23773,40450,675231,129363,96446,197994,16693,1614,22542,55880,6521,4907,211728,2019
37,"Gloucester, VA",555980,44535,73089,55916,1144670,1419,798,72493,1882903,62794,50250,1884322,661183,357020,382632,37499,3844,63592,101047,14212,10368,391341,2019
38,"Goochland, VA",2395438,146525,180627,228208,1440807,-2301,-3852,260629,2494253,193746,104052,2491952,-694002,808089,243056,23949,4723,189894,294731,23430,18707,1910813,2019
39,"Grayson, VA",151162,16977,26083,16058,236965,-12549,-14128,25006,511870,21341,32061,499321,110809,78208,184148,15574,1966,7213,34112,5514,3548,109837,2019
40,"Greene, VA",257758,20545,27173,22644,587744,881,-17,31867,915063,61687,46025,915944,361853,153769,174431,19901,2405,61670,38495,6527,4122,157593,2019
41,"Greensville + Emporia, VA*",421851,28557,62323,46496,286421,4724,3809,51805,537703,5801,32485,542427,-83625,68696,187310,16698,1195,9610,85571,9252,8057,326670,2019
42,"Halifax, VA",703259,54245,98567,75702,634012,-378,-3664,92096,1264445,49861,37140,1264067,22849,200627,429428,34035,3212,46197,136418,16289,13077,520644,2019
43,"Hampton (Independent City), VA",4610261,271177,769292,549030,3343308,0,0,545692,5713242,104901,42305,5713242,-721261,983059,1386875,135048,12737,104901,1043807,77430,64693,3461553,2019
44,"Hanover, VA",3751465,241452,374746,384238,4545257,11958,5233,433571,6670373,452086,62141,6682331,1227363,1228771,908303,107535,15179,457319,566865,73913,58734,2727281,2019
45,"Henrico, VA",18779549,1135068,1555376,1688924,15750443,1721,685,1979530,22473581,4095433,67592,22475302,-1049576,4032916,2691943,332513,47548,4096118,2399838,256481,208933,12283593,2019
46,"Henry + Martinsville, VA*",1310069,103418,172207,139780,1195201,9901,9192,173308,2465140,98049,39183,2475041,58440,398799,881041,63167,4709,107241,242097,31483,26774,960731,2019
47,"Highland, VA",31463,2823,4323,2508,32429,4225,3599,4077,91922,4080,44185,96147,5043,35985,27733,2176,649,7679,5577,1204,555,18207,2019
48,"Isle of Wight, VA",710178,52627,79738,75320,1364882,11177,9595,90287,2080619,45769,55930,2091796,744991,345582,381332,37400,4227,55364,117398,15662,11435,537416,2019
49,"James City + Williamsburg, VA*",2736840,188229,328421,290122,3209866,-3417,-4007,333290,5990310,235025,65176,5986893,806316,1782748,994279,91857,11830,231018,473482,58761,46931,2032340,2019
50,"King George, VA",1509430,83437,277093,170334,1013153,300,-121,168604,1487910,82079,55158,1488210,-327673,279401,195656,26981,2478,81958,362260,15892,13414,1065212,2019
51,"King William, VA",278696,21172,31332,29210,541457,-334,-927,35777,825855,28950,48001,825521,298538,129256,154808,17198,1882,28023,45937,6305,4423,204736,2019
52,"King and Queen, VA",74308,7029,9270,7110,185904,1361,425,10584,311081,12206,44565,312442,122180,49456,77082,7011,730,12631,12825,1906,1176,48852,2019
53,"Lancaster, VA",278641,22778,30680,27430,233776,511,145,36493,643375,39393,60635,643886,-8372,246210,163900,10619,1931,39538,44395,6996,5065,194708,2019
54,"Lee, VA",240052,24190,43395,24906,308684,-5621,-6478,36643,704859,24700,29704,699238,105275,88000,302554,23540,2242,18222,55848,6871,4629,165982,2019
55,"Loudoun, VA",17256444,1015671,1670915,1749314,26539255,9216,-2137,1890328,33402363,1588533,80535,33411579,11173139,5068759,1803565,414872,63185,1586396,2545572,254097,190912,13124476,2019
56,"Louisa, VA",758588,54422,98762,77026,976635,397,-956,92935,1634283,82489,43618,1634680,310982,298721,359324,37477,4443,81533,137275,14882,10439,539780,2019
57,"Lunenburg, VA",143073,13028,22044,14924,190458,-2189,-4015,20490,405130,10643,32890,402941,67875,76028,136455,12251,1184,6628,29506,4002,2818,106939,2019
58,"Madison, VA",201605,16254,22941,19244,374548,-2098,-4745,25876,644261,42397,48601,642163,198819,143545,124070,13213,2459,37652,32563,5826,3367,131390,2019
59,"Mathews, VA",104828,10582,11379,8540,243016,1149,1099,14852,495688,29848,56574,496837,153040,139105,114716,8782,1266,30947,15649,3046,1780,58232,2019
60,"Mecklenburg, VA",607339,49047,79487,65884,538513,-4997,-9670,81989,1149157,44601,37241,1144160,13163,215422,390225,30723,3057,34931,112429,15401,12344,459979,2019
61,"Middlesex, VA",205691,17311,27687,19118,244102,1150,111,26870,556824,30647,52833,557974,65281,167275,146597,10561,1660,30758,37246,5314,3654,137687,2019
62,"Montgomery + Radford, VA*",3439979,207282,544742,356718,2653188,4308,1456,385641,4368019,205088,37377,4372327,-401150,959177,759962,116979,10914,206544,723101,64863,53949,2510334,2019
63,"Nelson, VA",259997,21973,30464,23274,376267,2776,164,33610,773522,55075,52216,776298,149880,211752,188279,14867,2407,55239,42101,6689,4282,162657,2019
64,"New Kent, VA",344016,26625,38821,33246,1264764,-2488,-2687,43248,1714138,62093,74471,1711650,963996,239852,207034,22984,3298,59406,55444,8583,5285,229166,2019
65,"Newport News (Independent City), VA",8511159,490488,1192017,1000516,4567517,0,0,990746,7467480,240590,41547,7467480,-2952896,1256498,1643465,179736,17374,240590,1692275,132486,115112,6578294,2019
66,"Norfolk (Independent City), VA",13395684,744926,2167004,1604474,5469687,0,0,1547163,9610101,125227,39453,9610101,-6378834,2044641,2095773,243581,24079,125227,2969241,193566,169487,10301216,2019
67,"Northampton, VA",253591,17284,28481,22834,356693,49477,38728,28701,610611,24414,55940,660088,131803,133746,169649,11800,1867,63142,39898,6370,4503,150551,2019
68,"Northumberland, VA",205444,19058,23339,20620,266557,2904,2112,29368,652150,26402,54276,655054,90481,208653,179844,12069,1646,28514,33649,4491,2845,143281,2019
69,"Nottoway, VA",343598,24007,62978,38910,248330,8792,6821,43462,530191,7181,35445,538983,-51806,99136,191517,15206,1393,14002,82433,7586,6193,247163,2019
70,"Orange, VA",640100,47744,76722,62166,1117928,26441,17111,78827,1842280,80962,50587,1868721,556655,377255,373538,36941,4409,98073,107805,15082,10673,434222,2019
71,"Page, VA",338311,28020,43466,35548,512494,21384,18869,45794,913180,35701,39043,934564,219977,162580,259490,23937,2587,54570,61240,8749,6162,222501,2019
72,"Patrick, VA",230975,21158,32344,23338,282987,2908,1294,32827,586915,26646,33528,589823,84839,96833,210003,17592,2061,27940,44013,6960,4899,159022,2019
73,"Pittsylvania + Danville, VA*",2110008,161860,271942,229704,1955473,10096,2706,276712,3820896,121119,38117,3830992,122177,559895,1315624,100506,9350,123825,386794,49555,40205,1599389,2019
74,"Portsmouth (Independent City), VA",4430689,246547,849649,514532,2223456,0,0,503813,3857256,153513,40782,3857256,-1703420,621620,1012180,94582,8607,153513,1106915,61320,52713,3170261,2019
75,"Powhatan, VA",521025,38801,58623,49416,1163750,1094,403,63509,1742865,82538,58652,1743959,706234,329051,251158,29734,4107,82941,83331,12434,8327,354753,2019
76,"Prince Edward, VA",526704,36020,76279,57612,371319,2526,1647,64826,719290,26405,31621,721816,-90559,125965,224532,22827,2012,28052,105085,12356,10344,393567,2019
77,"Prince George + Hopewell, VA*",2565215,137891,476390,307248,1397517,-1985,-2383,291515,2373513,93882,38845,2371528,-876183,395557,578454,61051,4531,91499,630014,36808,32277,1843702,2019
78,"Prince William, Manassas + Manassas Park, VA*",13821530,825234,1623688,1448030,22065067,-238,-2752,1549249,29818310,1522363,56181,29818072,9792786,4640361,3112644,530752,73304,1519611,2347703,254845,181541,9954216,2019
79,"Pulaski, VA",867140,62265,115290,102898,759564,1159,-139,113714,1360063,41701,40025,1361222,6138,200562,401096,34009,2817,41562,166739,18103,15286,658839,2019
80,"Rappahannock, VA",130403,10660,10746,9270,256095,-1899,-3547,15295,504005,52392,68110,502106,140987,173467,72544,7372,1787,48845,15381,3488,1701,66177,2019
81,"Richmond (Independent City), VA",14931755,881642,1780724,1531298,7437338,0,0,1647291,12750699,1162921,55191,12750699,-5847126,3254085,2059276,231027,31527,1162921,2546373,204415,172888,11222461,2019
82,"Richmond, VA",178841,12785,28400,18352,175658,2784,737,21961,333176,10867,37057,335960,18778,71602,88700,9066,967,11604,37576,4170,3203,129661,2019
83,"Roanoke (Independent City), VA",4663469,291624,554444,539960,2261475,0,0,561604,4215302,208394,42486,4215302,-1840390,835817,1118010,99216,9721,208394,824424,81099,71378,3630651,2019
84,"Roanoke + Salem, VA*",4087174,272427,494005,428860,3819250,31,-698,486857,6232127,362532,52094,6232158,218933,1206467,1206441,119632,13039,361834,708435,76160,63121,3016905,2019
85,"Rockbridge, Buena Vista + Lexington, VA*",814783,59193,107302,88344,747773,802,-1136,103365,1496780,81745,41029,1497582,36355,382203,367606,36501,4463,80609,151474,19605,15142,582700,2019
86,"Rockingham + Harrisonburg, VA*",4385580,269136,521585,438542,3465586,119739,101771,488407,5356952,445553,40413,5476691,-431587,1004398,1006707,135519,16410,547324,740856,87230,70820,3097400,2019
87,"Russell, VA",425120,37448,56140,48654,428911,-569,-2261,61775,896674,20852,33513,896105,65566,123719,343475,26739,2369,18591,80467,9875,7506,326062,2019
88,"Scott, VA",272370,26538,38727,29178,348453,-2390,-2995,41127,724165,25367,33450,721775,117210,107119,266203,21578,2378,22372,53316,7969,5591,196682,2019
89,"Shenandoah, VA",899251,66129,107919,89538,1203925,11638,8326,110898,2006486,117591,46333,2018124,415572,370600,443599,43557,5494,125917,152688,20822,15328,620646,2019
90,"Smyth, VA",663595,50720,100221,72720,566765,-3531,-5153,87080,1114214,33448,36800,1110683,-9750,166201,377717,30182,2798,28295,136581,15838,13040,498719,2019
91,"Southampton + Franklin, VA*",445966,33079,65737,44344,591903,22538,18682,55251,1092048,24602,43430,1114586,201188,212952,309731,25664,2500,43284,87909,11172,8672,314773,2019
92,"Spotsylvania + Fredericksburg, VA*",4121624,266832,453936,426326,5773418,2942,1573,479995,8596224,427286,51896,8599166,2131789,1496004,1329744,165701,19484,428859,667099,84803,65319,3025666,2019
93,"Stafford, VA",3769893,231648,515244,399422,6097128,-3171,-3575,431359,8536718,244572,55494,8533547,2758594,1348936,1087483,153775,17256,240997,714955,67722,50466,2813941,2019
94,"Suffolk (Independent City), VA",2388109,156009,292172,262554,3043349,21957,12518,287286,4779177,131246,52030,4801134,942526,846602,911183,92277,10472,143764,423449,45458,34986,1820896,2019
95,"Surry, VA",255312,15617,45837,26842,169607,3076,2348,29038,279098,4473,44042,282174,-56667,38754,73813,6407,729,6821,59258,3057,2328,189233,2019
96,"Sussex, VA",218286,15318,33370,23060,188918,5581,4314,26848,350462,7518,32099,356043,-2520,52548,114577,11092,928,11832,44900,4783,3855,161554,2019
97,"Tazewell, VA",803873,64417,113027,86772,748945,2415,1468,107803,1523559,55294,37462,1525974,52875,235632,541397,40734,3235,56762,156413,18852,15617,590698,2019
98,Virginia,348959675,21543775,39856588,36755448,328989253,445734,202582,39921499,502155049,28861792,58738,502600783,19951077,102012433,71599097,8556642,1088188,29064374,58234312,5327163,4238975,261660989,2019
99,"Virginia Beach (Independent City), VA",14300231,867009,1825039,1544850,16247369,-743,-2214,1639434,25925615,1374400,57513,25924872,3586572,5835099,3842404,450766,58390,1372186,2597464,269803,211413,10330581,2019
100,"Warren, VA",809288,56444,96957,86882,1270216,-1469,-2188,99885,1905196,80252,47315,1903727,560813,291941,341570,40235,4538,78064,140398,18286,13748,590826,2019
101,"Washington + Bristol, VA*",1670965,124175,221479,176628,1428899,-703,-3802,212489,2847824,156792,40164,2847121,-29577,588026,830196,70888,8106,152990,309793,39157,31051,1208182,2019
102,"Westmoreland, VA",208451,18313,26153,18944,412151,23645,19017,27785,789315,24821,45092,812960,231485,193234,207575,18029,2015,43838,35625,5906,3891,128988,2019
103,"Wise + Norton, VA*",839644,65536,129250,91456,631798,-239,-338,111264,1368936,43724,33052,1368697,-96582,175647,561252,41410,2681,43386,174978,19026,16345,621280,2019
104,"Wythe, VA",612425,46401,86564,66536,533289,-4515,-6986,79669,1024568,46149,35644,1020053,533,150210,336554,28618,3180,39163,119832,15203,12023,453430,2019
105,"York + Poquoson, VA*",1650761,110577,221383,178758,3095743,1467,698,199956,4838224,144961,59892,4839691,1644938,1067740,676208,80807,8133,145659,310762,35493,27360,1194340,2019
0,"Accomack, VA",1148582,70466,186812,136394,875373,28153,22931,138663,1705019,57349,53762,1733172,-134546,347073,510726,32238,3733,80280,255009,18794,15061,813293,2020
1,"Albemarle + Charlottesville, VA*",8579810,509665,1100194,867628,6220258,3102,-6134,943479,12227808,831240,77606,12230910,-1416073,4421440,1589212,157602,26446,825106,1534008,128179,101733,6220696,2020
2,"Alexandria (Independent City), VA",10390303,609941,1195526,1126542,10326096,0,0,1173212,14894033,875526,93835,14894033,1109005,3177583,1390354,158726,26235,875526,1758797,116764,90529,7755980,2020
3,"Alleghany + Covington, VA*",491476,38386,66279,55702,406180,330,7,66237,878960,24862,43230,879290,-19059,128798,344312,20340,1396,24869,94130,9120,7724,372477,2020
4,"Amelia, VA",176233,14694,20031,17246,353462,9927,6471,23317,598862,25905,46780,608789,200546,76653,178674,13014,1784,32376,28654,4534,2750,115203,2020
5,"Amherst, VA",476636,40411,64511,51666,663174,449,-271,66244,1275507,33880,40293,1275956,252782,179072,433710,31667,2869,33609,90344,11157,8288,352683,2020
6,"Appomattox, VA",183660,17450,25307,18304,363408,-832,-1621,26602,670623,20327,41750,669791,206350,87318,219065,16043,1725,18706,34459,5246,3521,130495,2020
7,"Arlington, VA",27126649,1522597,3067298,2899062,17544731,0,0,2972128,24209568,1434360,100823,24209568,-6609790,4996535,1668302,240119,34452,1434360,4516829,233541,199089,21175460,2020
8,"Augusta, Staunton + Waynesboro, VA*",3270651,230715,400083,351606,3351043,29998,22919,406518,5919206,309875,47794,5949204,486910,1020556,1577605,124475,13597,332794,575886,63909,50312,2361971,2020
9,"Bath, VA",128873,9536,18170,13964,106503,2431,1967,16518,286107,7149,70050,288538,-5852,103448,78587,4119,582,9116,25152,2538,1956,94605,2020
10,"Bedford, VA*",1204040,102208,140508,124758,2220507,-1120,-2862,164587,3948339,149090,49457,3947219,1181054,705885,1020827,79811,10105,146228,202887,30019,19914,854925,2020
11,"Bland, VA",139508,10484,22595,15166,120310,2602,2280,18067,244518,8017,39609,247120,-1131,34443,92367,6239,658,10297,30178,2683,2025,99033,2020
12,"Botetourt, VA",730660,55062,88879,78248,1061590,-1059,-2294,94186,1809421,60657,53767,1808362,425116,312281,434491,33633,4206,58363,128003,15636,11430,544294,2020
13,"Brunswick, VA",197304,18181,30158,22056,259863,1353,-396,29209,583980,8942,36499,585333,91768,79402,246068,16037,1333,8546,41186,5055,3722,147572,2020
14,"Buchanan, VA",434125,35389,57949,44660,334491,-121,-173,57719,803399,44399,38969,803278,-41915,83978,384809,20613,1078,44226,80279,7227,6149,309620,2020
15,"Buckingham, VA",215033,20472,33115,22206,284363,2679,1622,31575,571165,20304,33425,573844,100905,72480,217001,17168,1527,21926,44218,4955,3428,148889,2020
16,"Campbell + Lynchburg, VA*",4762595,316167,546127,536410,2841516,3600,1679,584372,5611964,241728,41030,5615564,-1336707,873238,1900810,136865,12999,243407,814332,86266,73267,3704856,2020
17,"Caroline, VA",403557,31324,60423,42450,859972,7088,5309,52549,1433525,35140,46682,1440613,508964,214945,365696,30860,3023,40449,81648,9296,6273,281460,2020
18,"Carroll + Galax, VA*",609667,54450,80855,66448,651885,7481,5479,87674,1407604,57528,38908,1415085,129892,176192,587008,36370,3596,63007,114079,15588,11992,432581,2020
19,"Charles City, VA",127436,9332,14973,13250,179811,6342,5198,15957,344926,8718,51498,351268,68332,69957,101500,6821,738,13916,21598,2515,1777,91922,2020
20,"Charlotte, VA",165170,15716,24100,17444,206964,1551,-119,24438,454077,18372,38547,455628,66232,70061,178603,11820,1589,18253,32822,4542,2953,114095,2020
21,"Chesapeake (Independent City), VA",7203913,465596,831128,793828,8541686,11112,6943,862510,13234040,446848,53622,13245152,2200283,1997021,2706445,247011,25692,453791,1228042,133971,108279,5522080,2020
22,"Chesterfield, VA",10366100,685190,1166954,1114344,13508110,2164,1305,1242362,20800738,881810,58069,20802902,4384372,3410827,3883965,358245,44061,883115,1724126,187217,143156,7758859,2020
23,"Clarke, VA",290462,22642,29720,28500,613226,3505,-186,36892,1007130,55053,69117,1010635,359656,223739,173670,14622,2552,54867,43970,6572,4020,191625,2020
24,"Craig, VA",47599,4832,7150,4470,109386,-480,-964,7067,213655,7514,41988,213175,68854,35003,68786,5077,634,6550,9385,1426,792,31664,2020
25,"Culpeper, VA",1207395,84727,138979,121640,1723622,9554,4360,145547,2696150,188376,50509,2705704,661774,405720,576362,53569,6438,192736,199799,23171,16733,814860,2020
26,"Cumberland, VA",86155,7207,11274,7834,221980,5089,4093,11124,404403,15478,41225,409492,146949,50990,136522,9933,1007,19571,15191,2316,1309,51393,2020
27,"Dickenson, VA",211780,20808,32249,22554,206677,-205,-266,32085,521732,9824,37046,521527,26982,53268,261582,14078,690,9558,43526,4356,3666,158696,2020
28,"Dinwiddie, Colonial Heights + Petersburg, VA*",1899754,143152,238723,220636,1657774,341,-732,253470,3430169,80903,44938,3430510,11490,478941,1293795,76339,6788,80171,349041,39421,32633,1470542,2020
29,"Essex, VA",207192,17033,25457,22216,250562,904,112,28141,509659,19678,46657,510563,71511,94871,165130,10943,1260,19790,36565,4983,3723,150837,2020
30,"Fairfax, Fairfax City + Falls Church, VA*",88831654,5406410,7695260,9131822,72481653,8996,7127,9972321,105768713,6840455,88971,105777709,-6377680,23424292,9871764,1188907,185202,6847582,12261171,897885,712683,69722901,2020
31,"Fauquier, VA",1996874,132260,202256,188390,3449864,12849,1858,226455,5325042,355952,74801,5337891,1679445,1160017,728010,71361,12008,357810,296451,35696,23688,1342613,2020
32,"Floyd, VA",195616,18431,23502,19956,351160,2281,-942,28409,665149,33342,42304,667430,183953,103741,212529,15777,2516,32400,33480,6161,3645,129736,2020
33,"Fluvanna, VA",328257,28454,42313,31152,761820,-451,-970,44030,1328779,55563,48440,1328328,477593,254827,311681,27422,3134,54593,57889,7719,4585,215775,2020
34,"Franklin, VA",927354,76382,112109,96088,1278943,7679,3333,124426,2509772,129496,44821,2517451,476015,483002,755506,56167,6482,132829,160153,22375,15893,634372,2020
35,"Frederick + Winchester, VA*",4547973,288965,525739,488006,4174696,1493,-2348,532968,6513580,435563,54832,6515073,159691,1065527,1274850,118819,13835,433215,769742,75920,62085,3345016,2020
36,"Giles, VA",312471,25833,43790,33868,380499,482,22,42767,725369,23028,43561,725851,110795,94097,251255,16663,1586,23050,60724,6515,4929,228697,2020
37,"Gloucester, VA",576056,46558,75390,59404,1163192,2970,2394,76260,1995128,62143,53341,1998098,663396,348439,486467,37459,3766,64537,105092,13829,10063,406427,2020
38,"Goochland, VA",2594446,159782,191215,245878,1496589,-872,-2366,282721,2581245,183566,105619,2580373,-815136,789488,294296,24431,4665,181200,314154,24128,19463,2099092,2020
39,"Grayson, VA",159677,15653,27323,16752,239742,-6952,-8465,24029,550643,21348,35093,543691,104094,77731,226218,15493,1926,12883,35699,5418,3492,111095,2020
40,"Greene, VA",256629,21093,27418,23778,595902,1697,834,32982,976120,57957,48573,977817,372255,152070,229845,20131,2352,58791,39307,6343,3991,158531,2020
41,"Greensville + Emporia, VA*",437028,30512,64362,50702,296929,1948,1072,55863,600829,9613,36450,602777,-84236,69372,236476,16537,1167,10685,89713,8836,7669,336630,2020
42,"Halifax, VA",696888,55402,98453,77936,633455,1320,-1831,94370,1362227,50383,40542,1363547,30937,196182,533910,33633,3160,48552,137421,15318,12158,510915,2020
43,"Hampton (Independent City), VA",4676032,277288,794587,551650,3431110,0,0,553113,6253733,130321,46165,6253733,-691809,978649,1843974,135464,12359,130321,1070412,73733,61374,3475299,2020
44,"Hanover, VA",3780725,249990,368996,395688,4615938,19736,13268,447834,6985277,440674,64704,7005013,1283047,1211285,1177790,108262,14900,453942,566840,69850,54950,2759943,2020
45,"Henrico, VA",18747934,1150693,1573542,1728914,15682760,3614,2613,2015150,23317388,3817096,69872,23321002,-1050024,3957041,3681201,333766,46486,3819709,2437999,243903,197417,12490226,2020
46,"Henry + Martinsville, VA*",1337563,109431,176305,146766,1211683,11345,10666,182814,2707011,99410,43380,2718356,56934,393567,1113106,62664,4613,110076,249688,30121,25508,977799,2020
47,"Highland, VA",31836,2924,4352,2592,33427,4165,3566,4220,97728,4340,46315,101893,5811,35056,33410,2200,637,7906,5648,1163,526,18282,2020
48,"Isle of Wight, VA",796723,59414,84444,84984,1406220,11204,9688,101906,2225333,49366,59285,2236537,711403,347822,482495,37725,4128,59054,126936,15253,11125,610733,2020
49,"James City + Williamsburg, VA*",2662977,193785,324431,285280,3306641,-2392,-2952,336425,6343541,235372,68279,6341149,980089,1754148,1280360,92871,11567,232420,467071,52296,40729,1963486,2020
50,"King George, VA",1580401,87427,291518,178070,1046079,1294,886,176462,1569741,63439,57377,1571035,-357860,271787,253169,27381,2430,64325,380553,16222,13792,1135523,2020
51,"King William, VA",282982,22033,31847,30048,566058,2127,1564,37057,896704,27981,50951,898831,320133,128370,204403,17641,1842,29545,46871,6045,4203,206566,2020
52,"King and Queen, VA",82641,7458,10241,8108,194539,4332,3431,11512,335049,12030,48888,339381,123410,48385,96457,6942,715,15461,14295,1913,1198,52885,2020
53,"Lancaster, VA",285717,22435,31330,28798,241561,1069,717,36834,677257,41177,63885,678326,-7322,240087,196678,10618,1897,41894,45729,6699,4802,198094,2020
54,"Lee, VA",255818,24646,45731,26750,317516,-2705,-3512,38021,770856,24302,33056,768151,99719,84865,365770,23238,2216,20790,59106,6739,4523,175922,2020
55,"Loudoun, VA",17820129,1063700,1693299,1822262,27917116,10492,-414,1974831,35661523,1640543,84374,35672015,12071818,5017857,2737042,422784,61897,1640129,2604430,242426,180529,13575570,2020
56,"Louisa, VA",763179,55167,104571,78628,990036,1780,485,94481,1753829,82531,46040,1755609,321338,304262,461311,38132,4362,83016,143885,14714,10352,536278,2020
57,"Lunenburg, VA",148214,12201,22456,15642,197730,-327,-2099,20022,439403,11958,35793,439076,69538,73860,167486,12267,1165,9859,30277,3838,2673,108078,2020
58,"Madison, VA",222256,17414,24023,21628,390367,1273,-1265,28228,685739,48239,51608,687012,196339,140103,156542,13312,2418,46974,34837,5719,3301,140445,2020
59,"Mathews, VA",105605,11523,11678,8902,244133,1702,1656,15974,515720,28006,59026,517422,154502,135192,138097,8766,1244,29662,16129,2942,1698,59814,2020
60,"Mecklenburg, VA",640946,52774,82401,70620,559211,-802,-5295,88084,1249225,47800,40693,1248423,6349,210476,478736,30679,2992,42505,117711,14797,11805,480730,2020
61,"Middlesex, VA",204510,18399,27039,19684,244534,1909,902,28241,584315,30711,55466,586224,68265,162625,179065,10569,1630,31613,36881,5058,3428,136016,2020
62,"Montgomery + Radford, VA*",3506878,215210,555992,371908,2665011,6969,4257,401164,4593733,193866,39442,4600702,-440703,931616,1004075,116646,10680,198123,741946,61943,51263,2566809,2020
63,"Nelson, VA",257962,24363,31508,23430,372603,5745,3235,36078,818597,52629,55869,824342,150719,213751,237988,14755,2355,55864,43223,6224,3869,158875,2020
64,"New Kent, VA",367573,30463,43911,36000,1338041,-1675,-1865,48463,1845201,53032,77957,1843526,1018931,237481,268004,23648,3181,51167,61911,8604,5423,254495,2020
65,"Newport News (Independent City), VA",8777314,509984,1258836,1032036,4676387,0,0,1026002,8197632,287450,45781,8197632,-3074925,1247433,2273812,179062,16899,287450,1774854,128392,111493,6715010,2020
66,"Norfolk (Independent City), VA",13675146,760884,2239783,1632002,5530657,0,0,1576885,10439462,143286,42996,10439462,-6567604,2016021,2892784,242803,23492,143286,3055784,184989,161497,10476076,2020
67,"Northampton, VA",282707,18285,29986,24662,386419,72211,61830,30616,658683,25347,62614,730894,134328,130268,214207,11673,1835,87177,42317,6011,4176,153213,2020
68,"Northumberland, VA",209517,21591,24137,21422,269664,5450,4686,32302,683607,25291,57093,689057,92449,202766,216627,12069,1616,29977,34848,4396,2780,144692,2020
69,"Nottoway, VA",343531,24935,62022,39570,250233,6776,4893,44720,578309,8348,38594,585085,-48578,96245,238607,15160,1372,13241,81807,7246,5874,248483,2020
70,"Orange, VA",661913,53364,78413,64588,1154861,42551,33571,85658,1963467,80330,53217,2006018,578606,368827,482330,37695,4322,113901,110707,14347,10025,437305,2020
71,"Page, VA",337283,29183,44292,36572,518398,14083,11678,47469,998462,36765,42307,1012545,228584,161228,332919,23933,2527,48443,62578,8335,5808,226262,2020
72,"Patrick, VA",226914,22220,31341,23522,280436,5817,4269,33981,631383,26992,36426,637200,87503,95388,261376,17493,2030,31261,43102,6492,4462,152551,2020
73,"Pittsylvania + Danville, VA*",2140239,167130,280604,238430,1979846,17826,10781,286345,4182439,127958,42121,4200265,125952,552268,1668151,99719,9152,138739,399819,47486,38334,1601681,2020
74,"Portsmouth (Independent City), VA",4491255,249672,878993,520786,2275640,0,0,510065,4266942,171626,44871,4266942,-1705550,624408,1366894,95094,8365,171626,1139386,59752,51387,3180243,2020
75,"Powhatan, VA",547617,40376,60445,52506,1210067,773,111,66629,1854737,86670,61547,1855510,729079,324391,321052,30148,4044,86781,86698,12243,8199,374138,2020
76,"Prince Edward, VA",527872,37694,75785,59296,372290,2949,2107,67342,776208,28149,33868,779157,-88240,121896,284971,23006,1970,30256,105433,11540,9570,392183,2020
77,"Prince George + Hopewell, VA*",2610576,139804,493299,314412,1401988,340,-34,297010,2547847,77807,41732,2548187,-911578,396741,749458,61061,4412,77773,650505,35834,31422,1882298,2020
78,"Prince William, Manassas + Manassas Park, VA*",14418229,871937,1671493,1512090,22752718,1098,-1284,1627982,31962982,1662153,59812,31964080,9962471,4645165,4566197,534406,71542,1660869,2427538,244311,172769,10329822,2020
79,"Pulaski, VA",799017,57993,110496,95004,767255,6053,4813,105495,1472953,39782,43583,1479006,73733,194588,517163,33935,2757,44595,157998,16504,13747,596424,2020
80,"Rappahannock, VA",131181,10223,11130,9650,255564,-656,-2238,15048,514714,51023,70807,514058,139431,169662,88832,7260,1753,48785,15955,3381,1628,66441,2020
81,"Richmond (Independent City), VA",15240164,911584,1785366,1573502,7556610,0,0,1698335,13735773,1183505,59148,13735773,-5985219,3187818,2991345,232226,30687,1183505,2572117,192020,161333,11484542,2020
82,"Richmond, VA",189054,13378,29615,19658,184664,5928,3956,23207,364085,11130,40791,370013,18817,69933,115416,9071,947,15086,39444,4093,3146,134524,2020
83,"Roanoke (Independent City), VA",4760411,303950,558438,551072,2327668,0,0,579486,4628669,252310,46727,4628669,-1853257,827541,1473460,99058,9500,252310,833974,76851,67351,3674127,2020
84,"Roanoke + Salem, VA*",4162301,285765,502163,444848,3862849,417,-273,508189,6588499,352014,54977,6588916,208737,1177967,1548100,119849,12786,351741,724587,73363,60577,3085973,2020
85,"Rockbridge, Buena Vista + Lexington, VA*",813113,61069,108025,91170,744678,4868,3024,106654,1581419,75837,43534,1586287,38219,375315,466294,36438,4363,78861,153610,18452,14089,580642,2020
86,"Rockingham + Harrisonburg, VA*",4509122,284999,529457,471352,3505968,91256,74106,520675,5768777,459087,43232,5860033,-482479,1006620,1347445,135550,16049,533193,765133,82855,66806,3210796,2020
87,"Russell, VA",434810,38455,56545,48450,429396,4437,2815,62680,966115,29276,36423,970552,57266,119516,421640,26647,2333,32091,80770,9542,7209,321949,2020
88,"Scott, VA",274748,28426,38344,29622,352979,703,129,43237,775394,25718,35882,776097,121468,103064,320054,21629,2347,25847,53155,7487,5140,195746,2020
89,"Shenandoah, VA",916751,69747,110136,95194,1253818,9172,6032,117344,2183815,123370,49948,2192987,454411,368117,571052,43905,5385,129402,157733,19940,14555,629616,2020
90,"Smyth, VA",670066,52010,102193,73754,575292,572,-986,88887,1209639,36622,40220,1210211,-5887,166309,468610,30090,2746,35636,139070,14956,12210,495360,2020
91,"Southampton + Franklin, VA*",450674,35346,67972,47528,598213,10825,7131,59110,1183907,26008,46909,1194732,206649,210948,385571,25469,2453,33139,91736,10867,8414,325799,2020
92,"Spotsylvania + Fredericksburg, VA*",4296186,281470,458430,448158,6031408,3845,2551,505549,9245812,482833,55077,9249657,2240771,1465544,1752705,167941,19026,485384,682509,80628,61602,3128293,2020
93,"Stafford, VA",4014564,249972,530852,426614,6426873,-2717,-3107,463279,9193623,269227,58635,9190906,2875588,1334228,1429805,156748,16855,266120,744159,66398,49543,3004285,2020
94,"Suffolk (Independent City), VA",2576577,170880,303660,289086,3190833,25064,15932,315423,5192830,143647,55561,5217894,929679,837366,1189695,93913,10233,159579,448203,44708,34475,1968795,2020
95,"Surry, VA",258924,15646,52472,26472,173045,4117,3422,28882,301897,4656,47927,306014,-56997,39007,93962,6385,719,8078,65708,2951,2232,185138,2020
96,"Sussex, VA",229694,16260,34960,24778,185081,6130,4918,28649,376918,8411,35062,383048,-15964,53036,144931,10925,910,13329,47349,4618,3708,169016,2020
97,"Tazewell, VA",780286,66785,112921,85186,723346,3722,2819,109378,1609123,55401,39795,1612845,52438,227691,661808,40529,3184,58220,155514,18033,14849,566552,2020
98,Virginia,358246267,22437588,40614342,37914368,336644234,633147,400189,41394772,531623069,29744053,61958,532256216,19792739,100174745,95437237,8590563,1064162,30144242,59571526,5100799,4036637,268530499,2020
99,"Virginia Beach (Independent City), VA",14778855,907892,1902503,1603960,16564223,723,-682,1709872,27432112,1449070,60796,27432835,3495240,5755577,5113035,451231,57162,1448388,2704483,258073,200911,10625984,2020
100,"Warren, VA",843638,60888,100282,92878,1300711,-614,-1303,107327,2044746,85873,50504,2044132,564400,289967,453454,40475,4446,84570,146721,17885,13439,612347,2020
101,"Washington + Bristol, VA*",1672711,127184,221833,181094,1448050,5209,2270,217731,3034359,159458,42796,3039568,-6930,566552,1024966,71024,7961,161728,312380,37132,29171,1198603,2020
102,"Westmoreland, VA",220891,19447,26831,20488,431978,31269,26822,29691,850364,23983,48577,881633,240778,189315,260340,18149,1972,50805,37075,5600,3628,133011,2020
103,"Wise + Norton, VA*",841119,68807,132130,92652,624455,6,-85,115133,1479948,42887,35929,1479954,-101531,169925,685574,41191,2629,42802,178456,18065,15436,619861,2020
104,"Wythe, VA",634033,48971,88868,69050,539136,1136,-1232,83496,1118371,46716,39116,1119507,-11401,144879,435492,28620,3124,45484,123393,14640,11516,465156,2020
105,"York + Poquoson, VA*",1595422,105076,220432,173938,3189256,1575,840,192045,5101261,145953,62645,5102836,1785879,1062427,851153,81456,7951,146793,307401,33041,25090,1141228,2020
